Devarim:1	כשם שהדבורה כולה עוקצין. עיין ברבה במקומו. אלה הדברים מה הדבורה הזה דבשה מתוק ועוקצה מר כך הם דברי תורה מי שעובר עליהם נוטל אפופסין (היינו עונש) ומי שמקיים אותה זוכה לחיים ע״ש. ודורש אלה הדברים כמו דבורים. ואולי זה יהיה כוונת המחבר שמביא זה הכא כמו שמסיים לבסוף ומה היתה תוכחה שהוכיח משה לישראל אלה הדברים וידרוש כמו דבורים. וכן הכא גבי קהלת דורש דברי קהלת כמו דבורה:
Devarim:2	שלא היה אדם אחר וכו׳. עיין ברבה מה שכתוב בו לא חמור א׳ מהם נשאתי לזה ראוי להוכיחן:
Devarim:3	הפה שאמר וכו׳. עיין רבה. הרי משה עד שלא זכה לתורה כתיב בו לא איש דברים אנכי כיון שזכה לתורה נתרפא לשונו והתחיל לדבר אלה הדברים:
Devarim:4	מה שעשו בשיטים. וזה בערבה בערבות מואב ששם נחל השטים:
Devarim:5	בחמה ולבנה ובים. הגר״א הגיה בספרי בשמש וארץ וים. כי כן הוא שם בפסוק וזרח השמש הולך אל דרום וסובב אל צפון (זו הארץ) וכל הנחלים הולכים אל הים:
Devarim:6	אמר ר׳ טרפון העבודה וכו׳. (ערכין ט״ז):
Devarim:7	ונתלבנה בצרעת. וזה ולב״ן:
Devarim:8	בכפורת. היינו במעשה המשכן עיין ספרי:
Devarim:9	רב לכם שבת בהר הזה אמר להם וכו׳ כצ״ל כי מילת בהר דריש:
Devarim:10	פנו וסעו לכם זה דרך ערד וחרמה כצ״ל. והכוונה שילכו לא״י קרוב לערד וחרמה. והלשון פנו דריש שיסעו לאחוריהם. והז״א האריך בזה:
Devarim:11	שמימיו פרין והולכין. ע״כ נקרא נהר הגדול. ודע הלשון שמימיו פרין והולכין כוונתו כמו (בכורות נ״ה) הנודר ממי פרת אסור בכל מימות שבעולם כי כל הנהרות נמשכין מאתו ע״ש:
Devarim:12	הוא יריב את ריבם. וסיפא דקרא וקבע את קובעיהם נפש:
Devarim:13	ארשב״י שבע שמחות את פניך אל תקרא שובע אלא שבע שמחות פניהם של צדיקים דומות לע״ל וכו׳ כצ״ל:
Devarim:14	משהגדיל הבן עמד האפטרופוס ונתן לו רק כדי פרנסתו אמר לאפטרפוס וכו׳ כצ״ל וכ״ה בספרי וע״ז שייך הסיום זהו משלי:
Devarim:15	וכצמחי האדמה. כ״ה בספרי והגר״א הגיה וכעפר הארץ:
Devarim:16	לא מעצמי וכו׳. נ״ל דקאי אקרא דלמעלה כאשר דבר לכם כלומר אע״פ שאני מתחיל להוכיח אתכם אין אני עושה מעצמי אלא מפי הקב״ה הוא דיבר לי להוכיח אתכם (חכם הספרדי):
Devarim:17	שהיו מתרעמין וכו׳. בספרי וכן (קידושין ל״ג:) הקדים משה לצאת אמר שמא אינו שפוי בביתו אחר לצאת וכו׳ והיינו שהיו בהם אפקורסת:
Devarim:18	שנאמר הבו לכם סבר ועצה כצ״ל. שכל הבה לשון הכנה והזמנה לדבר הוא פי׳ תנו עצה ועזר לדבר הזה (מזרחי):
Devarim:19	מה בין נבון לחכם. חכם דומה לשולחני עשיר שמביאים לו לראות היינו מטבעות רואה. כשאין מביאין לו יושב ותוהה. נבון דומה לשולחני תגר כשאין מביאין לו לראות מביא משלו רואה כ״ה בספרי וכצ״ל הכא:
Devarim:20	שיהיו ידועים וכו׳. שהם צדיקים שכל שבט מכיר אנשיו וכ״ה בהדיא בספרי:
Devarim:21	בין ברצונכם. כי יחיד מומחה דן בע״כ:
Devarim:22	ואלו נכונים לא מצא. (עירובין ק׳):
Devarim:23	ראשים במו״מ וכו׳. כי ת״ח נקטינן ליה שוקא (ב״ב כ״ב.):
Devarim:24	היה אחד משרי מאות נתפס בעידן שר אלף כצ״ל:
Devarim:25	ת״ר שרי אלפים וכו׳. (סנהדרין יח.):
Devarim:26	ושוטרים הלוים לפניכם כצ״ל:
Devarim:27	והלוים מחשים לכל העם כצ״ל:
Devarim:28	וכה״א שר חמשים וכו׳. יותר ראיה מקרא דאח״כ שם תיקר נא נפשי ונפש עבדיך אלה חמשים בעינך הרי השר חמשים היה חוץ מהחמשים:
Devarim:29	שיסבול את בעלי דינים. קאי על סיפא דקרא שמוע בין אחיכם:
Devarim:30	ברחבעם. אם תהיה עבד לעם הזה ועבדתם וכו׳ כצ״ל:
Devarim:31	אמר ר״ל צדק את הדין. (סנהדרין ז:) ע״ש ברש״א שפירש שמתחלה צדק את הדין לעשות פשרה ובא״ל חתכהו עפ״י ד״ת כי כשאתה יודע האיך הדין נוטה אי אתה רשאי לבצוע:
Devarim:32	בין איש וכו׳. (סנהדרין שם) ודורש בין איש לאחיו לענין ירושה וזה שאמר בין בית לעלייה בין תנור וכרים אלא יעלה אותן בדמים וישוה חלוקתו ע״י מעות (רש״י שם) ד״א לא תכירו ר׳ יהודה אומר לא תכירהו (היינו אם הוא אוהבך) ר״א אומר לא תנכרהו (היינו אם הוא שונאך) כצ״ל וכ״ה בסנהדרין שם וע״ז קאי המעשה אושפזכנאי וכו׳:
Devarim:33	מפיקנא לך. היינו שרצה לשמתו:
Devarim:34	אלו דקדוקי מצות כגון שחיטה וניקור הבשר ככ״ל ועיין רמב״ן על התורה ודורש סיפא דקרא כל הדברים אשר תעשון קאי על תורה שבע״פ שהם הלכה למשה מסיני:
Devarim:35	אלו יו״ד דברים. היינו מה שדיני נפשות חמור מדיני ממונות ע״ש בסנהדרין:
Devarim:36	עלה רש מיד. כי אם לא היו חוטאין היו נכנסין תיכף לארץ:
Devarim:37	לעלות בהר. בכדי שיוכלו לראות כל סביבותיהם:<br>לז. שגופים. כמו סגופים. לענות נפש תרגום לסגפא נפשי׳:
Devarim:38	מעמידין אותם בקלון כצ״ל. ופי׳ בבתי זנות:
Devarim:39	ענקים. המחבר דהכא יפרש בני ענקים שהיו כ״כ גבורים שהיו מתגאין בגבורתם וכמו הקרא לכן ענקתמו גאוה:
Devarim:40	ואומר אליכם לא תעלו ולא תלחמו. כל הפסקא בטעות וכן צ״ל ואומר אליכם לא תערצון ולא תראון מהם מפני מה שה׳ אלהיכם הוא ההולך עמכם וכו׳ (הוא הקרא השני) כצ״ל:
Devarim:41	מי שעשה לכם בראשונים. הוא מצרים.כן יעשה באחרונים היינו בארץ כנען:
Devarim:42	ואנכי תרגלתי לאפרים קחם על זרועותי. כמו הכא נשאך ה׳:
Devarim:43	ת״ל הדור הרע הזה. היינו הגדולים שהיו במנין בני כ׳ שנה. אבל הקטנים יבואו לא״י:
Devarim:44	ותהינו לשון הין וכו׳. עיין ראב״ע שני פירושים או לשון ה״ן היינו שאמרו אח״כ נעלה דוקא. או ותהינו לשון הין במידה. ויהיה הכוונה שמדדו עצמם לעלות בהר:
Devarim:45	שכיבד את אביו. דורש רב לכם סוב את ההר הזה אין הרים אלא אבות וכ״ה בדברים רבה:
Devarim:46	שלא יהיו מתגרים וכו׳. היינו שלא ימרדו במלכיות. וכ״ה בהדיא בתנחומא וברבה מסיים ולא זו בלבד אלא אתה צו לראשי הדורות שינהגו בו כבוד:
Devarim:47	עוברים אתם ולא יושבים. שאסור להם לישב בארץ בני עשו. ומה שמסיים שהפורענות עתידה לבוא אולי כוונתו על הגלות שבא אח״כ שהגלו ונתיישבו בין האומות:
Devarim:48	שהם מלוחין ויבשים. הוא ט״ס. רק מחמת שהם מלוחים נאכלין מחמת מלחם עיין (ע״ז ל״ח:) בתוס׳ ד״ה דגים קטנים וכ״ה לקמן בדברי המחבר:
Devarim:49	ואם עשה בהם ישראל שום מעשה. (ע״ז שם). ואתי ישראל וחתה בה חתויי והיינו שהיפך הגחלים ע״ש:
Devarim:50	אע״פ שהתירו רבינו הקדוש. (ע״ז ל״ה:) רבי ובית דינו התירו השמן. וע״ש בפרש״י דלא גרסינן רבי רק ר׳ יהודה נשיאה והוא נכדו של רבי וע״ש בתוס׳ ד״ה אשר לא יתגאל:
Devarim:51	כך לא התגריתי. ע״כ כתיב הלשון ונעבור שלא עכבו שם:
Devarim:52	הוא שאמר רחב״א וכו׳. (ב״ק ל״ח:):
Devarim:53	מכאן אמרו כשם שעמדה חמה וכו׳. (תענית כ.):
Devarim:54	שהיתה קדומה. ויהיה הפירוש ממדבר קדמות כמו *מדבר קדמות למד משה ממלחמת פרעה:
Devarim:55	מכאן אמרו עוג וכו׳. מסיפא דקרא כי בידך נתתי אותו:
Devarim:56	הם פלטין שלו. וכן הוא בתרגום שתרגם תרכונה. ובתרגום ירושלמי במגילת אסתר קורא לפלטין תרכונה:
Devarim:57	צידונים יקראו לחרמון שריון. והאמורי יקראו לו שני״ר וכתיב שיאון וחרמון הרי ארבעה שמות:
Devarim:58	ארבעה מלכים. וזה ד׳ שמות הם שמות המלכים שרצו כאו״א שיקראו על שמו:
Devarim:59	ואמרו רבותינו. (סוטה מב:) חצי שבחו דורש וחץ לשון חצי:
Vaetchanan:1	והוא שאמרו חז״ל (מ״ק כ״ח:) חיי ובני ומזוני כו׳:
Vaetchanan:2	אתה חונן את שאינו ראוי כו׳. ברבה וכן בפרש״י בחומש. פי׳ להיפך אע״פ שיש לצדיקים לתלות במעשיהם הטובים אעפ״כ אינם מבקשים אלא מתנת חנם:
Vaetchanan:3	תניא ר״א אומר שואל וכו׳. (ע״ז ז:) ע״ש ודורש כי יעטוף עטיפת נפשו ודאגת לבו יתפלל תחלה ואח״כ לפני ה׳ ישפוך שיחו היינו תפלת שמ״ע:
Vaetchanan:4	מעין כל ברכה וברכה. עיין ע״ז שם. אף על פי שאמרו שואל אדם צרכיו בשומע תפלה אם יש לו חולה אומר בברכת חולים. ואם צריך לפרנסה אומר בברכת השנים:
Vaetchanan:5	שבעה שמות לתפלה. ברבה הגי׳ יו״ד שמות לתפלה:
Vaetchanan:6	מקים מעפר דל רופא חולי. כי החולה מכונה בשם דל כמו מדוע ככה אתה דל בן המלך:
Vaetchanan:7	אל תרבו תדברו גבוהה. שאותך לבדך ביראה. יצא עתק מפיכם זו הודאה כצ״ל וכ״ה בילקוט שמואל:
Vaetchanan:8	ראיה לדבר חנה והיא מרת נפש כצ״ל:
Vaetchanan:9	והמתפלל וכו׳. עיניו למטה ולבו למעלה (יבמות קה:):
Vaetchanan:10	שהלכה כרב אסי כצ״ל:
Vaetchanan:11	אבל ישתוק מתפלתו וכו׳. עיין (סוכה לח.).בתוס׳ ד״ה שמע וכו׳ כדברי המחבר:
Vaetchanan:12	אמר חנה ומן. כי דומה שנתבטל השבועה אחרי כי כבש ארץ סיחון ועוג יכבוש כל א״י:
Vaetchanan:13	לאמר השיבני על כך. מלת לאמר דריש:
Vaetchanan:14	חנניה מישאל ועזריה לא קראו עצמם עבדים והקב״ה קראום עבדים. שנאמר (דניאל ג׳) שדרך מישך ועבד נגו עבדוהי דאלהא חייא נביאים הראשונים לא קראו עצמם עבדים והקב״ה קראן עבדים שנאמר כי אם גלה סודו אל עבדיו הנביאים כצ״ל:
Vaetchanan:15	אלו י׳ מכות. דכתיב נטה את ידך כצ״ל:
Vaetchanan:16	אתה החלות וכו׳. דריש החלות מלשון לא יחל דברו:
Vaetchanan:17	אלא כדי לחבב וכו׳. בפני ישראל עיין בספרי הלשון. כך משה היה מחבב דברי המקום ג״כ פירושו כמו הכא שמחבב את א״י לפני ישראל ובזה מחבב הוא דברי השי״ת ומפרשי הספרי דרכו בדרך אחר והנראה לי כתבתי:
Vaetchanan:18	הכל קראו וכו׳. ספרי אברהם אמר בהר ה׳ יראה. דוד אמר מי יעלה בהר ה׳. גוים אמרו לכו ונעלה הר בית ה׳ ובכאן קיצר:
Vaetchanan:19	למענכם בשבילכם. אולי הכוונה כמו שאמר למעלה בפ׳ דברים עתיד משה רבינו להעלות מתי מדבר:
Vaetchanan:20	אפילו עצמותיך. בספרי פנחס כפי גירסת הגר״א כי לא תעבור את הירדן הזה אף עצמותיך אינם עוברים שנאמר כי אנכי מת בארץ הזאת אינני עובר את הירדן וכי היה יכול לעבור אלא אמר משה אף עצמותי אינם עוברים את הירדן:
Vaetchanan:21	וראה מסוף העולם וכו׳. בספרי שם מסיים וכה״א (ישעיה ל״ג) מלך ביפיו תחזינה עיניך תראנה ארץ מרחקים:
Vaetchanan:22	צוהו על דברי קבלה. היינו תורה שבע״פ. ובספרי פנחס ה״ג בפי׳ צוהו על דברי תלמוד:
Vaetchanan:23	כי הוא יעבור לפני העם. מגיד שאין מעמידין פרנסים על הדור אלא אם נותנין עצמן עליהם כצ״ל:
Vaetchanan:24	אמר להם. היינו משה לישראל:
Vaetchanan:25	והשלישי וכו׳. ונשב בגיא וכו׳ וכתיב אחריו ועתה ישראל שמע אל החוקים היינו שיעשו תשובה:
Vaetchanan:26	אין אתם מחרישים. ובספרי ה״ג הרי אתם חדשים כבר מחלו לשעבר כי בעל תשובה כקטן שנולד דמי:
Vaetchanan:27	כגון החג שעשה ירבעם וכו׳ כצ״ל:
Vaetchanan:28	לעין לא נאמר. בילקוט ה״ג נגד העמים לא נאמר אלא לעיני העמים מלמד:
Vaetchanan:29	כי אתם המעט. מכל העמים:
Vaetchanan:30	כל מקום. שפקרו עיין רבה במקומו:
Vaetchanan:31	כל המפנה לבו לבטלה. דריש מסיפא דקרא ופן יסורו מלבבך:
Vaetchanan:32	אשר צוה וכו׳ לזכותכם וכו׳. כוונתו כי הלשון לעשות לא שייך על היו״ד דברות שהרוב מהן אין בהם עשיה רק בדרך שלילה כמו לא תרצח וכו׳ וכו׳ ע״כ אמר לעשות לזכותכם ע״כ הרבה להם מצות:
Vaetchanan:33	זו אזהרת הרהור עבודת גלולים. מסיפא דקרא כי לא ראיתם כל תמונה:
Vaetchanan:34	שאל פילוסופוס. (ע״ז נד:):
Vaetchanan:35	אלו שנים וכו׳. (סנהדרין לח:):<br>לה. ועשיתם הרע בעיני ה׳ אלהיך אשר אמר אנכי ה׳ אלהיך כצ״ל:
Vaetchanan:36	ולא היו עושין אלא להכעיס. דורש תיבת להכעיסו:<br>לו. ועשיתם הרע בעיני ה׳ אלהיך אשר אמר אנכי ה׳ אלהיך כצ״ל:
Vaetchanan:37	העיד בכם נוטה שמים וכו׳. עיין בראב״ע מה שכתב בזה:
Vaetchanan:38	מהר של מרי עלמא תתנ״ב שנה כצ״ל וכ״ה (בסנהדרין שם):
Vaetchanan:39	פירוש עובדי עבודת כוכבים. עיין בתרגום ובפרש״י שהכוונה אחרי כי יהיו משועבדים לעובדי והם עובדי עבודת כוכבים:
Vaetchanan:40	[]
Vaetchanan:41	ימצאו תשועה. כדכתיב ומצאת:
Vaetchanan:42	מצוה שלמה שאין בה דופי. אולי צ״ל אהבה שלמה שאין בה דופי וקאי על האבות:
Vaetchanan:43	לעולם שכולו טוב. עיין רש״י סוף חולין שאין בו לא היזק ולא יסורין אלא כולו טוב:
Vaetchanan:44	המזרח קולט. עיין (מכות י׳) אמר הקב״ה למשה הזרח שמש לרוצחים הכוונה לפי דברי המחבר כי כל הערים היו במזרח א״י. לא כפירש״י:
Vaetchanan:45	קולטין ממלאך המות. (מכות י׳) ע״ש מעשה לזה:
Vaetchanan:46	להיכן גולין למחנה לויה מכילתא משפטים פ״ד. הרי אתה דן נאמר מנוס לשעה ונאמר מנוס לדורות מה מנוס האמור לדורות ערי הלוים קולטות אף מנוס האמור לשעה מחנה לויה קולטת:
Vaetchanan:47	וכל הערבה כצ״ל. והביא פסוקים אלו וחסר הדרשות:
Vaetchanan:48	שמא כדומה להם אמר. ד׳ תיבות הללו אין להם ביאור. וברור כי ט״ס הוא. עיין שמות רבה פמ״ג הלשון כך אמרת בסיני אנכי ה׳ אלהיך אלהיכם לא נאמר לא לי אמרת שמא להם אמרת וכו׳ וכצ״ל הכא:
Vaetchanan:49	אמנון ביטל לא תנאף. בפסיקתא ה״ג זמרי ביטל לא תנאף:
Vaetchanan:50	עשרת הדברים כנגד י׳ מאמרות. בפסיקתא שם גירסות אחרות:
Vaetchanan:51	האב והאם. נמשלו לאדם כמאורות בזה נכון מאד הכתוב (משלי כ) מקלל אביו ואמו ידעך נרו באשון חושך:
Vaetchanan:52	כל שישנו בשמירה וכו׳. (ברכות כ:):
Vaetchanan:53	אלו כתות מלאכי השרת. דורש את כבודו על המלאכים שנקראו כבוד ה׳:
Vaetchanan:54	וכן אמרו חכמים. (עבודת כוכבים ה׳):
Vaetchanan:55	מכאן שהסכים הקב״ה. (שבת פ״ז.):
Vaetchanan:56	מכאן אמרו כל הדר בח״ל. (כתובות ק״י) ולומד שם מקרא לתת לכם את הארץ להיות לכם לאלהים:
Vaetchanan:57	השמיעה מביא לידי שמירה. ושמירה מביא לידי עשיה כנ״ל ה״ג:
Vaetchanan:58	ד׳ דברים היה ר״ע. ספרי ע״ש. ועיין (ר״ה י״ח:) קצת מזה. ובתוספתא סוטה פ״ו הוא בארוכה:
Vaetchanan:59	ואנחנו רבים לנו נתנה הארץ למורשה כצ״ל:
Vaetchanan:60	והארץ תירשו. בכאן חסר וכן חסר בספרי. ועיין בתוספתא מסיים על הדם תאכלו זה אבר מן החי ועיניכם תשאו על גלוליכם זה עבודת כוכבים ודם תשפכו כמשמעו עמדתם על חרבכם זה הדין והגזל. עשיתם תועבה זה משכב זכור ואיש את רעהו טמא זה גילוי עריות ומה מצות שנצטוו בני נח לא עשיתם ואתם אומרים נירש את הארץ:
Vaetchanan:61	והלכה זו. (ר״ה יח:):
Vaetchanan:62	גם אלה ד׳ דברים. כפי הנראה חסר כאן ולא מסיים הד׳ דרשות:
Vaetchanan:63	אמרו לו שמע ישראל. וקאי על יעקב:
Vaetchanan:64	שמו עלינו ביותר. דהוקשה לו הרי כתיב ה׳ אחד. ומה הוא אלהינו שמשמע רק הוא אלהי ישראל דוקא ע״כ אמר שמו עלינו ביותר כי יעקב בחר לו יה ועיין בספרי:
Vaetchanan:65	כענין שנאמר ואת הנפש וכו׳. וכי אם מתכנסים כל באי עולם לבראות יתוש אחד אינם יכולים אלא שהיה מגיירן וכו׳ כצ״ל:
Vaetchanan:66	ר׳ אלעזר אומר יש לך אדם וכו׳ כצ״ל (ברכות סא:):
Vaetchanan:67	ע״י יסורין. כי יסורין ממרקין עון:
Vaetchanan:68	ששמו של הקב״ה בו׳. במדרש תהלים מזמור צ״ד בבאורי (אות י׳) בארתי כי ה׳ הוא רחמים ואין הקב״ה מייחד שמו על הרעה כמו שמצאנו דרשתם גבי גדעון כשביקש שלא יהיה טל על הארץ רק על הגיזה לבדה כתיב ויהי כן סתמא ולא נזכר שם ה׳. אבל יסורין הם לטובה ע״כ כתיב כי ה׳ אלהיך מיסרך. ועיין בספרי הרבה דרשות בקבלת היסורין:
Vaetchanan:69	ואהבת וכו׳. שיהיה שם שמים וכו׳ (יומא פ״ו) ע״ש בארוכה:
Vaetchanan:70	ואהבת ובו׳. בכל לבבך אהבו כאברהם אבינו שנאמר אברהם אוהבו ואומר ומצאת את לבבו נאמן כו׳ כצ״ל כ״ה בספרי לפי גירסת הגר״א:
Vaetchanan:71	ובכל נפשך כיצחק שנעקד וכו׳ כצ״ל:
Vaetchanan:72	מאודך. כיעקב:
Vaetchanan:73	כיצר אני אוהבו ת״ל והיו הדברים האלה על לבבך (היינו שיהיו דברי תורה משוגרים בפיך) תן הדברים האלה על לבבך שמתוך כך אתה מכיר הקב״ה ומדבק בדרכיו כצ״ל:
Vaetchanan:74	ושלא תערב בהם דברים אחרים. בספרי מסיים שלא תאמר למדתי חכמת ישראל אלך ואלמוד חכמת יונית:
Vaetchanan:75	יצאו שבתות ויו״ט. (מנחות לז:):
Vaetchanan:76	על יד שמאל. (שם) ומסיים שם הקרא אף ידי יסדה ארץ וימיני טפחה שמים הרי שיד היא שמאל:
Vaetchanan:77	או שכתב האזכרות זהב. הא דנקט אזכרות דוקא. ע.ין מ״ס פ״א מעשה בתורתו של אלכסנדרא שהיו כל אזכרותיה כתובות בזהב ובא מעשה לפני חכמים ואמרו תגנוז:
Vaetchanan:78	יכול על מזוזה ממש. היינו שיכתוב על עובי הפצימין:
Vaetchanan:79	אינו רשאי ליטלה וכו׳. עיין (ב״מ ק״א) מעשה לזה שנענש מי שהוציאה:
Vaetchanan:80	זו אחד מד׳ בנים כצ״ל:
Vaetchanan:81	האל הנאמן לאברהם. כדכתיב ומצאת את לבבו נאמן לפניך:
Vaetchanan:82	שומר הברית ליצחק. (כראשית י״ז) ואת בריתי אקים את יצחק:
Vaetchanan:83	דבר שאין לו הפסק. עיין פרש״י וכן הוא (סוטה ל״א) עושה מיראה לאלף דור ומאהבה שני אלפים דור והמחבר מראה רק פשוטו של מקרא כדרכו לפעמים:
Eikev:1	זוכים לחיי עוה״ב כצ״ל:
Eikev:2	זהו בריתו של אברהם אבינו. שנאמר וכרות עמו הברית:
Eikev:3	משל לרופא וכו׳. מדרש תהלים מזמור ע״ג ע״ש כל הדרשא:<br>ג. אין מאחר צביונם. דורש חרצובות לשתי תיבות מאחר צביונם ועיין שם במדרש תהלים ובביאורי בס״ד:
Eikev:4	וכשם שאמר משה והיה עקב תשמעון. וסיפא דקרא ושמר לך את הברית והחסד כן אמר אסף אך טוב לישראל אלהים לברי לבב היינו לצדיקים:
Eikev:5	דאמר ר״ל וכו׳ (ע״ז י״ח.):
Eikev:6	עונות שאדם דש בעקביו בעוה״ז כצ״ל:
Eikev:7	על האדמה אשר ה׳ אלהיך נותן לך מכאן וכו׳ כצ״ל:
Eikev:8	כענין ואל בקצפך תוכיחני. ומלת אל מושך ג״כ על ובחמתך תיסרני כמו שהיה כתיב ואל בחמתך תיסרני:
Eikev:9	מדעת התורה. כי הפסוק מדבר לדורות הבאים ג״כ והאיך שייך לומר אשר ידעת כי רק דור שיצאו ממצרים ידעו. ומה גם כעת מדבר עם באי הארץ הדור החדש שלא יצאו ממצרים. ומביא ראיה מקרא הלא ידעת אם לא שמעת אלהי עולם וגו׳ ושם ג״כ הפירוש הלא ידעת מדעת התורה אם לא שמעת היינו משקול הדעת שאלהי עולם ה׳:
Eikev:10	שכך אמרו חז״ל (ב״מ ק״ז):
Eikev:11	תכלה אותם. וע״ז שייך לשון אכילה כמו הסנה איננו אוכל:
Eikev:12	לא תחמוד וכו׳. מכאן אמרו וכו׳ (ע״ז נ״ב.) שמואל רמי כתיב לא תחמוד וכתיב ולקחת לך (סיפא דקרא דהכא) הא כיצד פיסלו לאלוה לא תחמוד פסלו מאלוה היינו שבטלו אז ולקחת לך והם כמו דברי המחבר:
Eikev:13	כל היודע בטיב ע״ז. (ע״ז מג.) והיינו עובד כוכבים קטן אינו יכול לבטל:
Eikev:14	כל שכיוצא בו נעבד (שם מ״א) ע״ש כל הסוגיא:
Eikev:15	כיצד היו קוראין אותה (שם מו):
Eikev:16	ולא היה נעצר להם. פי׳ אף שהיה יורד בכל יום אעפ״כ לא היה מתקיים מיום ליום וזה היה העינוי שלהם כמו שמסיים:
Eikev:17	לא בא לרגלך צוקה. דורש בצקה לשון צוק וצרה. ועיין בתרגום שתרגם ומסנאך לא יחיפו פי׳ כפי הענין ולא כפי המלה:
Eikev:18	מרוב שלמות. היינו מרוב בגדים שהיה להם. ועיין ראב״ע שמביא פי׳ זה והרמב״ן דחה דבריו:
Eikev:19	קמחי דחיטי ר״י אמר בפה״א וכו׳ כצ״ל:
Eikev:20	רב ושמואל וכו׳. (ברכות לו:) כל שיש בו מה׳ מינים:
Eikev:21	והשותה שמן זית לבדו. (ברכות ל״ה) אי דשתי לי׳ אזוקי קא מזיק ע״כ אינו מברך כלל:
Eikev:22	תבשיל של שלק וכו׳. היינו שאין נאכלין כמות שהן חיין ע״כ אם בשלו מברך במ״מ:
Eikev:23	אע״פ שיש בו חלב ודבש וכו׳. כי קמח הוא העיקר:
Eikev:24	ומי שנסתפק לו אם בירך וכו׳. אם משבעת המינים שהם דאורייתא צריך לברך. ספק התפלל אל יתפלל שתפלה דרבנן וכן כוונתו הכא:
Eikev:25	ושנו חכמים הנוטל ידיו וכו׳ (סוטה ד:):
Eikev:26	כדי שתצא הזוהמא. (רש״י שם). 
Eikev:27	ואין נוטלין מיד ליד אפילו מן הנהר וכו׳. שאין כאן לא נטילה ולא טבילה והוא כדברי הרשב״א עיין שו״ע א״ח:
Eikev:28	אר״נ משה תיקן כו׳ (ברכות מח.):
Eikev:29	שכל אדם שיש בו גסות הרוח. (סוטה י):<br>כט. מה הם בנביא.לדעתי צ״ל הגירסא להיפך שקאי על קרא דהכא העידותי בכם היום מה אתם בנביא כדכתיב העידותי אף הגוים בנביא כי מצאנו כמה נבואות שניבא ירמיה ושארי נביאים על האומות. ועיין איכה רבתי בא״ב תנינא בפסוק הפך עלי בלהות הלשון כגוים אשר ה׳ מאביד מפניכם מה אלו בכהן ונביא אף אלו בכהן ונביא:
Eikev:30	של מה שזוממין. היינו מה שחושבין:
Eikev:31	ג׳ פעמים למה. פי׳ ג׳ פעמים כתוב הלשון צדקת:
Eikev:32	ולהלן הוא אומר ושני הלוחות בידו. היינו ביד אחת:
Eikev:33	לא נתכוון משה. קאי על סיפא דקרא ואשליך את עפרו אל הנחל:
Eikev:34	גדולה תפלה ממע״ט (ברכות ל״ב):
Eikev:35	לוחות שהיה שניהם שוים. בתנחומא לחת כתיב חסר שלא היו גדולים זה מזה אלא שניהם שוים והיתה פסולת שניהם שוים:
Eikev:36	ד״א אבנים. משום שם רועה אבן ישראל כצ״ל. ופי׳ דורש אבנים לשון יסוד (עלעמענט) כמו משם רועה אבן ישראל ג״כ הכוונה יסוד ישראל:
Eikev:37	זה שאמר הכהוב יקר בעיני ה׳. עיין ילקוט חוקת בשם הילמדנו כי הפסוק הזה נדרש על מיתת בני אהרן:
Eikev:38	לשרתו וכו׳ מקיש וכו׳ אף ברכת כהנים בכשרים ותמימים. דברי המחבר צ״ע כי אם נלמד מקרא דהכא לפסול בברכת כהנים בעלי מומים להקיש לשירות היה לנו לפסול אף מומין שבסתר ובאמת פסולי מומין בברכת כהנים הוא רק במום שבגלוי (מגילה כ״ד) כל כהן שיש בו מום אינו עולה לדוכן מפני שהעם מסתכלין בו וכן מסיים בגמ׳ מומין שאמרו דווקא בפניו ידיו ורגליו:
Eikev:39	אלו מ׳ דאחרונים. דכתיב ויאמר ה׳ קום לך למסע לפני העם וכו׳ והוא אחר שנתרצה הקב״ה מעון העגל והוא אחרי מ׳ האחרונים שניתן הלוחות השניים:
Eikev:40	משל לאדם שמבקשין ממנו וכו׳ (ברכות ל״ג):
Eikev:41	אמר ר׳ יוחנן כל מקום וכו׳ (מגילה לא.):
Eikev:42	מהם זקנים יוצא מצרים. היינו אותן שהיו יותר מבן ס׳ בעת יציאתם ממצרים לא נגזרה עליהם גזירה:
Eikev:43	היה מדבר עמם פא״פ. קאי על הפרשה הראשונה שמע ישראל אתה עובר היום וכו׳:
Eikev:44	וא״י נקראת ארץ וכו׳. כן הוא (תענית ט) ודורש א״י משקה אותה הקדוש ברוך הוא בעצמו וכל העולם ע״י שליח שנאמר הנותן מטר על פני ארץ זו א״י ושולח מים היינו ע״י שליח על פני חוצות הוא כל העולם כולה:<br>מד. הרי זה קרוי ד׳ שמות. לעיל סוף פרשת דברים:
Eikev:45	ואע״פ שהיתה מפסולת א״י. עיין לעיל בפ׳ דברים והאמורי יקראו לו שניר הוא שלג ומפני הקרירות יקרא חרמון לשון חרם שאינו מוציא פירות וזה שאמר שהיתה מפסולת של א״י:
Eikev:46	וכן בכ״מ כמו ודנה וכו׳. מביא ראיה כי קרית סנה הוא ג״כ קרית ספר אשר דביר נקראת על שמה. והכל מחביבות המקום נקרא כמה שמות. וראיתי מי שכתב שקרית סנה וסנה בלשון ערבי לימוד ושנון כמו בעברי קרית ספר:
Eikev:47	קלה להוציאה פירותיה (כתובות קיב):
Eikev:48	מקום נמוך שותה. ששם אין גשמים רק מה ששותה מנהר נילוס:
Eikev:49	ואלו הן הארצות. היינו שי״ב פעמים נאמר בקרא ארץ. בכאן חסר ובספרי חשיב כולם כסדר:
Eikev:50	למטר השמים וכו׳. שיהיה עננים וכו׳ חסר כאן ועיין ספרי:
Eikev:51	להפריש ממנה חלה וכו׳. כי הוא חובת הארץ דוקא:
Eikev:52	עתים לטובה עתים לרעה וכו׳. (ר״ה י״ז:) ע״ש:
Eikev:53	וכי התבואה וכו׳. וכי תבואה עומדת בארץ כל השנה הרי נקצרת בזמנה. ובספרי הגי׳ וכי יש פירות בשדה כל השנה:
Eikev:54	שכל שנה שרשה וכו׳. (ר״ה טז):
Eikev:55	שנתחייבו בתלמוד קודם המעשה. פי׳ אף קודם שבאו לארץ והיו מצות שלא היו נוהגות במדבר אבל בתלמוד תורה נתחייבו תיכף בקבלת התורה:
Eikev:56	כי ריב לה׳ עם. עם יושבי הארץכי אין אמת ואין חסד כצ״ל ומה שבנתיים מיותר:
Eikev:57	גדול ת״ת שקודם לחלה (קידושין מ):<br>נז. כשומע מפי חכם כשומע מפי משה כשומע מפי הקב״ה כצ״ל:
Eikev:58	אשר אנכי מצוך היום. היא דרשה בפני עצמה:
Eikev:59	שלא יהא לבו של אדם חלוק וכו׳. היינו שלא יהרהר בדברים אחרים. ובספרי ה״ג אזהרה לכהנים שלא יהרהרו בשעת עבודה שלא לפסול הקרבן:
Eikev:60	יורה שמורה הבריות (תענית ו׳):
Eikev:61	שלא תהא מצטער. דורש בשדך שהוא מיותר משדה שלך יהיה גם כן עשב לבהמתך:<br>סא. ועשב לעבודת האדם. ופשתן האדם עובד בו ועושה ממנו בגדים:
Eikev:62	כשבהמתך אוכלת ושובעת. כוונתו כי ואכלת ושבעת קאי ועל ונתתי עשב בשדך לבהמתך וע״י זה עובדת בכח וזו ואכלת ושבעת:
Eikev:63	אלא שמאחרין הטובה וכו׳. מכילתא יתרו פרשה ו׳ ודורש אחרים לשון איחור:
Eikev:64	שומעני שהם כלים מהעולם כצ״ל וכ״ה בספרי:
Eikev:65	מה להלן חרב וכו׳. בספרי מסיים פסוקים חרון אף על כל החמשה מיני פורעניות:
Eikev:66	שיהיו עננים טעונים גשמים ועומדין כצ״ל:
Eikev:67	ק״ו למי שלא נאמר בו מהרה. והיינו האומות ובספרי מסיים הקרא (יחזקאל ל״ח) מימים רבים תפקד באחרית השנים:
Eikev:68	דומין ליום. דורש כימי השמים כיום שהוא מאיר:
Eikev:69	אין עץ אלא תורה וכו׳. והרי הדברים ק״ו ומה אם התורה שלא נבראת אלא לכבודן של ישראל הרי היא קיימת לעולמי עולמים ק״ו לצדיקים שבשבילם נברא העולם כצ״ל וכ״ה בספרי:
Eikev:70	ונוח לאבדן ככלי זכוכית (חגיגה טו) וחסר לשון כאן לא יערכנה זהב וזכוכית וכלי פז אלו דברי תורה שקשים לקנותן ככלי זהב ופז ונוח לאבדן ככלי זכוכית כצ״ל:
Eikev:71	והאיך הוא עצל אחרי שקנה שדה וכרם אלא מפני שהוא לא השביחן כצ״ל ופי׳ ויתקלקל אח״כ וכ״ה בספרי המאמר בארוכה:
Eikev:72	אם שמע אדם וכו׳ קאי על הקרא כי אם שמור תשמרון שאם שמע דבר מדברי תורה ראשון ומקיימו כשם שהראשון מתקיים בידו כך האחרונים מתקיימין בידו כצ״ל:
Eikev:73	שלא יאמר וכו׳. בספרי הלשון שלא תאמר הריני לומד פרשה קשה ומניח את הקלה כו׳ אלא כל המצוה הזאת מדרש הלכות ואגדות והמחבר קיצר בלשון:
Eikev:74	גם אני מרבה אבי שבשמים. וזהו ולדבקה בו. ועיין ראב״ע שכתב לזה סוד גדול. ועיין רמב״ן:
Eikev:75	מה שדין עליכם. הלשון אינו מדוקדק. והכוונה המצות שצויתי אתכם:
Eikev:76	לרבות מסייעיהן. דורש את כל הגוים כל לרבות שירצו לעזור אותם אף הם. יפלו. וכמו שמצאנו (יהושע ט) ויהי כשמוע כל המלכים כו׳ וכולם נפלו בחרב יהושע:
Eikev:77	ולא מן כל המדבר. שהמדבר בעצמו אינו ארץ ישראל:
Eikev:78	אפילו כעוג. דריש איש המיוחד:
Re'eh:1	דאמר ר״א מ״ד אשרי איש וכו׳. (ע״ז יט.) ושם בשם ריב״ל ע״ש:
Re'eh:2	ילך אדם וכו׳. ת״ל ובחרת בחיים למען תחיה אתה וזרעך כצ״ל:
Re'eh:3	האוהב את הטובה. חסר קרא וכצ״ל מות וחיים ביד לשון ואהביה יאכל פריה וע״ז קאי האוהב את הטובה אוכל פירותיה. וכ״ה בספרי לפי גי׳ הגר״א:
Re'eh:4	וכד״א נצור לשונך מרע. ורישא דקרא מי האיש החפץ חיים:
Re'eh:5	לא הוכיח משה וכו׳. קאי על הקרא ראה נותן לפניכם היום דוקא אחרי שראו הטובות וכבשו ארץ סיחון ועוג וקרוב היה למיתתו וכן גבי יעקב:
Re'eh:6	מכאן אמרו כל המודה בעבודת כוכבים. מסיפא דקרא ללכת אחרי אלהים אחרים:
Re'eh:7	ונתתה את הברכה. (סוטה לז) וכ״ה בספרי וכצ״ל ונתתה את הברכה וכו׳ מה תלמוד לומר והלא כבר נאמר אלה יעמדו לברך וגו׳ על הר גריזים ואלה יעמדו על הקללה בהר עיבל אלא מקיש וכו׳ כצ״ל:
Re'eh:8	מה קללה בקול רם דכתיב בפירוש וענו הלוים וכו׳ קול רם:
Re'eh:9	כשם שהקללה בלה״ק. דילפינן קול קול ממשה:
Re'eh:10	מעבר הידדן ואילך דברי ר״י. (סוטה שם) ופי׳ רחוק הרבה מהירדן לצד מזרחי מדכתיב אחרי דרך וכ״מ שנאמר אחרי מופלג:
Re'eh:11	אף אלון מורה. האמור כאן (אצל אלוני מורה) הוא שכם:
Re'eh:12	משאתם עוברין את הירדן. היינו נסים של ירדן יהיה סימן בידכם שתבואו ותירשו את הארץ:
Re'eh:13	בשכר שתירש תשב. היינו שתגרש כל הגוים אז תוכל לישב:
Re'eh:14	תפיסת ידי אדם. היינו שהאדם נטעו:
Re'eh:15	ג׳ בתים הם. (ע״ז ג״ז):
Re'eh:16	דושנה של יריחו. שהוא ת״ק אמה על ת״ק אמה כמו מקום המקדש ונתנו כל אותן השנים קודם שנבנה הבית לבני קני וכו׳:
Re'eh:17	וכתוב אחד אומר ויתן דוד לארונה כו׳ משקל שש מאות כצ״ל:
Re'eh:18	בשתי מעשרות. מעשר בהמה ומעשר דגן (היינו מעשר שני) לאכול לפנים מן החומה בירושלים:
Re'eh:19	במחיצה. פי׳ שאין צריך לאכול במקדש דוקא אלא בירושלים בכל העיר. וזה לא קאי על חטאות ואשמות שנאכלין במקדש:
Re'eh:20	מטלטלין את המשכן. פי׳ כי במשכן היו מקריבים בכ״מ שעמדו במסע אבל אח״כ משעברו הירדן ובאו לשילה נאסרו במת יחיד להקריב בכ״מ שירצו רק בשילה:
Re'eh:21	מלמד שהיחיד מקריב בבמה וכו׳. היינו נדרים ונדבות:
Re'eh:22	רש״א היום אנו מקריבים. סובר שבמשכן לא הקריבו אלא פסח וחובות הקבועה להם זמן אבל חטאות ואשמות לא קרבו:
Re'eh:23	לא תעזבו כו׳. עיין ג״כ ברמב״ן כי בעת שהיו במדבר אסורים היו בבשר תאוה ואם אכלו אכלו רק שלמים. וגם לא היו להם מחיצות כי היו מותרין לאכול בכל המחנה. ולא היו מחוייבים לעלות לרגל. ע״כ אמר כי כל המצות יעשו בירושלים:
Re'eh:24	אנחנו כמו שאמר דניאל חטאנו וכו׳. וח״ו הוא לא חטא:
Re'eh:25	ר״י אומר ג׳ מצות וכו׳. (סנהדרין כ:) וצ״ל להעמיד להם מלך ולהכרית זרעו של עמלק ואח״כ לבנות להם בית הבחירה ובכאן ט״ס:
Re'eh:26	במה הכתוב מדבר. אם בבשר תאוה להתירה בלא הקרבת אימורין כבר נאמר לקמן בפ׳ כי ירחיב ספרי:
Re'eh:27	ת״ל רק ורק מיעוטא הוא. ומסתברא כי מום עובר אין פודין וממתינין עד שיעבור ומקריבין אותו:
Re'eh:28	תזבח ולא גיזה. בשר ולא חלב ואכלת ולא לכלביך כצ״ל וכ״ה בבכורות:
Re'eh:29	ונפדו יהיו אסודין. פי׳ כי אין קדשים חלין על בעלי מומין וקדוש רק קדושת דמים:
Re'eh:30	שאינו נוהג בכל הולדות. רק בפטר רחם:
Re'eh:31	שיצא מכלל המתנות. ופטורין מזרוע ולחיים והקיבה:
Re'eh:32	כדם המוקדשין. שבמוקדשין הקיש דם לחלב מה חלב בשני לאוין אף דם בשני לאוין:
Re'eh:33	על הארץ תשפכנו כמים לא לתוך המים וכו׳ כצ״ל:
Re'eh:34	אף דם מכשיר את הזרעים. היינו דם זה של פסולי המוקדשין אבל דם קדשים אינן מכשירין:
Re'eh:35	לא יהיה לך רשות. בספרי יכול אני אבל איני רשאי. וכן כוונת המחבר:
Re'eh:36	אבל הנותן מתנה. ואינו אוכל פטור:
Re'eh:37	וכי מה בא ללמדנו. (מכות י״ז):
Re'eh:38	עד שלא קרא עליהן שעובר בעשה כצ״ל. והיינו שלא קרא הפרשה ארמי אובד אבי:
Re'eh:39	בכור שאסור לזרים. אינו כדין כ״ה ג״כ בספרי. ותמוה הוא הרי מכאן הוא הלימוד שבכור אסור לזרים. והז״א על הספרי הגיה בכור קדושתו מרחם. ולדידי ברור שהכל ט״ס וצ״ל הג׳ כמו שהוא במכות שם אר״ש וכי מה זה בא ללמדנו אם לאוכלן חוץ לחומה ק״ו ממעשר אם לפני זריקה ק״ו מתודה ושלמים הרי לא בא הכתוב אלא לאוכל מן הבכור אפילו לאחר זריקה (היינו זר) שהוא לוקה וכצ״ל. הכא והשאר נמחק:
Re'eh:40	חוץ לקלעים. ואזהרת עשה מצאנו בה במקום אחר במקום קדוש תאכל בחצר אהל מועד:
Re'eh:41	אלא לאוכל מעולה. היינו אף. כהן האוכל:
Re'eh:42	כי אם לפני ה׳ אלהיד זה שילה כצ״ל:
Re'eh:43	תן לו מחלקו. היינו מעשר ראשון:
Re'eh:44	ואפילו שמטין ויובלות. שאין בהם מעשר תן לו בתורת צדקה:
Re'eh:45	על אדמתך ולא בגולה. היינו בח״ל אינו מוזהר עליו יותר משאר עניי ישראל:
Re'eh:46	עשה מצוה האמורה בענין ובו׳. יש לפרש כמו שאמרו בויק״ר פ״ה אר״א כתיב השמר לך פן תעזוב את הלוי וגו׳ וכתיב בתריה כי ירחיב ה׳ את גבולך וגו׳ אמר הקב״ה לפי מתנתך מרחיבין לך:
Re'eh:47	מה דבר לך את הקני ואת הקנזי ואת הקדמוני כצ״ל כי לאברהם הבטיח ה׳ עשרה אומות ולישראל לא נתן רק ז׳ אומות ולעתיד יתן להם עוד ג׳ קני קנזי וקדמוני וזה כאשר דבר לך:
Re'eh:48	ר״י אומר מניד שבשר תאוה וכו׳. (חולין טז:):
Re'eh:49	ר״ע אומר לא בא הכתוב וכו׳. ט״ס כאן וכצ״ל ר״ע אומר לא בא הכתוב אלא לאסור להם בשר נחירה שמשנכסו לארץ נאסר להם בשר נחירה (שהותר להם בז׳ שכבשו) ואח״כ דברי ראב״ע לא בא הכתוב אלא ללמוד ד״א שלא יאכל בשר אלא לתאבון וכו׳ וכ״ה בספרי לחולין שם:
Re'eh:50	שי״ן רוב וכו׳. אשר דורש נוטריקון:
Re'eh:51	וכי מה בא הכתוב ללמדך מצבי ואיל כצ״ל:
Re'eh:52	להגיד מה גרם. פי׳ מאיזה טעם נאסר להם (ז״ר) והרבה יש כזה בדברי המחבר:
Re'eh:53	זה הדם מן החי. ולעבור עליו בשני לאוין:
Re'eh:54	אר״ש. (מכות כ״ג) ושם הג׳ ר״ש ברבי:
Re'eh:55	ונדריך תשא. היינו שהוא חייב באחריותן וע״ז קאי קדשים כו׳:
Re'eh:56	אם אין דם. (זבחים ק״ד.) פי׳ שאם אין דם אין מקריבין האימורים למזבח:
Re'eh:57	אף בשר בזריקה. הא למדת שריוח יש בין כבש למזבח שמשם היה זורק האימורים:
Re'eh:58	כל מקום שאתה רוצה לבנות וכו׳. חסר כאן וכצ״ל לפי שנאמר בפרשת שופטים וישבת בעריהם ובבתיהם יכול א״א רשאי להוסיף על הבנין ת״ל וישבת בארצם כל מקום שאתה רוצה לבנות בנה:
Re'eh:59	כשם שהם יוצאין בבגד ארגמן. הוא בגד מיוחד לכומרי עובדי כוכבים. ועיין (מגילה כ״ז) האומר איני עובד בצבועין כו׳ חיישינן שמא מינות נזרקו בו:
Re'eh:60	הא אינו חייב וכו׳. כאן ט״ס וגם הפיסקא באמצע ט״ס והכתוב לא תעשון כן לה׳ וכו׳ נמשך הכל דרשה אחת וכן הגיה הגר״א בספרי. וכצ״ל ואעשה כן גם אני לא תעשון כן לה׳ אלהיך. יש כאן לעבודת כוכבים ויש כאן לעבודת המזבח. מכל דבר שמקריבין אותו לעבודת כוכבים אין מקריבין כיוצא בו לעבודת כוכבים ואם הקריב חייב ואין מקריבין כיוצא בו לגבי מזבח ואם הקריב פטור. יכול אם הם היינו העובדי כוכבים מקריבין חטאות ואשמות לא יהיה מקריבין למזבח ת״ל כי תועבת ה׳ אשר שנא וכו׳ לא נתכוון הכתוב אלא בדבר שהקב״ה שונא אותו כצ״ל:
Re'eh:61	לפני כלבו. הכוונה לפני ע״ז שלו וקראו כלבו בלשון גנאי (ז״ר) ואכלו פי׳ הקריבו:
Re'eh:62	ליתן ל״ת על כל עשה. דורש תשמרו לעשות. וכל מקום שנאמר השמר לא תעשה:
Re'eh:63	מכאן אמרו וכו׳. מתן א׳ במתן ד׳ פלוגתא דר״א ור׳ יהושע (זבחים פ״י):
Re'eh:64	מנין שאין מוסיפין וכו׳. פי׳ להוסיף על גוף המצוה הכחובה בתורה כמו לולב וציצית שלא יפחות מד׳ ולא יוסיף על ד׳ כמו שמסיים. וזה שנאמר בפ׳ ואתחנן לא תוסיפו על הדבר ולא תגרעו ממנו הכוונה שלא יוסיפו על התרי״ג מצות מצוה חדשה או לבטל איזה מצוה מתרי״ג מצות כי מתחלה אמר שם שמע אל החוקים ואל המשפטים אשר אנכי מלמד אתכם לעשות ועל זה קאי לא תוסיפו על הדבר אשר אנכי מצוה אתכם (הגר״א באדרת אליהו):
Re'eh:65	רבי יוסי הגלילי אומר בוא וראה. (סנהדרין צ.):<br>סה. מפרסמין את החניפים. (יומא פ״ו):
Re'eh:66	זה הענן.לא ידעתי לפרשו וט״ס ואולי צ״ל כמו שהוא בספרי אחרי ה׳ תלכו זו מ״ע:
Re'eh:67	לא אונס וכו׳. מלת ההוא דריש למעט (הגר״א בא״א):
Re'eh:68	שאפילו אין עליך אלא שפדך מבית עבדים די כצ״ל:
Re'eh:69	נאמר כאן הדחה. (סנהדרין פ״ט):
Re'eh:70	כענין שנאמד אשר הסתה אותו איזבל אשתו. ותרגם יונתן דאטעית יתיה איזבל אתתי׳:
Re'eh:71	או אשת חיקך זו נשואה. כדכתיב משוכבת חיקך ואומר ואתנה נשי אדוניך בחיקך. ועיין פרש״י:
Re'eh:72	אומות העולם וכו׳. דריש מדכתיב ואבותיך:
Re'eh:73	אע״פ שהזהרתיך וכו׳. דורש לא תאבה לא תהא תאב לו ותאהבנו כפרש״י (ואולי אבה משורש אהב מאותיות המתהפכות כמו כבש כשב):
Re'eh:74	מכאן אמרו מחזירין מחזירין וכו׳. (סנהדרין לב.):
Re'eh:75	אלא לא מת באבן אחד יומת באבנים הרבה כצ״ל:
Re'eh:76	ונאמר להלן הדחה. גבי נביא שקר:
Re'eh:77	משמרין אותו וכו׳. (סנהדרין פ״ט.):
Re'eh:78	כדבר הרע הזה יצא המגפף וכו׳ כצ״ל:
Re'eh:79	מכאן אמרו מדכתיב באחת עריך אין עושין ג׳ עיירות מודחות בא״י יכול אף שתים לא ת״ל עריך (לשון רבים) ושתים עושין כצ״ל:
Re'eh:80	שלא נתנה לבית דירה. שלא נתחלקה לשבטים:
Re'eh:81	ולא יושבי עיר אחרת. שצריך להיות המדיחין מתוכה (סנהדרין קי״א):
Re'eh:82	ודרשת וחקרת ושאלת היטב ונאמר והוגד לך וכו׳ ודרשת היטב וכו׳ כצ״ל:
Re'eh:83	לרבות גרים וכו׳. נעשתה התועבה הזאת בקרבך לרבות גרים ועבדים וכו׳ כצ״ל:
Re'eh:84	מכאן אמרו החמרין וכו׳. (סנהדרין קי״א):<br>פד. הרי אלו מצילין אותם. פי׳ אם רוב אנשי העיר הדיחו והחמרין והגמלין משלימין המועט ואותן אותן רוב הרי אלו מצילין אותם שאין ממונם אבד אלא נידונין כיחידים (רש״י):
Re'eh:85	מכאן אמרו נכסי צדיקים. (שכ.) ונכסי צדיקים היינו אותם שבעיר שלא הודחו עמהם:
Re'eh:86	לא בהמת הקדש. היינו בכורות ומעשרות שבתוכה (תמורה ח.) והכוונה אף שיש להם חלק בגוה ולא ממעטינן ליה מקרא דלקמיה ולא שלל שמים:
Re'eh:87	וכתבי קדש. היינו מה שכתבו קודם שהודחו. אבל אם כתבו אח״כ ס״ת שכתבו מין ישרף:
Re'eh:88	מכאן אמרו מקל וכו׳. (ע״ז מ״ט.):
Re'eh:89	א״ר יהורה אם נוהגים וכו׳. (קדושין ל״ו):
Re'eh:90	יכול לא יהיו חייבין וכו׳. (מכות כ:):
Re'eh:91	ונאמר להלן לא תזבח שור ושה אשר יהיו בו מום מה להלן וכו׳ כצ״ל. ודע כי בספרי הובא ג״כ דברי ר׳ אליעזר מנין לצורם אוזן בכור ואוכל ממנו עובר בל״ת שנאמר לא תאכל כל תועבה ועיין (בכורות לא.) ומי קניס ר״א לעולם. ובתוס׳ הקשו ע״ז הרי בספרי הכא סובר ר״א דמדאורייתא אסור. והנה רש״י בחומש מביא דברי הספרי והרב המזרחי הרבה לפלפל בדברי רש״י גם הזרע אברהם מפרש הספרי אולם כפי הכלל שכתב הרא״ש במס׳ ב״ק בפרק מרובה בפיסקא צינור שחקקו וז״ל וטובא איכא מילי דרבנן דאסמכוה רבנן אקראי בת״כ כגון מעשר פירות וירק ודריש להו בספרי מקראי. ובזה ספו תמו כל הפלפולים בזה. ויונח ג״כ דעת נפש היפה. דברי התוס׳ (תמורה ד:) ד״ה רבא שכתבו הלשון ובזה ניחא למה לא נאסר צרם אוזן בכור מכל מה שתעבתי לך הרי הוא בבל תאכל כמו בשר וחלב. שח״ו לומר שנעלם מהם דברי הספרי ומה גם כי בבכורות הביאו בעצמם דברי הספרי. אך הכל כפי הכלל שכתבתי בשם הרא״ש. ורבינו הגר״א בא״א הביא על האי קרא שלא תאכלו כל תועבה כל שתעבתי לך הרי הוא בבל תאכל לימד על בשר בחלב שאסור בהנאה ד״א על פסולי המוקדשין והשמיט הך דצרם אוזן בכור. ואכמ״ל:
Re'eh:92	ריה״א זה שור הבר. (חולין פ״ו) ושם ר׳ יוסי סתמא וסובר מין חיה הוא וחלבו מותר:
Re'eh:93	מלמד שחיה בכלל בהמה (חולין עא.):
Re'eh:94	למדנו לבהמה טמאה. היינו שאין לה שום סימן טהרה:
Re'eh:95	למרנו מצות עשה סן הכתוב ומצות ל״ת מק״ו. כבר עמד הרמב״ן בפ׳ שמיני הלא אין מזהירין מן הדין וכן אמרו גבי אחוחו בת אביו ואמו שאסור הכתוב והוצרך לרבות אף שבאה מק״ו מהכתוב שאסר אחותו בת אביו או בת אמו כדאיתא בסנהדרין ובמכות. עיין ברמב״ן התירוץ השני. והנה המזרחי הרבה לפלפל בדברי הרמב״ן ולדחותו. והנה הרב המגיד תירץ דהא דאמרינן אין מזהירין מן הדין אלא במידי דלית ביה איסורא דאורייתא בביאור אבל כאן כיון שיש לנו עשה בפירוש מקרא אז הל״ת שהוא מק״ו נוכל ללקות עליו וזה הטעם שחזר הספרי הכא נמצא מצות עשה שלהם מן הכתוב ול״ת מק״ו ודברים של טעם הם. גם הז״א מפרש הספרי פלפל הרבה בזה. ואענה גם אנכי את חלקי בזה בס״ד. הנה הטעם שאין מזהירין מן הדין הובא בקיצור כללי הש״ס הטעם לפי שק״ו נדרש מעצמו ולפעמים שהוא טועה בסברא והדין פריכא ולאו אדעתין ואין כח ביד חכמים לענשו מלקות מק״ו (זולת ממון יכולין לחייבו) והנה משונה ק״ו זה מכל ק״ו דעלמא כי זה לשון הקרא הכא וכן בפ׳ שמיני. אך את זה לא תאכלו ממעלה הגרה וממפריסי הפרסה. את הגמל כי מעלה גרה הוא ופרסה איננו מפריס טמא וכן גבי שפן וארנבת. ואת החזיר כי מפריס פרסה הוא ושוסעת שסע פרסה והוא גרה לא יגר וכו׳ אשר באמת קשה למה היה להתורה לכתוב הסימני טהרה כי מעלה גרה הוא וכן גבי חזיר כי מפריס פרסה הוא יגיד הכחוב הסימן טומאה והיה די. ויותר הלשון כי בוודאי מיותר יכתוב הקרא מעלה גרה הוא ופרסה לא הפריס וכן להיפך גבי חזיר. וכבר ידוע כי מלת כי משמש בד׳ לשונות ונוכל לפרשו ג״כ בלשון דלמא ויהיה כוונת התורה כי מעלה גרה הוא בלשון דלמא. בל תאמר אחרי כי יש לו סימן טהרה כי מעלה גרה הוא יהיה טהור אעפ״כ אני אוסרו ופרסה לא יפריס וכן להיפך גבי חזיר כי מפריס פרסה הוא בל תאמר אחרי שיש לו סימן טהרה כי מפריס פרסה הוא יהיה טהור אעפ״כ אני אוסר והוא גרה לא יגר הרי מי שיש לו שני סימני טומאה מבואר בהדיא בקרא כי טמא הוא ואין צריך לק״ו. כי מהפסוק הראשון גבי גמל מבואר איסורו בהדיא אחרי כי התורה אמרה בל תביט להתירו אף שיש לו סימן א׳ טהרה רק אם יש לו סימן א׳ טמא טמא הוא. מבואר בהדיא כי בשני סימני טומאה טמא הוא לא כן גבי אחותו כי בקרא כתיב רק אחותו בת אביו או בת אמו והנה אחותו מאביו ואמו אם תרצה לאוסרה הוא רק מכח ק״ו מה אחותו בת אביו שלא בת אמו בת אמו שלא בת אביו אסור ק״ו אחותו מאביו ואמו. ע״ז אמר אין מזהירין מן הדין כי אין לנו לענוש ע״י ק״ו גרידא שנלמוד כי אולי נטעה בסברא וכל הדברים האלו נוכל לכוון בדברי הרמב״ן בתירוץ השני רק קיצר בלשונו ומוצל הוא רבינו הרמב״ן מהשגות המזרחי כי משונה ק״ו זה מק״ו דאחותו. ומה שמסיים הספרי נמצא מ״ע מן הכתוב ומצות ל״ת מק״ו לרווחא דמלתא היינו להראות לשון הלאוי״ן את הגמל וכו׳ ופרסה לא הפריס וגבי חזיר ולא גרה וכו׳ כי בלשון לא הוא הלאוי״ן:
Re'eh:96	אר״ע וכי משה קניגי היה וכו׳. (חולין ס:) ע״ש כי עיקר הקושיא הוא על השסועה שהיא בריה בפני עצמה:
Re'eh:97	לרבות צפור המשולחת. (קדושין כ״ז) ע״ש מסקנת רבא כי לא אמרה תורה שלח לתקלה:
Re'eh:98	והראה ואת האיה כצ״ל:
Re'eh:99	זו ביצתה. (חולין ס״ד:):
Re'eh:100	ועורב הבא בראש היונים. (שם ס״ג) וע״ש בגמ׳ דדמי רישיה לדיונה:
Re'eh:101	כל עור. וכו׳. הא טמא לא תאכלו לאו הבא מכלל עשה עשה. כה״ג לפנינו בספרי. והר״ן בשו״ת סי׳ נ״ו הביא הגירסא כל עוף טהור תאכלו זו מצות עשה וכה״ג בילקוט. ובזה דחה דעת הרמב״ם דסובר דרבית עובד כוכבים מ״ע לקבל מדרשתם לנכרי תשיך זו מ״ע ואומר כמו הכא כל עוף טהור תאכלו זו מ״ע בודאי הכוונה רק הא טמא לא תאכלו (כי מאי שייך מ״ע לאכול צפרים) כן התם לנכרי תשיך זו מ״ע ג״כ הכוונה הא לישראל לא. זו מ״ע. ודבריו נכונים מאד ע״כ העתקתי אותם כאן אף שאין זה מקומו. אחרי עבור זמן רב מצטער הייתי בדברי הרמב״ם ז״ל שפי׳ לנכרי תשיך זו מ״ע הלא פשוטו של מקרא הוא רק עצה טובה לאחיך לא תשיך ולנכרי רשאי לשוך. ועתה מצאתי דוגמא לזה (ערכין כט:) המוכר את שדהו בשעת היובל אינו מותר לגאול פחות משתי שנים וע״ש בגמרא מוכר קאי בעשה דכתיב במספר שני תבואות ימכר לך לוקח נמי קאי בעשה דכתיב שנים תקנה והנה בפסוק זה הוא נותן רק עצה טובה ע״ש ברש״י בחומש וז״ל זהו פשוטו של מקרא על האונאה בא להזהיר כשתמכור או תקנה קרקע דעו כמה שנים יש עד היובל ולפי השנים ותבואות השדה הראויה לעשות ימכור המוכר ויקנה הקונה וכו׳ עכ״ל רש״י. הרי מצאנו אף שהכתוב בא ללמד רק עצה טובה. אעפ״כ סבירא להגמ׳ במספר שני תבואות דוקא לעבור הקונה והמוכר כ״א בעשה. ומזה יצא להרמב״ם בפסוק לנכרי תשיך אף שהוא עצה טובה אעפ״כ מקיים העשה:
Re'eh:102	את שנתנבלה בשחיטתה. היינו שנעקרו הסימנים ולא יצאתה מדי שחיטתה מתורת נבלה:
Re'eh:103	דברים ככתבן דברי ר״י. (פסחים כ״א:):
Re'eh:104	זה מע״ש. שבו דבר הכתוב ואכלת לפני ה׳ אלהיך היינו בירושלים כ״ה בספרי:
Re'eh:105	היוצא להזרע בשדה וכו׳. לאפוקי הפקר עיין (מעשרות פ״א) כל שהוא אוכל ונשמר:
Re'eh:106	היוצא מן השדה. היינו שנגמרה מלאכתו אז חייבת במעשרות:
Re'eh:107	את המוכר שהוא חייב במעשר. שמקח קובע למעשר. ודע כי בספרי דורש עשר תעשר ואכלת ולא מוכר תבואת זרעך. ולא לוקח היפך ממה שכתב המחבר עיין (ב״מ פ״ח.) תוס׳ ד״ה תבואות זרעך שחילקו בין הלוקח קודם מירוח חייב לאחר מירוח פטור. ודברי המחבר קאי בקונה קודם מירוח:
Re'eh:108	רע״א יכול יהא אדם מעלה בכורות מח״ל. (תמורה כא): בזמן שבהמ״ק היה קיים:
Re'eh:109	בין בארץ בין בח״ל. כל הימים דורש:
Re'eh:110	וכי ירבה וכו׳ אחד מרובה וכו׳ ערבובי דברים בכאן וט״ס וכצ״ל וכי ירבה ממך הדרך יכול בריחוק זמן הכתוב מדבר (פי׳ שאין לו פנאי וזמן להעלותו לירושלים שיהא מותר לפדותו. ת״ל כי ירחק ממך המקום בריחוק מקום הכתוב מדבר. אין לי אלא שהוא מרובה (שיש לו מעשר שני הרבה שיש לו טרחה גדולה להעלותו לירושלים) בזמן שהוא מועט מנין ת״ל כי לא תוכל שאתו (פי׳ שאינו יכול לשאת אותו אפילו מועט אם רב עליו הדרך) אין לי אלא עני עשיר מנין (פי׳ עשיר יכול לשכור סוסים ועגלות ת״ל כי יברכך ה׳ אלהיך) פי׳ אף שברכך בעושר אעפ״כ אם הוא מרובה תוכל לפדותו:
Re'eh:111	דבר שדרכו לצרור. (ב״מ מ״ז):
Re'eh:112	פרט לכשיצא חוץ מרשותך. כגון שנפל כיסו לים הגדול אינו יכול לפדות מע״ש על מעות שבתוכו שצריך לשכור מי ששט ע״פ המים להוציאו (מעשר שני פ״א בפי׳ הרע״ב):
Re'eh:113	ר״י אומר יכול הלוקח וכו׳. דה״א ללמוד ק״ו ממעשר עצמו (מעשרות פ״ג משנה י׳) וה״א דמהני ליה פדיון ת״ל וצרת הכסף כסף ראשון וכו׳ ולא מהני ליה פדיון אלא יקבר:
Re'eh:114	אלא פרי מפרי. לאפוקי מים ומלח:
Re'eh:115	אלא שלמים. ולא עולות שאין בהם אכילה שכולה כליל:
Re'eh:116	להגיד מה גרם. אחרי שלא קיבל חלק בא״י וחלקו אצלך ע״כ פרנסהו:
Re'eh:117	ולהלן הוא אומר. מקץ שבע שנים בחג הסוכות:
Re'eh:118	שבשלישית ובשביעית. מפני מעשר עני שבששית:
Re'eh:119	ומעשר שני יבטל שנאמר כי תכלה כצ״ל ומלת ת״ל ט״ס הכא:
Re'eh:120	יכול אף בשביעית. תהי חייבת בביעור (כן הגיה הגר״א בספרי) ת״ל שנת המעשר שנה שחייבת במעשר חייבת בביעור ושביעית שפטור מן המעשר כי השדות הפקר פטור מן הביעור:
Re'eh:121	של שנה ההיא וכו׳. הוא מאמר בפ״ע. על הקרא תוציא את כל מעשר תבואתך בשנה ההיא וע״ז אמר שלשנה ההיא וכו׳ ואי אתה מבער ירק וכו׳ דבירקות אזלינן בתר לקיטה (ר״ה י״ג) וכיון שנלקט אחר ר״ה של רביעית אינו חייב בביעור באותו שנה עד שיגיע פסח של שביעית (ז״ר) ודע כי בפסקא זו הלשון אינו מכוון:
Re'eh:122	יבוא הלוי וכו׳. (ר״ה י״ג:) ובא הלוי כ״ז שבא תן לו דברי ר״י וכן כוונת המחבר ויטול חלקו מ״מ כי מעשר ראשון אין לו הפסק:
Re'eh:123	מכאן אמרו אין פוחתין וכו׳. היינו מדכתיב ושבעו שיתן לו כדי שביעה. וע״ז קאי אין פוחתין:
Re'eh:124	שאין מוציאין. היינו המעשר עני לעניי חו״ל שיאכלו בחו״ל. וכ״ה גרסת הרמב״ם בספ״ו מהלכות מתנות ענים:
Re'eh:125	וכה״א השמר לך וכו׳ קרבה שנת השבע. ואם אתה אומר ז׳ שנים לכל מלוה ומלוה להלואתו כאו״א האיך הוא קרבה (רש״י בחומש):
Re'eh:126	מקץ שבע שנים. ולהלן הוא אומר וכו׳ עיין (עירכין כ״ח:) יליף מקרא דהכא גופא ע״ש בשלמא שביעית בסופה דכתיב מקץ ז׳ שנים. וגירסא דהכא וכ״ה בספרי ראיה לדעת הראב״ע ושארי מדקדקים. כי הראש והסוף יקראו קצה. ע״כ אין ראיה מקרא דהכא. ועיין רמב״ן:
Re'eh:127	מה להלן בסוף השנה. דהיינו בחג הסוכות הוא משנה השמינית עיין (ר״ה י״ב):
Re'eh:128	שהשמטה נוהגת בתחלת השנה. היינו שאסור בחרישה וש״ד:
Re'eh:129	מה שמטה משמטת ט״ס וכצ״ל יכול אי מה שמיטה משמטת וכו׳:
Re'eh:130	שזקפן עליו במלוה. היינו דרך הלואה. ולא ש״ש והקפת חנות:
Re'eh:131	רעהו פרט לאחרים. היינו כנענים:
Re'eh:132	בזמן שהיובל כו׳. (קדושין ל״ח):
Re'eh:133	אם אמר ליתן. דורש בגלל הדבר לשון דיבור שכר אמירה:
Re'eh:134	ר״א ובך לא ימשולו. כדרך שב״א שולטים וכו׳. והפסוק ואתה לא תעבוט ט״ס:
Re'eh:135	אחיך זו אחיך מאביך. דורש אחוה אחוה מבני יעקב:
Re'eh:136	הרי יושב במקום אהר. פי׳ ובא לכאן אתה מצווה לפרנסו. ודורש מאחד שעריך לרבות. ועיין טוי״ד סי׳ רנ״א בשם הר״ר יצחק ב״ר ברוך דהא דאמרינן עניי עירך קודמין. היינו שלא לשלוח לעיר אחרת אם יכול ליתן לעניי העיר. אבל העניים הבאים לעיר דינם כעניי העיר והספרי והפסקתא דהכא מסייעם:
Re'eh:137	בכ״מ אפילו בחו״ל. אלא שעניי א״י קודמין כאמור למעלה:
Re'eh:138	לפי שיש אדם וכו׳. בספרי הג׳ לא תאמץ את לבבך. יש בן אדם שמצטער אם יתן או לא יתן כי אינו נותן בסבר פנים יפות. וכן הכוונה הכא:
Re'eh:139	לו זו אשה. (כתובות ס״ז) יתום הבא לישא:
Re'eh:140	מכאן אמרו כל המעלים. (שם ס״ח.):
Re'eh:141	לא אמר ולא נתן יצא כל שכרו בהפסדו. ולא הבנתי כוונתו אחרי כי לא אמר ולא נתן מה שכר יש לו ובספרי כאן גירסא אחרת לא אמר כו׳ ולא נתן כו׳ אבל נח לו בדברים טובים מנין שנותנים לו שכר שנאמר בגלל הדבר הזה יברכך ה׳ והיינו הדבר שנחמו בדברים טובים:
Re'eh:142	והיה מעשה הצרקה. פי׳ שמעשה אחרים ליתן:
Re'eh:143	עצה טובה אני נותן לך. לטובתך כ״ה בספרי:
Re'eh:144	ופודין אותה בע״כ. דאב משום פגם משפחה:
Re'eh:145	עובד את הבן. (קדושין י״ז):
Re'eh:146	ומנין שאם ברח. (שם ט״ז):
Re'eh:147	ולהלן הוא אומר ולא יראו פני ריקם. חסר המאמר ונכתב לבסוף פיסקא השניה נאמר כאן ריקם ונאמר להלן ריקם (בעולת ראיה) כדתנן אלו דברים וכו׳ אבל דבריו אינם מובנים כלל עיין (קידושין י״ז.) דפריך הגמ׳ ולילף ריקם ריקם מעולת ראיה (דשעורא שתי כסף) ומשני אמר קרא (הכא) אשר ברכך ה׳ אלהיך לפי הברכה תן לו כמו שמסיים ג״כ הכא והאיך רוצה ללמוד מעולת ראיה. וצע״ג שאין אתה מעניק לו שנאמר וכי תשלחנו חפשי מעמך יצא זה המשתלח בכסף ששלוחו ע״י עצמו ולא ע״י האדון:
Re'eh:148	שהן ראוים לברכה. וצאן פרה ורבה וכן יקב הוא מגדולי קרקע (רש״י שם):
Re'eh:149	יכול פעם אחת (קידושין כ״ב):
Re'eh:150	מכאן אמרו (קידושין ט״ו) והעבד ביום ובלילה שרבו מוסר לו שפתה כנענית והוולדות לאדון:
Re'eh:151	לימר על בכור וכו׳. הכא נאמר בפירוש בקרא לפני ה׳ אלהיך תאכלנו שנה בשנה (וכ״ה לישנא דמתניתין (בכורות כ״ו) רק כוונת הספרי והפסיקתא כי בבעלי מומין נאמר בקרא אח״כ וכי יהיה בו מום וכו׳ בשעריך תאכלנו קאי ג״כ על קרא דלקמיה תאכלנו שנה בשנה:
Re'eh:152	שאר קדשים מנין. שיהיה בתוך שנתן נאכלין ת״ל כל הבכור וכל לרבות כ״ה ה״ג בילקוט מצוין בשם הספרי. ובספרי שלפנינו ליתא:
Re'eh:153	אשר יולד וכו׳. תקדיש וכו׳. עיין (ערכין כ״ט.) ושם הגירסא מקדישו הקדש עילוי ואי אתה מקדישו הקדש מזבח היינו לשם קרבן אחר. וע״ש בפרש״י ותוס׳ הקדש עילוי להעלותו בדמים ויתן טובת הנאה לכהן. ודברי המחבר דחוק ונצרך לפרש הקדש מזבח להקדישו לשם בכור כי מצוה לקדשו כמו שמסיים אבל אי אתה מקדישו הקדש בדק הבית שאינו חל על קדשים:
Re'eh:154	יצא הקדש בדק הבית. שמותר בגיזה ועבודה מדאורייתא רק מדרבנן אסור (בכורות כ״ה):
Re'eh:155	ר״ש אומר לא תעבוד וכו׳. בבכור אדם וכו׳ (שם ט):
Re'eh:156	יום א׳ משנה זו וכו׳. (בכורות כ״ו) וע״ש בפרש״י:
Re'eh:157	שמור את חדש האביב. מפני האביב שיהיה בזמנו היינו האביב יום התקופה יהיה במילוי הלבנה ואז נקרא ניסן חודש האביב:
Re'eh:158	לא פחות ולא יותר. בספרי יכול אם חסרה השנה י״ד או ט״ו יום תתן לו רק י״ד ט״ו יום ת״ל החודש שלם דוקא. וכן אם נחסר מ׳ או נ׳ יום יכול אתה נותן לה מ׳ או נ׳ יום ת״ל החודש לא יותר מחודש. וזה כוונת המחבר לא פחות ולא יותר כדרכו לקצר לשון הספרי. ומה שהקשה הז״א האיך משכחת לה שתהא השנה חסרה כ״כ ולא עוברה בשנת העברה. ולי לא קשה מידי שזה היה בשנות הרעבון שאין מעברין השנים. ועיין בתוספתא וכן (סנהדרין י״ב) אמר ר׳ שמעון מעשה בר״ע שהי׳ חבוש בבית האסורין ועיבר ג׳ שנים זו אחר זו ע״ש כי חכמים פליגי ע״ז ואמרו משם ראיה ב״ד ישבו וקבעו כ״א בזמנה אבל ר׳ שמעון סובר שעשה ג׳ שנים רצופים מעוברים ואז חסרו יותר מנ׳ יום. וכבר ידעת כי סתם ספרי ר׳ שמעון ע״כ נכון מאד דברי הספרי שכותב מ׳ או נ׳ יום. ובזה ג״כ ניחא בדבר שכתב הרמב״ם בהלכות קידוש החודש ה׳ י״ג יראה לי שמה שאין מעברין בשני רעבון אבל אם היתה שנה הראויה להתעבר מפני התקופה מפני האביב ופירות האילן מעברין לעולם. והשיגו הרמ״ה ממאמרם (סנהדרין שם) ואיש בא מבעל שלישה וכו׳ ראויה היה שתתעבר ומפני מה לא עברה אלישע ששנת בצורת היתה ולא השיגו מספרי דהכא שמפורש בהדיא מ׳ או נ׳ יום (וע״ז לא היה עולה ג״כ תירוץ הכ״מ ע״ש) אך מהך דהכא אין ראיה כי דברי ספרי הוא לפ״ד ר״ש ואינו הלכה:
Re'eh:159	חדש האביב וכו׳. לא חם ולא צונן. נראה כי יפרש אביב כמו (איוב י״ב) עודנו באבו לא יקטף שפי׳ רש״י באבו בלחותו ורעננותו שאז הפרי בעצם תקפה לא בוסר שלא נגמל כל צרכה וכן לא נגמל כולו שאז ג״כ הפרי אינה חזקה ותפול מעל העץ. וכן מפרש הכא חודש האביב לא חם ולא צונן רק האויר אז ממוזג:
Re'eh:160	שנגאלו מהלילה. במכות בכורות ואז אתחלתא דגאולה שאמר פרעה קומי צאי מתוך עמי:
Re'eh:161	ולמה יצאת. פי׳ ולמה נאמר דוקא וזבחת. עיין בספרי:
Re'eh:162	משש שעות וכו׳. (פסחים כ״ח:). דברי ר׳ יהודה:
Re'eh:163	פרט לחלוט. (פסחים לו:) וחלוט הוא חשיבות ולא עוני:
Re'eh:164	חפזון דמצרים. (ברכות ט.):
Re'eh:165	שנשרף הנותר בט״ו בניסן. כי אין שורפין קדשים ביו״ט:
Re'eh:166	מכאן שאין שוחטין הפסח על היחיד. דורש מסיפא דקרא באחד שעריך כמו לא תוכל לזבוח את הפסח באחד (פסחים צ״א):
Re'eh:167	עד מועד צאתך ממצרים אתה שורף כצ״ל והשאר מקודם נמחק:
Re'eh:168	שהיה קרב בט״ז בניסן. ומתיר את החדש:
Re'eh:169	למדנו שחולו של מועד. (חגיגה י״ח.) וביום השביעי עצרת מה שביעי עצור אף ששת ימים עצורין אי מה שביעי עצור בכל מלאכה אף ששת ימים עצורין בכל מלאכה ת״ל וביום השביעי וכו׳ לא מסרן הכתוב אלא לחכמים:
Re'eh:170	שבעה שבועות תספר לך יכול בב״ד. מדכתיב תספור לך ומשה מומחה ב״ד הוא וה״א ללמוד מספירת יובל שהוא בב״ד ת״ל וספרתם לכם ספירה לכל או״א כצ״ל:
Re'eh:171	ר״י הגלילי ג׳ מצות וכו׳ (חגיגה ו׳):
Re'eh:172	חגיגה נוהגת לפני הדבור. אותם שלמים שהקריבו הבכורות בפרשת משפטים אע״פ שלא ברגל הקריבום חגיגה נקראו שבהם נתקיים ויחוגו לי במדבר שנאמר במצרים (רש״י שם):
Re'eh:173	במה שאתה חוגג. היינו בבשר שמהם מביא קרבן חגיגה:
Re'eh:174	שבעת ימים תחוג. יכול יהא חוגג והולך כל ז׳ ת״ל וחגותם אותו ואותו משמע רק יום אחד א״כ למה נאמר ז׳ ימים ללמד שכל הרגל תשלומין דראשון הוא:
Re'eh:175	יכול באותו המין. היינו במה שעשית סוכה וחגיגה יהיה רק חל הברכה (ז״ר):
Shoftim:1	פוקד על הרשעים. לרעה והם נמלטין:
Shoftim:2	הוי האוצרים חמס למו. אין זה מקרא בתנ״ך וט״ס ואולי צ״ל האוצרים חמס ושוד בארמנותיהם (עמוס ג׳):
Shoftim:3	שממעט בנכסיו. וזה טוב מעט:
Shoftim:4	ואפילו מאן דלא דריש סמוכים. (ברכות כא.):
Shoftim:5	ר״א בן שמוע. חנחומא בשם ר׳ אלעזר סתם ומסיים שם אין סיפק ביד הדיין לעשות לו כלום אלא א״כ מוסרו ביד השוטר והשוטר מוציא ממנו בע״כ:
Shoftim:6	אחד על גבי כלם. הוא הנשיא. וי״מ הוא מופלא שבב״ד אב ב״ד ובכל שופטים היה מופלא:
Shoftim:7	ושפטו אה העם בע״כ. עיין רמב״ן על התורה שפי׳ שבב״ד שבכל שבט היו יכולים לדון בע״כ. כי בב״ד שבכל עיר יכול הב״ד לומר לב״ד הגדול קאזלינא היינו להב״ד של השבט שהם ידונו בע״כ:
Shoftim:8	זו מצות הדיינים שיהיו מנוקים בצדק. פי׳ ושפטו את העם משפט צדק קאי על תתן לך שתתן לכחחלה שופטים ושוטרים אשר ישפטו משפט צדק. ופי׳ משפט צדק שיהיו חכמים ואנשי אמת. (הגר״א בא״א):
Shoftim:9	עד שאינו יודע מה מדבר. היינו שישכח תלמודו:
Shoftim:10	אחר ר״א ללוד. (סנהדרין ל״ב ע״ב):
Shoftim:11	שתיהן קרובות. הטל פשרה ביניהם:
Shoftim:12	ויפת בסתר לבי. וסיפא דקרא כי כחשתי לאל ממעל והיינו ע״ז:
Shoftim:13	ואפילו בקהל גרים. דה״א בישראל דווקא ת״ל והוצאת את האיש ההוא כו׳ אפילו גרים נשים ועבדים:
Shoftim:14	מנין אפילו מאה. ששנים יכולים להזים אותם:
Shoftim:15	אלא כסדר הזה. כמו שאומר למעלה ולמטה דיני סקילה:
Shoftim:16	מלמד שבמופלא שבב״ד וכו׳. והיינו למעוטי תלמיד שלא הגיע להוראה אינו נעשה זקן ממרא:
Shoftim:17	ממך זה יועץ. שנחלקו בעבור שנה הקרוי סוד ועצה:
Shoftim:18	דברי אלו ערכין וחרמין וכו׳. שנתחייב אדם ע״י דבורו:
Shoftim:19	ועגלה ערופה. שהחלל נהרג על ידי מריבה:
Shoftim:20	וטהרת המצורע. שאף נגעים על ידי ריב ולשון הרע באים:
Shoftim:21	בשעריך. זה לקט שהם לעניים דכתיב בהם ואכלו בשעריך:
Shoftim:22	כענין שנאמר והיה כו׳. זה עומק הדין. דורש כי יפלא שנעלם מהם עומק הדין ויחשבו אותו לנמנעות שלא יכלו לידע עפ״י סברא וכ״ה פי׳ הקרא התם כי יפלא בעיני העם שיחשבו הדברים לנמנעות:
Shoftim:23	בין בהרת לשאת. שהם אבות מחולקים. ולא ידעו אם הנגע מאב אחד ומצטרפין זה ע״ז עיין ריש נגעים:
Shoftim:24	ואינו חייב מיתה על הוראת ב״ד שביבנה. אבל חייב לעשות כמו שהורו. רק מיתה הוא פטור (חכם הספרדי):
Shoftim:25	ואינו חייב מיתה על דברי סופרים. אתיא כר״י (סנהדרין כח:) על דבר שעקרו מדברי תורה ופירושו מד״ס:
Shoftim:26	וזקן ממרא. עפ״י ב״ד בחנק:
Shoftim:27	עשה מצוה האמורה בענין. (סנהדרין כ:) כי שלש מצות נצטוו בביאתם לארץ ואחד מהם למנות מלך:
Shoftim:28	עפ״י נביא. כי מאין יודעים שה׳ בחר בו:
Shoftim:29	ולא מאחרים. היינו כנענים:
Shoftim:30	לא תוכל וכו׳. זה ל״ת שום תשים זה עשה. כ״ה בספרי:
Shoftim:31	כשהיה אגריפס וכו׳. (סוטה מא.) והיינו כשהיה קורא משנה תורה ברגל בשעת הקהל:
Shoftim:32	ואזרם במזרה בשערי הארץ כצ״ל כלישנא דקרא:
Shoftim:33	שתהא מוגהת וכו׳. היינו מספר המונח בעזרה (הגר״א):
Shoftim:34	וקרא בו כל ימי חייו. בתוספתא דסנהדרין. וקרא בו דוקא המלך אבל אחר אסור לקרות בספר של המלך. והוא דין חדש לא הביאו הספרי. וכן הגי׳ בסנהדרין. גם הרמב״ם בהלכות מלכים לא הביאו ואולי הוא בכלל שכתב הרמב״ם שאין משתמשין בכלי תשמישו. ויוכלל ג״כ הס״ת בזה. וצ״ע:
Shoftim:35	מלמד שאין על גבו אלא ה׳ אלהיו. (הוריות ג׳) איזה נשיא זה מלך שנאמר מכל מצות ה׳ אלהיו שאין על גביו אלא ה׳ אלהיו אז דינו כמלך שמביא פר על המצות:
Shoftim:36	ואת יהואחז מפני יהויקים שהיה גדול ממנו שתי שנים כצ״ל:
Shoftim:37	בזמן ששלום בישראל. היינו שאינו מחלוקת בדבר המלוכה:
Shoftim:38	אחד גדול ואחד קטן. ובספרי וכן הועתק ברש״י אחד תמימין ואחד בעלי מומין ואולי כאן ט״ס וצ״ל כמו התם:
Shoftim:39	ומה דיבר לו אשי ה׳ ונהלתו. הוא קרא דמקודם. וברש״י בחומש הגי׳ ומה דבר לו (במדבר י״ח) בארצם לא תנחל אני חלקך היא גירסא יותר נכונה:
Shoftim:40	מלמד שהמתנות יוצאות בדיינים. דכתיב משפט (חולין קל:) דלא כר״ח שם:
Shoftim:41	מאת העם ולא מאת ההקדש. בספרי וכן בחולין שם ממעטינן הקדש מדכתיב וזה יהיה משפט הכהנים. אין להם אלא זה. ומאת העם ממעט כנענים ואחיו הכהנים:
Shoftim:42	פרט לטרפה. שאינה קרוי זבח. ופטור ליתן המתנות לכהן. והכהן ימכרם למי שאינו מצווה או יאכיל לכלבו:
Shoftim:43	פרט לכלאים. בספרי וכן (חולין קלב:) דורש שה לרבות את הכלאים. ובכאן ט״ס:
Shoftim:44	ונתן לכהן ולא לשלוחו. בספרי הגי׳ לכהן עצמו ופי׳ הז״ר הכוונה אעפ״י שזכה הכהן המתנות לאחר אסור ליתן לו אא״כ הזוכה ת״ח שאין נותנין מ״כ לכהן עם הארץ עיין (חולין קל:) למד מקראי. ול״נ כוונה אחרת עפ״י מה דאיתא (כתובות כ״ה כ״ו) מעלין מתרומה ומתנות ליוחסין ע״כ נותן לכהן עצמו ולא לשלוחו וכ״ה הוא הפי׳ בספרי לכהן עצמו (אחר זה ראיתי בספר בית דוד להרב הגאון המפורסם ר׳ טעביל ממינסק זצ״ל בסי׳ ו׳ מספרו מביא דברי הפסיקתא ע״ש.ועכ״פ מה שכתב שידוע שהמחבר פסיקתא זוטרתי הוא מהאחרונים לא כ״ה כי המחבר הוא מהראשונים שהיה בימי הרי״ף כידוע):
Shoftim:45	מלמד וכו׳ בעמידה. מסיפא דקרא לעמוד ולשרת:
Shoftim:46	בין בארץ בין בחו״ל. קאי על ברכת כהנים. ואפשר לפרשו ג״כ על ראשית הגז שנוהג בחו״ל כסתמא דמתניתין רק האידנא בטלוהו שנהג עלמא כתלתי סבי:
Shoftim:47	יכול לוי ממש ת״ל ושרת את אחיו יצאו לוים כצ״ל:
Shoftim:48	בכל מקומות מושבותיהם. פי׳ אף כהן שגר בחו״ל אעפ״כ כשבא לארץ יכול לעבוד וזה דורש מאשר גר שם (ז״ר):
Shoftim:49	מכאן לכהן שבא. דורש מסיפא דקרא ושרת בשם ה׳ זה נשיאת כפים שהיה בשם המפורש (ז״ר):
Shoftim:50	ככל אחיו הלוים העומדים שם עומד על גבי הרצפה כדתנן (זבחים ט״ו) ע״ש כצ״ל:
Shoftim:51	חלק לאכול וחלק לעבוד. כמו ברגלים כל המשמרות שוות בעבודה כך שוות באימורי הרגלים ובחילוק לחם הפנים (סוכה נ״ה נ״ו):
Shoftim:52	מה מכרו וכו׳. (סוכה שם) והיינו דוד ושמואל שתקנו המשמרות:
Shoftim:53	עשה מצוה. האמורה בענין כ״ה בספרי. והיינו שלא יהיה בך מעונן ומנחש:
Shoftim:54	אבל אתה למד להבין ולהורות. (סנהדרין סח.):
Shoftim:55	להזהיר ב״ד. שהם יבערו העושים עבירות:
Shoftim:56	מה כאן באש. דכתיב בהדיא מעביר בנו או בתו באש (שם ם״ז):
Shoftim:57	אפילו באחת מאלה. מדלא כתיב עושה כל אלה (חכם הספרדי):
Shoftim:58	אפילו אמר לך וכו׳. כגון אליהו וכו׳ (יבמות צ:):
Shoftim:59	וכן מעשה גדעון. (תמורה כח:) ח׳ דברים התירו ובמדרש הגי׳ ז׳ עבירות:
Shoftim:60	בשכר כי יראו. פי׳ בשעת מ״ת שאמרו ישראל ועתה למה נמות כי תאכלנו האש הגדולה הזאת וע״ז השיב לו הקב״ה הטיבו את אשר דברו:
Shoftim:61	שלא להושיב את המתורגמין. היינו הנביא בעצמו יגיד נביאתו:
Shoftim:62	ג׳ מיתתן בידי שמים. (סנהדרין פט.):
Shoftim:63	קרי ביה לא ישמיע כצ״ל. היינו שאינו רוצה להגיד נבואתו:
Shoftim:64	אל דברו. זה העובר ד״ע. דורש לא ישמע אל דברי קאי על הנביא בעצמו:
Shoftim:65	אלו נביאי הבעל. חסר והמתנבא בשם עובדי כוכבים אלו נביאי הבעל כצ״ל ועולה המנין ג׳ מיתתן בידי אדם:
Shoftim:66	ירמיה אמר. לשון הכתוב אינו מדוקדק וכצ״ל כה אמר ה׳ על הכלים וכו׳ בבלה יובאו וכו׳:
Shoftim:67	לא תמנע עצמך מללמד עליו חובה. ולא תירא לענש עליו כן פרש״י בחומש:
Shoftim:68	שלש ערים תבדיל. לא כרכים קטנים ולא כרכים גדולים אלא עירות בינונית כצ״ל:
Shoftim:69	תבדיל לך ולא לאחרים. היינו לעובדי כוכבים:
Shoftim:70	מה תירש. צ״ל משתכבוש ותירש אז נתחייבו בעשיית ערי מקלט. וכה״ג הגר״א:
Shoftim:71	סטריאות כצ״ל ופי׳ דרכים המפולשים:
Shoftim:72	כמקדש לצפון בעבר הירדן כצ״ל:
Shoftim:73	שהיה עוקבין. אורבין להרוג:
Shoftim:74	והיח לנוס שמה כל רוצח אפילו כהן גדול במשמע כצ״ל (סנהדרין יח.) אף שאינו יוצא משם לעולם:
Shoftim:75	למה נאמר שמה ג׳ פעמים. (מכות יא:) כצ״ל וע״ז מסיים שם תהא דירתו:
Shoftim:76	תמול שנים. שלשום שלשה והיינו כל שלא דבר עמו ג׳ ימים:
Shoftim:77	שלא יהא גולה מעיר לעיר. היינו רוצח שהרג בעיר מקלטו גולה משכונה לשכונה ודורש אל אחת הערים ולא שתים:
Shoftim:78	אין לי אלא מי שיש לו חמות הלב. בספרי ליתא דרשה זו. כי דרשה זו נכון מאד לשון המשנה (מכות ח:) האב גולה ע״י הבן והבן גולה ע״י האב. אף שאין שייך הכא כי יחם לבבו:
Shoftim:79	ת״ל אחרי הרוצח מ״מ כצ״ל:
Shoftim:80	להזהיר ב״ד ע״כ. דורש והיה עליך דמים קאי על ב״ד:
Shoftim:81	לכך נאמר וכי יהיה איש שונא לרעהו. (בתחלה שונא) ואח״כ וארב ואח״כ וקם עליו ואח״כ והכהו נפש (הגר״א בא״א):
Shoftim:82	מכאן היה ריב״י אומר. קאי על הקרא ושלחו זקני עירו ולקחו אותו משם (מכות ט:):
Shoftim:83	אם נתחייב מיתה וכו׳. (מכות שם) ודורש מדכתיב וארב עליו היינו מזיד. ואח״כ כתיב ונס מכאן שכלם מקדימין לערי המקלט (חכם הספרדי):
Shoftim:84	ושל ר׳ יהושע בדברי ר׳ אליעזר לומר על טהור טמא ועל טמא טהור שהוא עובר בל״ת ת״ל לא תסיג גבול רעך כצ״ל וכ״ה בספרי והשאר ט״ס והסגרתי במוסגר. ובכוונה גדולה נאמר בספרי וכן הכא לומר על טהור טמא וכו׳ עיין (שבועות י״ט) משמעות דורשין א״ב רב ששת מחליף דברי ר״א לר״ע ור״ע לר״א וע״ש בפרש״י כשהיה ר׳ ששת שונה משנתו מחליף דברי זה בזה ולא היה מקפיד לפי שאין ביניהם חיוב ופטור עכ״ל רש״י (הרב משכיל לאיתן) ונכון הוא (הערה) עיין ירושלמי שבת פרק א׳ על פסוק רב אדם וכו׳ ואיש אמונים מי ימצא זה ר׳ זעירא דאמר ר״ז לית אנן צריכין חשושין לשמעותא דר׳ ששת דרב ששת הוא גברא מפתחא ופי׳ אחרי כי היה סגי נהור ולא ראה שמות המדברים היה מחליף מאמרם. וכמו שאמרו בבבלי שבועות שר׳ ששת מחליף דברי ר״א לר״ע. וכבר דברתי הרבה מזה בהקדמתי למדרש משלי:
Shoftim:85	אבל קם הוא לעדות אשה להשיאה. עיין (יבמות פ״ח.) ועוד בכמה מקומות שזה רק תקנת חכמים מתוך חומר שהחמרת עליה בסופה ע״ש. וכבר הבאתי כמה פעמים דברי הרא״ש שכתב שכמה מילי דרבנן אסמכינהו בספרא וספרי מקראי ואין להאריך. זולת זה פלא שבספרי הוא מאמר ר׳ יהושע אבל קם הוא לעדות אשה להשיאה (וביבמות קכ״ב.) שם במשנה הגי׳ ר׳ יהושע אומר אין משיאין האשה ע״פ עד אחד ומצאתי בז״א בשם בן המחבר שכתב שבסמ״ג ל״ת רי״ג הביא דברי הספרי וגורס ר׳ יהודה ולא ר׳ יהושע. אבל הגר״א בהגהותיו לספרי לא הגיה כלל וצ״ע:
Shoftim:86	ולהלן הוא אומר ע״פ שנים. בהתחלת הפרשה גבי עובד כוכבים:
Shoftim:87	ונאמר להלן ועמדו. בפסוק שאח״כ גבי כי יקום עד חמס. ובשם הוא בעמידה דכתיב ועמדו:
Shoftim:88	אין חמס אלא גזלן. דכתיב (שמות כ״ג) אל תשת ידך עם רשע להיות עד חמס. וכצ״ל בספרי. והז״א ציין קרא שלא נמצא ועיין (סנהדרין כ״ז) אל תשת רשע עד אל תשית חמס עד אלו הגזלנין קיצר הגירסא בלישנא דקרא כדרכם באיזה מקומות:
Shoftim:89	מלמד וכו׳. עד שיזמו מעצמן (מכות ה׳) הלשון לענות בו סרה. עד שתסרה גופא של עדות (פי׳ שיאמרו עמנו הייתם) ואז סרה כל גוף העדות (הגר״א בא״א) ועיין במזרחי:
Shoftim:90	להביא אשה עם אשה וכו׳. אשר להם הריב רבויא הוא. ועיין (שבועות ל.) ועמדו שני האנשים בעדים הכתוב מדבר. או אינו אלא בבעלי דינין וכי שנים באו לדין שלשה אין באין לדין וכו׳ וכי אנשים באין לדין ונשים אין באין לדין:
Shoftim:91	זה שהיה קרוב ונתרחק. שהיה חתנו ומת בתו:
Shoftim:92	ומנין שהעד עושה עצמו עד שקר וכו׳. עיין כ״ז בספרי. ומסיים ג״כ יכול אף שנחקרו עדותן בב״ד ת״ל שקר ענה באחיו כ״ז שב״ד צריכין להם ולא משנחקרה עדותן בב״ד. החכם הספרדי וכן הז״א פי׳ על דברי הירושלמי פ״ב דכתובות. וכ״ה בתוספתא שם עדים שהעידו בין לטמא בין לטהור וכו׳ לפטר ולחיוב עד שלא נחקרו עדותן בב״ד ואמרו בדאין אנחנו הרי אלו נאמנין. ויהיה כאן הפירוש ומנין שהעד עושה עצמו עד שקר היינו קודם שנחקרו עדותן בב״ד. וע״ז מסיים הקרא והנה עד שקר העד אולם הגר״א בא״א פי׳ באופן אחר. וז״ל שבמלקות ומיתה ודיני קנסות אם העידו על האדם שהרג את חברו ותייבו מיתה או מלקות או קנס ועדים אמרו עמנו הייתם אף שעדים אחרים באו ואמרו שאמת הוא שנהרג רק לא באותו היום וביום אחר הוא אעפ״כ יקויים בהם כאשר זמם שבשעה שדברו עליו לא היה חייב מיתה עדיין שלא באו עדים עדיין וקנסות ג״כ לא היה חייב עד שיפסוק ב״ד ע״פ עדות כשר. אבל בממון באופן זה אינו חייב רק אם הוא דבר שקר לגמרי. אבל אם עדים אחרים באו ואומרים אמת שחייב ממון לחבירו אע״פ שהתכחשו עדים הראשונים בעמנו הייתם לא מקיים בהם כאשר זמם משום שלא הפסידו בזה שממון חייב אף בלא ב״ד ולכך כתיב והנה עד שקר העד ששקר הוא לגמרי וקאי על ממון עכ״ל וזה כוונת הפסיקתא שהעד עושה עצמו עד שקר. היינו שכל המעשה הוא שקר:
Shoftim:93	אם עוגשין עונשין. היינו עונש מיתה:
Shoftim:94	ריה״ג אומר ועשיתם לו כאשר זמם. לעשות לאחיו ולא לאחותו מכאן שזוממי וכו׳ (סנהדרין צ.):<br>צד. במלחמת הרשות הכתוב מדבר. למלחמת מצוה יוצאין אפילו חתן מחדרו (סוטה מ״ד):
Shoftim:95	מלמד ששתי מלחמות וכו׳. עיין (בר״ר פ׳ ע״ד) בסופה:
Shoftim:96	שארץ מצרים עמוקה. מדכתיב המעלך:
Shoftim:97	אלא קריאת שמע. שמתחלת שמע ישראל:
Shoftim:98	כיון שמתחיל הכהן לדבר שוטר משמיע כצ״ל:
Shoftim:99	השיבוני על דברי. היינו אותם. החוזרים יאמרו טעמם מי בנה בית וכו׳:
Shoftim:100	אם אינו שומע לדברי הכהן. הכוונה כמו שאמרו במשנה לפיכך תלתה התורה כל אלו שיחזרו בגללן ולא יתביישו עוברי עבירה כי יאמרו מחמת אלו דברים חזרו והנה מי שאין בידו עון יחשוב כי הוא ילך למלחמה אף שבנה בית וכו׳ אחרי כי הטעם רק שלא יתביישו עוברי עבירה לכך מסייסכי זה גופא עבירה שלא ישמע לדברי הכהן וימות בשביל חטא זה (הרב המזרחי):
Shoftim:101	ואיש אחר יחנכנו יכול א׳ מן המשפחה נאמר כאן אחר ונאמר להלן אחר (דברים כ״ח) אשה תארש ואיש אחר וכו׳ או הקרא בניך ובנותיך נתונים לעם אחר. מה להלן נכרי אף כאן נכרי כצ״ל וכ״ה בספרי. ובכאן חסר. וצער יש לאדם יותר שביתו יבוא לידי נכרי. ולא לידי אחד ממשפחתו:
Shoftim:102	אחליה לקדושתיה. שטעון פדיון (ברכות לה.):
Shoftim:103	במלחמת הרשות וכו׳. כמו שמפורש בענין כן תעשה לכל הערים הרחוקות ממך (רש״י) ועיין ברמב״ן:
Shoftim:104	והיה אם שלום תענך. יכול אפילו מקצתן ת״ל ופתחה לך כולה ולא מקצתה כצ״ל:
Shoftim:105	אלו כנענים שבתוכה. מסיפא דקרא והיה כל העם הנמצא בה אלו כנענים. כ״ה בספרי:
Shoftim:106	לכל הערים הרחוקות ממך מאוד לא יהיה דינם כצ״ל:
Shoftim:107	לרבות הגרגשי. אף שפינה מקומו אעפ״כ ביזתו מותרת (ז״א) כגון בני גבעון שהחיה יהושע. הגר״א בא״א כתב ובגבעונים שהערימו אותם ואם לא הערימו היו נהרגין אף שעשו שלום משום שהשלום שעשו הי׳ אחר שעמדו במרדם שיהושע היה שולח אגרות מי שישלים יבוא וישלים ומי שרוצה לפנות יפנה ומי שרוצה לעשות מלחמה יעשה עכ״ל. וזה שלא כדברי המחבר דהכא:
Shoftim:108	במלחמת הרשות הכתוב מדבר. דריש מלתופסה ולא תשחיתנה ובשבעה עממין מצוה לשחתה:
Shoftim:109	רבים שלשה. מגיד שתובע שלום ב׳ או ג׳ ימים. ואע״פ שאין ראיה לדבר זכר לדבר (שמואל א כ״ח) ויהי בבוא דוד ואנשיו צקלג ביום השלישי:
Shoftim:110	לתפסה ולא לבזות אותה. בספרי הגי׳ ולא לשובתה והכוונה להרסה בלי תועלת. וכן הוא כוונת המחבר לבזות אותה:
Shoftim:111	כי ימצא. פרט למצוי. עיין (סנהדרין פ׳.ר) ע״ש בתוספות ד״ה ונמצא בידו שהקשו מהכא. ולפע״ד לא קשה מידי כי הכא סמוך על סוף הקרא לא נודע מי הכהו ע״כ דורש כי ימצא פרט למצוי. והוא כעין שם בסוטה גבי נמצא טמון בגל שהקשו מעומר ותירצו הכא מעניני דקרא והתם מעניני דקרא. ע״ש ותבין כוונתי:
Shoftim:112	אפילו אחד בסוף העולם (היה יודע מי ערפו) לא היו עורפין כצ״ל:
Shoftim:113	ומדדו אל הערים אשר סביבות החלל. מן החלל אל הערים ולא מן הערים אל החלל כצ״ל:
Shoftim:114	כשיעור העול לרחבו כצ״ל:
Shoftim:115	מצוה בזקני העיר ההוא: ולא בזקני ירושלים שהם מדדו עיין שם בסוטה:
Shoftim:116	את העגלה הערופה בנחל כצ״ל. ומפרש הערופה (לא כדברי רש״א וראב״ע שמפרשים ערופה מלשון עורף שמשבר ערפה) והמחבר מפרש מלת הערופה בעצמה לשון שברון והפוכה כמו התם הוא יערוף מזבחותם והוא כמו שתרגם. אונקלוס וינקפון תמן ית עגלתא:
Shoftim:117	וכן אמר שהעגלה היתה מתלעת וכו׳. עיין כ״ז בתרגום המכונה ליונתן בן עוזיאל:
Shoftim:118	ומה שירות בתמימים. עיין כ״ז בפרשת עקב. ודע כי גבי עגלה ערופה כשירה בכהנים אף בעלי מומין וכ״ה בספרי:
Shoftim:119	שופכי הדם הנקי. היינו אם נמצא ההורג אחר שנערפה העגלה יהרג עיין ברש״י בחומש. וה׳ יכפר לנו ויטהרנו אמן:
Ki Teitzei:1	לבי לחוקקי ישראל וכו׳. עיין (הוריות י״א) ומחוקק מבין רגליו אלו בני בניו של הילל שמלמדים תורה ברבים:
Ki Teitzei:2	שנאמר ויעבור הרנה כצ״ל:
Ki Teitzei:3	בזמן שעושים וכו׳. דורש ובטוב צדיקים שהצדיקים עושין טוב:
Ki Teitzei:4	ולא כתיב. דבר אל ב״י. כי הוא לשון צווי ועיין (סוטה ל״ה:) ברש״י שם:
Ki Teitzei:5	לרבות כנענים שבתוכה. דורש ושבית שביו מה ששלל השונא מאחר. וכעין שדרשו בפ׳ חוקת וישב ממנו שבי (גיטין ל״ח.) ע״ש:
Ki Teitzei:6	בשעת שביה. כי רק בשעת מלחמה הותרה יפ״ת:
Ki Teitzei:7	ולא לבית אחר. אפשר לפרש כמו שכתב הגר״א בא״א שכל הנוולים שעושה לה הוא כנגד יצרו אבל לא לבזותה לפני אחרים. וזה שדרש אל תוך ביתך ולא לבית אחר לבזותה בפני אחרים:
Ki Teitzei:8	בגדים נאים. כי מלת שמלה נופל על בגד עליון העשוי להתקשט בו. וכן לא ילבש גבר שמלת אשה (הגר״א בא״א):
Ki Teitzei:9	כאשת איש. והבא עליה חייב מיתה:
Ki Teitzei:10	מנהג אישות כמו שנאמר שארה וכו׳ כצ״ל:
Ki Teitzei:11	ואין צריך להעניקה. דה״א ללמוד מאמה העבריה שמעניקין אותה (קידושין מ) ודורש ושלחה לנפשה את הנפש בלבד ולא להעניקה (נכדי החכם חיים נחמן שי׳):
Ki Teitzei:12	ת״ל ומכור לא תמכרנה. דורש מלות כפולות לרבות שוה כסף:
Ki Teitzei:13	זו אהובה בנישואיה וכו׳. שזו באה מן העממים דורש האחת בה״א הידיעה קאי על היפ״ת:
Ki Teitzei:14	שאין בהם הויה. שאין קדושין תופסין בה:
Ki Teitzei:15	לא הספק בן תשעה לראשון או בן שבעה לאחרון כצ״ל וכ״ה בספרי. ואינו נוטל אפי׳חלק פשוט דזיל הכא קמדחי ליה וזיל הכא וכו׳:
Ki Teitzei:16	כמה טעות טעו הקראים כו׳. דע כי גזירת רבינו גרשום מאור הגולה בחרם שלא לישא שתי נשים. והביאו הרמ״א בא״ע סי׳ ב׳ וכתב כי לא גזר רק עד כלות אלף החמישי. וכל הפוסקים לא הבינו הטעם למה גזר רק על זמן ידוע. והרבה פירושים נאמרו בזה וברור הדבר כי בימי ר״ג מאה״ג נתפרצו אז מאד כת הקראים נגד התלמוד ומחלוקת גדולה היה אז ביניהם. והרבנים עמדו במלחמת מצוה ללחום נגד הקראים והראשון היה רבינו סעדיה גאון ותלמידיו כי הקראים אם כי האמינו בי״ג מדות שהתורה נדרשת אבל עקמו הדרשות למטרתן כפי ששינו הרבה מצות התורה גרעו והוסיפו. גם המחבר שלנו ר׳ טוביה נלחם נגדם הרבה פעמים כאשר תראה בהפסיקתא הזו. וכן בכאן נגד דרשתם שרצו לאסור ליקח שתי נשים מהפסוק אשה אל אחותה. והנה בימי ר״ג מאה״ג אחרי כי ראה לפי אריכות הגלות והטלטולים גזר שלא לישא ב׳ נשים. אולם שלא ידמו הקראים כי חכמי הרבנים הודו להם בזה ע״כ במכוון גזר רק עד סוף אלף החמישי. להראות כי זה רק מטעם גזירה ולא ע״פ דין. וכאשר מצינו ג״כ לחכמי התלמוד שגזרו כמה דינים להוציא מלב הצדוקים אשר היתה בימיהם כן עשו ג״כ דורות הגאונים להוציא מלב הקראים כי הקראים והצדוקים כמעט דעת אחת להם. כנ״ל ברור. ולאשר זה דבר חדש הצגתיו כאן אף שאין זה מקומו:<br>טז. ביום מפילין נחלות. (סנהדרין לד:) וע״ש בפרש״י דביום הוי צואת המת דין פסוק ואינו צריך עוד לדיינין ובלילה לא הוי דין פסוק וצריך דיינין ואלו ששמעו צואת המת יעידו לפניהן:
Ki Teitzei:17	מלמד שהבן נוטל וכו׳. היינו בן פשוט. דורש מדכתיב יהיה לו משמע אפילו עכשיו אין לו (ז״ר) ואם ביכר אינו מבוכר. דהוה מתנה על מה שכתוב בתורה:
Ki Teitzei:18	בכל אשר ימצא לו וכו׳. גבי פשוט כתיב כל אשר יהיה לו דרשינן שנוטל בראוי כבמוחזק. וזה אשר יהיה לו אף להבא אף שאין לו עכשיו. וגבי בכור כתיב אשר ימצא לו. דורש דווקא הנמצא בשעת ירושה לבד ולא הראוי לבוא אח״כ (הגר״א בא״א):
Ki Teitzei:19	מלמר שהבכורה יוצאת בדיינים. אם הפשוטים אינם רוצים ליתן. ב״ד היו מוציאים בע״כ כי משפט כתיב כאן (ז״א):
Ki Teitzei:20	ובכור שנולד לאחר מיתת אביו. (ב״ב קמ״ב נדה מד:) יכיר בעינן והא ליכא:
Ki Teitzei:21	כגון שהיה לאביו ב׳ נשים וכו׳. וכן כשאשתו מעוברת וילדה תאומים (רשב״ם שם):
Ki Teitzei:22	אבל לעובר דיליה (ב״ב קמ״ב:). הואיל ודעתו של אדם קרובה אצל בנו. ועיין טור ח״מ סי׳ ר״י בהתחלה בב״י שהאריך בזה:
Ki Teitzei:23	בן ולא בת. (סנהדרין סח:):
Ki Teitzei:24	ללמדך מ׳ מתחלף בו׳. וכמו שהיה כתוב עד אילון ממרה:
Ki Teitzei:25	מורה וכו׳ שוטה. וכמאמרם אין אדם עובר עבירה עד שנכנס בו רוח שטות:
Ki Teitzei:26	שבא לכלל איש. (סנהדרין ס״ח) משיקיף זקן התחתון אינו נעשה בן סורר ומורה:
Ki Teitzei:27	יכול אפילו אמר לו אביו ואמו להדליק את הנר ולא הדליק ת״ל אינו שומע אינו שומע לגז״ש מה אינו שומע האמור להלן בן סורר ומורה זולל וסובא אף אינו שומע האמור כאן סורר ומורה זולל וסובא כצ״ל וכ״ה ה״ג בספרי. והנה בא״א להגר״א הג׳ יכול אפילו אמר לו אביו להדליק את הנר בשבת ולא שמע לו ולא הדליק ת״ל כו׳. ודבריו מופלאים הלא לעיל בפ׳ קדושים איש אמו ואביו תיראו ואת שבתותי תשמורו יכול אפילו אמר לו אביו להדליק את הנר בשבת ת״ל ואת שבתותי תשמורו כולכם חייבים בכבודי הרי זה לימוד אחר לגבי בן כשר. ובלי ספק שתלמיד טועה הוסיף בדברי הגאון תיבת בשבת ונצרך למחקו שם:
Ki Teitzei:28	מלמד שב״ד מלקין אותו. היינו ב״ד של ג׳ מלקין אותו בפעם ראשונה:
Ki Teitzei:29	ותפשו בו אביו ואמו מלמד שאינו נסקל וכו׳ כצ״ל. ולשון ולא גדמין ט״ס ונאמר בפיסקא שלאחריו:
Ki Teitzei:30	מצוה בזקני עירו. וכ״ה ג״כ בספרי. עיין (מכות י:) וזה כמ״ד זקנים מצוה בעלמא הוא:
Ki Teitzei:31	היה אחר מהם גידם וכו׳. (סנהדרין ע״א.):
Ki Teitzei:32	ואמרו ולא אילמים. לקמן גבי מוציא ש״ר כתיב ואמר אבי הנערה אל הזקנים דורש מכאן שאין רשות לאשה לדבר לפני האיש. והנה כאן כתיב ואמרו אל זקני עירו משמע ששניהם יאמרו בננו זה סורר ומורה ע״כ דורש ואמרו ולא אלמים. היינו ג״כ שהאב יאמר אבל גם האם לא תהיה אילמית. ויש לכוון דבר זה ג״כ בא״א להגר״א ז״ל):
Ki Teitzei:33	מכאן אמרו האיש נתלה. (סנהדרין מ״ה:) כדברי חכמים:
Ki Teitzei:34	כי תראה ולהלן הוא אומר כי תפגע הרי מ״ע ול״ת. קשה לי הרי בכאן גופא מסיים הקרא השב תשיבם לאחיך הוא מצות עשה ועיין (ב״מ ל״ב:) האי עשה ול״ת פרש״י עשה השב תשיבם וכן באלפסי שם בפירוש ע״ש וצע״ג (העירני לזה נכדי החכם רח״נ שיחי׳):
Ki Teitzei:35	איזו אבידה. (ב״מ ל׳:) ע״ש:
Ki Teitzei:36	יש פעמים שאתת מתעלם. (שם) ע״ש גבי כהן והאבידה בבית הקברות:
Ki Teitzei:37	החזירה למקום שראוה אחרים ולא נטפלו בה נגנבה וכו׳ חייב באחריותה כצ״ל וכ״ה בספרי. והיינו כיון שלא מסר לידו הוי נגנבה או נאבדה כמו פשיעה ועיין (ב״ק נ״ז:) כל הסוגיא כיון דנקטי להו ניגרא ברייתא בעי נטירותא יתירתא:
Ki Teitzei:38	לעשות רחוק כקרוב. פי׳ מדכתיב ולא ידעתו היינו שרחוק ממך אעפ״כ ואספתו אל תוך ביתך. ועיין מכילתא משפטים פ׳ ב׳ פסוק כי תפגע ה״ג אין לי אלא בזמן שהוא קרוב ורחוק אם אינו מכירו מנין ת״ל כו׳ ולפי דעתי כוונת המכילתא כמו שהוא כאן בפסיקתא (חכם הספרדי):
Ki Teitzei:39	ולא לרשות אחרים. דה״ל שומר שמסר לשומר וחייב באחריותה:
Ki Teitzei:40	עד שתדרוש את אחיך וכו׳. (ב״מ כ״ח) והיינו שיתן סימנים. ודורש עד דרוש אחיך אותו הוא סימן כמו (ישעיה ז׳) גבי אחז שאל לך אות הוא ג״כ סימן. וכ״ה בזוהר חוקת (קפ״ד) ע״ש:
Ki Teitzei:41	שאם מצאת חמור וכו׳. (ב״מ כ״ח:) ומטפל בהם עד י״ב חודש. ונראה לי מדחלק הכתוב לכתוב בפ״ע וכן תעשה לחמורו. וכן תעשה לשמלתו לכל אחד בפני עצמו מזה דרשו חלוקי דינים גבי חמור שעושה ואוכל לטפל בהם י״ב חודש גבי כסות לנערה אחת לל׳ יום הכל לפי חלוקי הדברים:
Ki Teitzei:42	לפני יאוש בעלים. היינו בדבר שאין בו סימן. כי לאחר יאוש הוי הפקר ואינו צריך להחזיר רק לפנים משורת הדין (ב״מ כ״ד:):
Ki Teitzei:43	ושלא תלבש אשה כלי זיין וכו׳ כצ״ל (נזיר נ״ט.):
Ki Teitzei:44	בין מועטים. כי צפור לשון יחיד:
Ki Teitzei:45	לפניך לרבות אווזים וכו׳. דורש לפניך שהיו לפניך ומרדו בך (חולין קל״ט):
Ki Teitzei:46	פרט למעופפת. פי׳ מדלא כתיב והאם יושבת אלא רובצת משמע שבכנפיה נוגעת בקן רובצת מקרי (חכם הספרדי):
Ki Teitzei:47	ר״א שיהיה עוף טהור וכו׳. דצפור דווקא טהורה נקרא ולא טמאה:
Ki Teitzei:48	אפי׳ לטהר בה את המצורע. (חולין קמ״ב.) דהו״ל למכתב לא תקחנה על הבנים דבאם משתעי קרא מאי לא תקח האם אפילו לטהר בה את המצורע כך פירש הראב״ד (חכם הספרדי):
Ki Teitzei:49	פרט לקורא זכר. דורש שלח תשלח את האם דווקא. וקורא זכר דרכו להרביץ על הביצים:
Ki Teitzei:50	ומה הקלות שהם באיסר כך וכו׳ כצ״ל:
Ki Teitzei:51	לקח ירש וכו׳ מנין ת״ל בית מ״מ כצ״ל וכ״ה בספרי. והקרא ולא תשים דמים הוא דרשה בפ״ע כמו שמסיים:
Ki Teitzei:52	ראוי היה ליפול. (שבת לב.) ראוי היה ליפול שהרי לא נפל והכתוב קוראו נופל:
Ki Teitzei:53	שכל המקיים כלאים. ה״ה זורע שעובר בשני לאוין. ומקיים עיין (ע״ז ס״ד.) בפרש״י מקיים שעושה סייג וגדר כדי לקיימן דאל״ה הוי לאו שאין בו מעשה ואין לוקין עליו. וע״ש בתוס׳:
Ki Teitzei:54	פן תקדש וכו׳. שאסור בהנאה בספרי יליף ג״ש קדש קדש ע״ש וכוונתו כמו שהוא (חולין קט״ו) שיליף קדש דהכא מלא יהיה קדש בבני ישראל מה להלן הנאה (בעילה הנאה הוא. רש״י) אף כאן הנאה (ז״א) ונכון:
Ki Teitzei:55	מאימתי תבואה מתקדשת משתשריש כצ״ל (כלאים פ״ז) ע״ש:
Ki Teitzei:56	והרוח מסייעתו. [כלאים פ״ה] וסערתו הרוח לאחריו מותר לפניו אסור ע״ש:
Ki Teitzei:57	להביא בדין הדש והמנהיג וכו׳ כצ״ל וכ״ה בספרי וחורש לאו דווקא:
Ki Teitzei:58	פרט לגזי צמר ובו׳. שאינם משוזרים וקלועים ביחד:
Ki Teitzei:59	ר״י אומר אם בא עליה לוקה כצ״ל (כתובות מ״ה:) ע״ש שר״י סובר שלוקה רק מכות מרדות משום לא תלך רכיל ע״ש בפרש״י וע״ש בתוס׳:
Ki Teitzei:60	אמר לה הקדחת את תבשילי ולא הקדיחה כצ״ל$:
Ki Teitzei:61	להביא ביאה אחרת. היינו שלא כדרכה ודורש מלות כפולות ושם לה עלילות דברים והוציא עליה שם רע. והנה לפי סוגיית הש״ס (כתובות מו.) לא הבנתי דרשה זו כי כל הפלוגתא דראב״י ורבנן רק אם הבעל בעל או לא בעל. אבל העלילות דברים הוא רק שנבעלה לאחר כדרכה וכמסקנת הגמ׳ שם. והז״א האריך בזה אבל תירוצו אינו עולה יפה לפענ״ד. וצע״ג:
Ki Teitzei:62	בעמידתה הדברים נאמרים. פי׳ שיגיד לה הדברים בפניה דבעינן בפני בע״ד:
Ki Teitzei:63	מכאן שאין רשות וכו׳. מדכתיב ואמר אבי הנערה ולא כתיב ואמה כמו שכתוב למעלה אבי הנערה ואמה (חכם הספרדי):
Ki Teitzei:64	מלמר שרשות ביד האב לקדש את בתו הקטנה כצ״ל (כתובות כב.) מנין לאב שנאמן לאסור את בתו מן התורה כו׳:
Ki Teitzei:65	יבואו עדיו של זה וכו׳. (שם מ״ו.) דברי רבנן וזהו פירוש ופרשו השמלה קאי על העדים:
Ki Teitzei:66	לא על זו בלבד כו׳. דכתיב על בתולת ישראל ללמדך שהשם רע הוא על כל הבתולות:
Ki Teitzei:67	זה חומר במוציא שם רע. היינו ממפתה:
Ki Teitzei:68	להזים עדיו של זה. מה שאמרו לא נמצאו וכו׳ כצ״ל:
Ki Teitzei:69	במעמד כל אנשי עירה. פי׳ וכי כל האנשים רוגמים אותה. וכ״ה בספרי:
Ki Teitzei:70	מה כאן זנות עם זיקת הבעל. (סנהדרין נ:):
Ki Teitzei:71	בערים. היינו שעדים התרו בו:
Ki Teitzei:72	בעולת בעל להביא בעולת בעל בבית אביה היינו שבא עליה הארוס בבית אביה ועדיין לא נכנסה לחופה:
Ki Teitzei:73	סתם מיתה בחנק. כי בנערה המאורסה כתיב דוקא בתולה ואז נדונית בסקילה:
Ki Teitzei:74	גם להביא את המעוברת. (ערכין ז.) גם שניהם לרבות את הולד. ודע כי בספרי וכן ברש״י בחומש גירסא אחרת גם לרבות הבאים מאחריהם. עיין במזרחי שהביא ויש שפרשו שלא תאמר מאחר שדינם של נואף ונואפת נגמר למיתה הרי הם חשובים כמתים. ואם באו הם וזנו הוא באחרת והיא באחר ה״א שאין ממיתין האחרים על ידם כיון שנגמר דינם למיתה לא חשיבי מעשיהם כדאמרינן גברא קטילא קטל. קמ״ל גם לרבות הבאים מאחריהם ג״כ ידונו למיתה. ודברים אלו מבוארים בב״ר פ׳ ל״ב ר״נ בריה דרשב״נ אמרו (דואג ואחיתופל) לשאול וכי יש אישות לדוד הרי מורד במלכות הוא וחשיב כמת והותר אשתו של דוד ע״ש:
Ki Teitzei:75	אע״פ שנבעלה לקטן. והיינו בן ט׳ שנים ויום אחד שביאתו ביאה:
Ki Teitzei:76	נערה ולא בוגרת. (סנהדרין ס״ו:):
Ki Teitzei:77	שהפירצה קורא לגנב. דריש ומצאה איש בעיר מחמת שלא ישבה בביתה והלכה לעיר ע״כ אירע לה כזה:
Ki Teitzei:78	שער שנמצאו בו. שעברו בו העבירה (כתובות מב.):
Ki Teitzei:79	עפ״י התראה. דורש מלות על דבר בעת שהתרו בה:
Ki Teitzei:80	להביא כל שבענין כו׳. היינו שהיתה אנוסה וכ״ה בספרי:
Ki Teitzei:81	אין לנערה חטא. זה הקרבן מות זה מכות כ״ה בספרי:
Ki Teitzei:82	מלמד וכו׳. מצילין אותם בנפשם שם:
Ki Teitzei:83	בכל דבר וכו׳. היינו באחד מאבריו של רודף (סנהדרין סט.):
Ki Teitzei:84	פרט למפותה. שאינו נותן נ׳ סלעים:
Ki Teitzei:85	בעדים. כי עפ״י עצמו אינו משלם קנס:
Ki Teitzei:86	כל שכיבה. פי׳ אפילו שלא כדרכה (קדושין י.) גבי באו עליה י׳ אנשים ועדיין היא בתולה מודה רבי לענין קנס דכולהו משלמי כדעת הספרי והפסיקתא. אולם הרמב״ם פסק אין האונס והמפתה חייב קנס עד שיבוא עליה כדרכה ועיין בטור א״ה סי׳ קע״ז בב״י שדבר בזה. ואכמ״ל:
Ki Teitzei:87	ולא בוגרת. כי קנסה לעצמה גבי בוגרת:
Ki Teitzei:88	מלמד ששותה בעציצו. (כחובות לט.) ופי׳ שותה בעציצו בכלי שבחר בו ע״כ ישאנה:
Ki Teitzei:89	בעמוד והחזר כו׳. (גיטין צ.) והיינו שב״ד כופין לו שישאנה עוד הפעם ואינו לוקה שנתקו הכתוב לעשה:
Ki Teitzei:90	זהו סריס חמה וכשר כצ״ל:
Ki Teitzei:91	אר״י ארבע קהלות הם. תוספתא קידושין ט״ה (ובקדושין ע״ב ע״ג) נשתנה הגי׳ ובחנם נדחק בזה הרב ז״א:
Ki Teitzei:92	וחכ״א שלשה קהלות הם קהל כהנים קהל לוים קהל ישראלים. אבל לא קהל גרים כי גר אסור בממזרת. ודע כי הכל שייך ע״פ דלקמן לא יבוא ממזר:
Ki Teitzei:93	כגון העריות. היינו דוקא מחייבי כריתות או מיתות ב״ד (יבמות מט.):
Ki Teitzei:94	ולמטה הוא אומר גבי עמוני ומואבי בקהל ה׳ עד עולם. וכ״ה לקמן בדברי המחבר:
Ki Teitzei:95	מאי ממזר. בספרי מאי ממזר מום זר. ודברי המחבר מן המשפחות הכשרות הוא פירוש ע״ז. היינו שהאיסור רק מחמת בעילת האיסור אבל המשפחות כשרות הם:
Ki Teitzei:96	גדולה לגימה. (סנהדרין ק״ד):
Ki Teitzei:97	בדרך בשעת צרתכם. בספרי הגי: בשעת טרופכם היינו מי שהוא בדרך הוא בטירוף לא כמו שהוא בעיר שהכל מוכן:
Ki Teitzei:98	רחמנא אי בטולך וכו׳ כצ״ל (גיטין י״ז):
Ki Teitzei:99	המקבל אכסנאי. (ברכות סג:) המארח ת״ח בביתו וכו׳:
Ki Teitzei:100	ונטלו עצה להחטיא את ישראל. בעצת בלעם בשיטים:
Ki Teitzei:101	בנים אשר יולדו להם אלו הבנות. (קדושיו ע״ז:) תלאן הכתוב בלידה:
Ki Teitzei:102	אמר ר״י מנימין גר מצרי היה לי חבר וכו׳ כצ״ל:
Ki Teitzei:103	לבשר ענוים. חסידים לא נאמר אלא ענוים מכאן שענוה גדולה מכלם:
Ki Teitzei:104	אלא שהלילה וכו׳. (נזיר ס״ו.) אורחא דקרי למתיא בלילה:
Ki Teitzei:105	ולא בעמידה. דורש מסיפא דקרא והיה בשבתך חוץ בישיבה דוקא וכ״ה לקמן בדברי המחבר:
Ki Teitzei:106	ואין נפנין למזרח וכו׳. (ברכות ם״ב.):
Ki Teitzei:107	מפני שהשכינה במערב. ודרש מקרא כי ה׳ אלהיך מתהלך בקרב מחנך. והחכם ירושלמי פי׳ דברי הפסיקתא שהכוונה שאינו מכסה מיושב רק עומד ומכסה. ובעת העמידה לא יטה עצמו כלפי דרום שלא יהיה עגבותיו לצד מערב ע״כ דבריו בקיצור לשון:
Ki Teitzei:108	לרבות גר תושב. היינו אם העבד גר תושב ובא לא״י אל תסגירהו לידם (חכם הספרדי):
Ki Teitzei:109	באחד שעריך ולא שיהיה גולה וכו׳ כצ״ל. ודורש באחד שעריך שיהיה ישיבתו במקום אחד:
Ki Teitzei:110	בטוב לו. מנוה הרעה לנוה היפה. תוכל לשנות מקומו:
Ki Teitzei:111	ואי אתה מוזהר על האומות. עיין רמב״ן ובמזרחי שהאריכו בדבריהם. ולדברי הרמב״ן פי׳ הספרדי כי זה קאי על ב״ד להזהירם שלא תעמוד האשה הקדשה המוכנת לזנות מבנות ישראל אבל על בנות הכנענים לא הוזהרו ב״ד ע״ז. אף שהוזהרו ב״ד שלא יהיה בן הכנענים היושבים בא״י עובדי כוכבים ומזלות אבל ע״ז לא הוזהרו:
Ki Teitzei:112	והמתרגם אמר וכו׳. לא תהי אתתא וכו׳ הכוונה אחרי כי עבד הבא על בת ישראל אין קדושין תופסין בה והוי בעילתו בעילת זנות. וזה לא תהיה קדשה וכו׳:
Ki Teitzei:113	יכול אפילו העבירו ברגליו. ולא הקריבו:
Ki Teitzei:114	פרט לפרת חטאת. והיינו פרה אדומה ששחיטתה בהר הזתים ולא בעזרה:
Ki Teitzei:115	לכל נדר וכו׳. כל רבויה הוא ועופות באים בנדר או בנדבה. (הרע״ב):
Ki Teitzei:116	גם שנירם להביא שנוייהם. היינו חטים ועשאם סולת:
Ki Teitzei:117	מחיר זונה ואתנן כלב מותרים. דכתיב גם שניהם ולא ארבעה כצ״ל:
Ki Teitzei:118	אזהרה למלוה. דכתיב אל תקח מאתו נשך וכו׳ כצ״ל:
Ki Teitzei:119	לרבות כסף מעשר. היינו מעשר שני. דס״ל מע״ש ממון גבוה וסד״א דהוי כמו הקדש דאין בו משום רבית קמ״ל דעכ״פ הבעלים אוכלין אותו בירושלים ויש בו משום רבית (ז״ר):
Ki Teitzei:120	לרבות כל דבר. שאר דברים שאינו לא כסף ולא אוכל. כגון בהמה וכלים (ז״א):
Ki Teitzei:121	שלא ילמדנו מקרא כו׳. דורש דבר כמו דבור:
Ki Teitzei:122	הוא ולא חילופו. עיין (ר״ה ו׳) מסקנת הגמ׳ כגון שעברו עליו ב׳ רגלים והומם וחללו על אחר ועבר עליו עוד רגל אתד דקסד״א כמאן שעברו עליו ג׳ רגלים דמי קמ״ל שאינו עובר בבל תאחר עד שיעברו ג׳ רגלים על השני:
Ki Teitzei:123	שאינו עובר בב״ת אלא על השני כצ״ל:
Ki Teitzei:124	ולא בקרבנך חטא. היינו שהקרבן אינו נפסל בכך:
Ki Teitzei:125	והיה לוקח וכו׳. בכאן חסר וכצ״ל. ר״י אומר טוב מזה ומזה נודר ומשלם וע״ז קאי דברי המחבר והיה לוקח טוב. והכוונה מקודם כתיב בקרא את אשר תדור שלם. ואח״כ כתיב טוב אשר לא תדור ודורש ר״י כי הטוב מקרא שלאחריו שייך לקרא שלפניו. וכמו שהיה כתוב את אשר תדור שלם טוב והיינו שנודר ומשלם טוב מזה ומזה ועיין במדרש תהלים מזמור קט״ז דרשא זו ובביאורי (אות ט׳ מה שכתבתי שם בס״ד):
Ki Teitzei:126	מוצא שפתתיך זו מ״ע. (ר:ה ו׳.) וע״ש בתוס׳ שפירשו שכן כתיב והיוצא מפיכם תעשו היינו עשה:
Ki Teitzei:127	וכה״א ויעמוד וכו׳ אשר עשו לדבר. וע״ש בפרש״י אותו מגדל עץ עשו לשם כך לקרות שם עליו בספר תורה והוא קדשי בדק הבית ודורש אשר דברת כמו התם עשו לדבר:
Ki Teitzei:128	זה השכיר. (ב״מ פ״ז:) ויליף כתיב הכא כי תבא וכתיב התם לא תבוא עליו השמש מה התם בפועל אף כאן בפועל:
Ki Teitzei:129	פרט לקמת אחרים היינו של עכו״ם:
Ki Teitzei:130	ולא קודם לכן כצ״ל. היינו העושה במחובר לקרקע אינו אוכל:
Ki Teitzei:131	כענין קנה לך את שדי וכו׳ כצ״ל:
Ki Teitzei:132	ספר כריתות שיהיה כריתות לעולם כצ״ל:
Ki Teitzei:133	ושלחה מביתו. עד שיאמר לה הרי זה גיטך מכאן אמרו הזורק גט לאשתו ואמר כנסי שט״ח זה וכו׳ והרי גיטה אינו גט עד שיאמר לה הרי זה גיטך כ״ה בספרי וכצ״ל הכא:
Ki Teitzei:134	והלכה כר״א בגיטין וכו׳. היינו הרי את מותרת לכל אדם (גיטין כ״ו):
Ki Teitzei:135	אלא משעת נתינה. ובעינן שתשהה אחר גיטה ג׳ חדשים כצ״ל:
Ki Teitzei:136	ואין ביטול הגט אלא בפני ב׳. הלשון אינו מדוקדק וכצ״ל וביטול הגט אפילו בפני ב׳ כר״נ והיינו דלא כרב ששת דבעי שלשה שיהיה ב״ד:
Ki Teitzei:137	והלכתא כרב דאמר אין האשה וכו׳. (גיטין סג:) והיינו שליח הבעל שהוא שליח להולכה אין האשה יכולה לעשות לו שליח לקבלה ודעת הרי״ף והרא״ש והרשב״א דלא כהמחבר:
Ki Teitzei:138	עד שמת בעלה אינו גט. דאין גט לאחר מיתה:
Ki Teitzei:139	היא נדחית מלפניו. דטלטולא דגברי קשה מדאיתתא (חכם הספרדי):
Ki Teitzei:140	ובשתי שורות החיצונות יכתוב הזמן וכו׳ כצ״ל:<br>קמ. הא לא ניסת. היינו רק נתקדשה לאחר. ואח״כ בא בעלה מותרת לבעלה:
Ki Teitzei:141	ואין הולד תועבה. היינו מחזיר גרושתו משנשאת אף שעובר בלאו הולד כשר לכהונה:
Ki Teitzei:142	כך כל שני כלים.כגון זוג של מספרים או צמד של פרות:
Ki Teitzei:143	כי ימצא בעדים. ברש״י בעדים והתראה:
Ki Teitzei:144	איש פרט לקטן. היינו קטן שגנב איש פטור ממיתה:
Ki Teitzei:145	בין איש בין אשה. דה״א מדכתיב כי ימצא איש איש דוקא ת״ל ומת הגנב מ״מ:
Ki Teitzei:146	מלמד שאינו חייב עד כו׳. דורש ונמצא בידו ברשותו כמו ויקח את כל ארצו מידו:
Ki Teitzei:147	בחנק. כי סתם מיתה חנק:
Ki Teitzei:148	ההוא ולא הגונב את העבד ולא שחררו עדיין כצ״ל:
Ki Teitzei:149	השמר בל״ת. היינו שלא יקוץ הנגע:
Ki Teitzei:150	לשמור מאד משנזקק לטומאה. ט״ס בכאן (שבת קלב.) אין לי אלא משנזקק לטומאה עד שלא נזקק לטומאה מנין ת״ל ככל אשר יורו:
Ki Teitzei:151	נגעי בתים מנין. שלא יקלוף הנגע:
Ki Teitzei:152	בין מתוך הסגר. אסור לקוץ הבהרת:
Ki Teitzei:153	ואחד שכר שכיר. היינו דוקא בזקפן עליו אז אינו יכול למשכנו:
Ki Teitzei:154	יכול ימשכנו בחוץ ת״ל לעבוט עבוטו בחוץ כצ״ל. ודורש בחוץ מקרא דלאחריו הכא כמו שהיה כתוב לא תבוא לעבוט עבוטו בחוץ:
Ki Teitzei:155	לא תשכב ועבוטו עמך. כי אי אפשר לפרש לא תשכב בעבוטו ממש כי אסור להשתמש במשכן של אחר:
Ki Teitzei:156	כל אדם עני הוא בפעולתו. בספרי לפי גירסת הגר״א ז״ל למד זה מקרא (ויקרא י״ט) לא תעשוק את רעך וכו׳ לא תלין פעולת שכיר ושם לא נאמר עני הרי אף. גבי עשיר עובר הלאו ולא תלין:
Ki Teitzei:157	קצירך ולא קציר כנענים. היינו אף שנתגייר אח״כ:
Ki Teitzei:158	פרט למעמר בשדה אחרת. היינו פועל ששכח בשדה בעה״ב אינו שכחה:
Ki Teitzei:159	ושכחת עורד ולא הגדיש. היינו אם יש בו סאתיים תורת גדיש עליו:
Ki Teitzei:160	בשדה פרט לטמון. כמו הצנון והבצל והשום והלפת אינו שכחה:
Ki Teitzei:161	מיכן יהיה ספק לקט וכו׳. מילת יהיה יתרא הוא ובירושלמי פיאה פ״ד לומד מקרא עני ורש הצדיקו. הצדיקהו משלך ותן לו ספק לקט לקט:
Ki Teitzei:162	הראשונים היו חובטין. פי׳ כי לא היו מלקטין ביד מן האילן אחד אחד ונשאר הרבה לעניים:
Ki Teitzei:163	לא תפאר אחריך לא תתפאר לעני בה כצ״ל. והיינו בל תתפאר כי עשית בזה מצוה מה שתסייע לעני אחד. כי גוזל אתה בזה את האחרים:
Ki Teitzei:164	זכור ועשה. דורש רישא דקרא וזכרת ואח״כ כתיב מצוך לעשות:
Ki Teitzei:165	משום דהצדיקו את הצדיק והרשיעו את הרשע והיה אם בן הכות הרשע. אלא עדים שהרשיעו את הצדיק ואתו עדי אחריני והצדיקו את הצדיק (היינו שהזימו לעדים הראשונים) ושוונהו להנך רשעים והיה אם בן הכות הרשע כצ״ל:
Ki Teitzei:166	שהיו אומדין אותו אם אינו יכול לקבל מלקות ארבעים מלקין וכו׳ הראויה להשתלש כצ״ל:
Ki Teitzei:167	והכהו מלפניו שיהיה לוקה שליש מלפניו ושני שלישים מלאחריו כצ״ל:
Ki Teitzei:168	לימד על חייבי לאוין. היינו לאו שיש בו מעשה דווקא כמו לא.דחסימה:
Ki Teitzei:169	אבל אתה חוסם את הארס. פי׳ אף דמצוה על הבעה״ב להניח לפועל לאכול בשעת מלאכתו אף בתלוש אעפ״כ: אם חסמו אינו לוקה כי שור מיעוטא הוא (מזרחי):
Ki Teitzei:170	כי ישבו אחים שהיתה להם ישיבה אחת בעולם פרט לאשת אחיו שלא היה בעולמו כצ״ל:
Ki Teitzei:171	יחדו בעולם אחד. ט״ס כי זה דרש למעלה וכצ״ל יחדיו מיוחדים בנחלה פרט לאחים מן האם:
Ki Teitzei:172	ואינו נותן גט עד שיגדיל. היינו קטן בן ט׳ הבא על יבמתו קנאה אבל אינו יכול לגרשה עד שיגדיל:
Ki Teitzei:173	אלא הבכור זה היבם. וקרי ליה בכור שהוא גדול האחים:
Ki Teitzei:174	יקום לנחלה. שכל נכסי המת יורש הוא ואין אחיו חולקים עמו:
Ki Teitzei:175	פרט לאשת סרים שכבר הוא מחוי כצ״ל:
Ki Teitzei:176	ונאמר להלן שם. היינו גבי רות להקים שם המת על נחלתו:
Ki Teitzei:177	בישראל ולא בגוים. בספרי הגי׳ בישראל ולא בגרים (יבמות צ״ז) הגיורית שנתגיירו בניה עמה לא חולצין ולא מייבמין. ולפי גרסא דהכא הכוונה אם היבם מומר אינו זוקק לחליצה. וכבר הוא מחלוקת בין גדולי הראשונים. ואאמו״ר הגאון החסיד זלה״ה הראה מקום לזה בזוהר חדש פ׳ כי תצא וז״ל והא דאמרן כי ישבו אחים יחדו ר׳ יצחק אמר כי ישבו אחים שיכירו בלבם שהם אחים כמד״א וישב ה׳ מלך לעולם כמה דאשתמודעין דהוא מלכא על כולא. וברור שכוונתו שאם היבם מומר אינו זוקק לחליצה. ובתשובתו להגאון מ׳ יעקב זלה״ה אב״ד דקארלין בחיבורו שו״ת מהרי״ם נשמט דבר זה שם:
Ki Teitzei:178	מלמד שהיבמה וכו׳. (סנהדרין ל:) וקראו לו זקני עירו ולא זקני עירה:
Ki Teitzei:179	ושלא חפץ בה המקום כצ״ל. היינו שהיא בלא״ה אסורה עליו מחייבי לאוין אז אינה צריכה חליצה:
Ki Teitzei:180	רגלו הימנית. דילפינן רגל רגל ממצורע:
Ki Teitzei:181	אשר לא בנה ולא עתיד לבנות כצ״ל (יבמות י:) כיון שלא בנה שוב לא יבנה (חכם הספרדי):
Ki Teitzei:182	אין שלום יוצא. לעיל בפ׳ כתיב כי יהיה ריב בין אנשים:
Ki Teitzei:183	פרט לאשת שליח ב״ד. כ״ה ג״כ בספרי. והמה דברי הירושלמי בפרק החובל תני ושלחה ידה פרט לאשת שליח ב״ד וכו׳ מאן דאמר ושלחה ידה ולא אשת שליח ב״ד כשהכהו ברשות. והרב ז״א ציין לבבלי (ב״ק כ״ח) ושלחה ידה פרט לשליח ב״ד. ובסוף מסיק שם הש״ס בשאינה יכולה להציל ע״י ד״א נעשה ידה כשליח ב״ד ופטורה. היינו כל הנשים אם אינה יכולה להציל ע״י ד״א ואין שום מעלה לאשת שליח ב״ד מאשה אחרת. ואין שום מקור לזה רק מהירושלמי כמו שציינתי:
Ki Teitzei:184	מגיד שאינה כו׳ עד שתתכוון. דורש מדכתיב ושלחה ידה איני יודע שהחזיקה ומה ת״ל והחזיקה עד שתכוין לבושת כ״ה בספרי:
Ki Teitzei:185	המכחשת זו את זו. פי׳ שניהם משקל אחד. היינו ליטרא. אחת גדולה ואחת קטנה:
Ki Teitzei:186	ואם לאו לא יהיה לך. היינו שתעני ולא יהיה לך מה לשקול:
Ki Teitzei:187	להוסיף על הדמים. פי׳ אף שיוסיף על הדמים במקום שמוחקין או להיפך ינכה מן הדמים. אעפ״כ אסור מהטעם אבן שלמה וצדק:
Ki Teitzei:188	אל תשכח בלב כצ״ל:
Ki Teitzei:189	בדרך בשעת טירופכם. בצאתכם ממצרים בשעת גאולתכם כצ״ל וכ״ה בספרי:
Ki Teitzei:190	שלא יאגוד עליך אגודה כצ״ל. והיינו שיניח ה׳ לך מכל אויביך אז תוכל להלחם בו:
Ki Teitzei:191	מכאן אמרו ג׳ מצות וכו׳. (סנהדרין כ:):
Ki Tavo:1	ללמדך שגרול יום הגשמים וכו׳. (תענית ח:) ושם דורש מקרא שובה ה׳ את שבותינו כאפיקים בנגב ואין אפיקים אלא מטר:
Ki Tavo:2	והיה מיד. וכ״ה בספרי. ופי׳ תיכף כשתבואו לארץ יתתייבו בבכורים וקשה והלא לא נתחייבו בבכורים עד אחר ירושה וישיבה (קידושין ל״ז). והגר״א מוחק זה בספרי. וחכם הספרדי פי׳ והיה מיד קאי על פרשה דלמעלה על מלחמת עמלק. אבל דבריו דחוקים כי בפירוש דריש לעיל והיה בהניח ה׳ לך מכל אויביך שלא יאגוד עליך אגודה:
Ki Tavo:3	מה שתירש תכבוש ותשב בה כצ״ל. והכוונה בשכר שתירש כמו שכתוב והורשתם את יושבי הארץ גו׳ ואם לא תורישו גו׳ תזכו לישב בה. והגר״א בספרי מוחק הכל:
Ki Tavo:4	ונאמר להלן בכורי ציבור. פי׳ עומר ושתי הלחם נקראים ג״כ בכורים גבי עומר כתיב ואם תקריב מנחת בכורים וגו׳ ובשתי הלחם כתיב והניף הכהן וגו׳ על לחם הבכורים:
Ki Tavo:5	להלן חטים ושעורים שתי הלחם חטים והעומר שעורים:
Ki Tavo:6	ת״ל ראשית בכודי אדמתך. ולא כתיב מראשית:
Ki Tavo:7	נאמר התם בכורי צבור ונאמר הכא בכורי יחיד מה בכורי צבור מז׳ המינים האמורים בשבח הארץ אף בכורי יחיד שבעת המינים האמורים בשבח הארץ חטה ושעורהכצ״ל:
Ki Tavo:8	זית אגורי ששמנו וכו׳. ירושלמי שם כל הזיתים הגשמים יורדין עליהן והם פולטין את שמנן וזה הגשמים יורדין עליו והוא אוגר שמנו בתוכו:
Ki Tavo:9	ודבש זה דבש תמרים. ירושלמי שם (בכורים פ״א) מייתי מקרא (דה״ב ל״א) ובפרוץ הדבר הרבו בני ישראל ראשית דגן תירוש ויצהר ודבש. ודבש (דבורים) חייב במעשרות. אלא אלו דבש תמרים שהם חייבים במעשרות:
Ki Tavo:10	אפילו אשכול אחד. (בכורים פ״ג) אדם רואה אשכול שבכרה וכו׳. והגר״א הביא בא״א בשם התוספתא ששיעור בכורים אחד בששים. ובתוספתא בכורים שלפני לא מצאתי זה:
Ki Tavo:11	אי אתה מביא יין ושמן בכורים. (חלה פ״ד) יוסף הכהן הביא יין ושמן ולא קבלו ממנו:
Ki Tavo:12	זה שילה ובית עולמים. (זבחים קי״ט) כי לא באתם עד עתה אל המנוחה ואל הנחלה מנוחה זה שילה ונחלה זה בית עולמים. ולמעוטי נוב וגבעון:
Ki Tavo:13	כהן שהוא כשר. בספרי כל כהן שבימיך הוא כשר:
Ki Tavo:14	פעם אחת וכו׳. מלת היום דורש. והיינו אם הביא בכורים פ״א וקרא ואח״כ הביא עוד הפעם מין אחר אינו קורא (בכורים פ״א):
Ki Tavo:15	מלמד שטעונין תנופה. כתיב הכא ולקח הכהן הטנא מידך וכתיב התם (ויקרא ז׳) ידיו תביאנה את אשי ה׳ להניף אותו תנופה מה להלן תנופה אף כאן תנופה:
Ki Tavo:16	נטמאו בעזרה וכו׳. (בכורים פ״א) ובירושלמי שם הטעם ולקח הכהן הטנא מידך פעמים שאין נוטל רק הטנא. היינו אם נטמאו:
Ki Tavo:17	ועתה מיד היינו מיד שנגמר הפרי הבאתי. ומחמת זה נקראו בכורים (ז״ר):
Ki Tavo:18	מלמד שטעון הנחה ב׳ פעמים. גירסא זו נכונה מאוד שכן כתיב בקרא שתי פעמים א׳ והניחו לפני ה׳ קודם אמירה ואח״כ כתיב והנחתו אחר אמירה. והנה בספרי הגי׳ תנופה והגיה הגר״א הנחה כמו שהוא כאן. ובזה סרו כל קושיית התוס׳ (סוכה מ״.ר) ד״ה הבכורים שהיו לפניסס גירסא מוטעת בספרי תנופה:
Ki Tavo:19	בכל הטוב זה השיר. (ערכין י״א) אייתי טוב טוב. וע״ש בפרש״י שלומד מן (דברים כ״ח) בשמחה ובטוב לבב ע״ש. ובירושלמי בכורים לומד מדכתיב (יחזקאל ל״ג) והנך להם כשירעטגבים יפה קול ומיטב נגן:
Ki Tavo:20	מלמד שאדם מביא בכורי אשתו. (גיטין מ״ז:) דורש ולביתך זו אשתו:
Ki Tavo:21	מכאן אמרו ישראל ממזרים מתוודים אבל לא גרים כצ״ל ומלת מותרים ט״ס ופי׳ מתוודים מה שקורים בערתי הקודש:<br>כא. מכאן אמרו עיו״ט הראשון וכו׳. בראה הגי׳ עיו״ט האחרון והיא גי׳ נכונה ע״ש בביאורי:
Ki Tavo:22	שאין מוציאין אותו לח״ל. היינו המעשר עני:
Ki Tavo:23	אמרו משפחת כו׳. פי׳ שהיו עניים והיו דרים בירושלים ונתנו להם מעשר עני כ״כ ממון מרובא ולא נתנו לעניי ח״ל:
Ki Tavo:24	ואמרת בכל לשון כצ״ל ובכאן ט״ס וכ״ה (סוטה לב.):<br>כד. בערתי הקדש וכו׳ זה נטע רבעי ומע״ש שהם נקראים קודש:
Ki Tavo:25	מן הבית זו חלה. שהיא נתרמה מן העסה בתוך הבית:
Ki Tavo:26	כיון שהפרשתו וכו׳ אין אתה זקוק כו׳. פי׳ שאם נאבד בדרך קודם שיגיע ליד כהן או הלוי אינו חייב באחריותו. משא״כ בבכורים שחייב באחריותם עד שימסרנו לכהן:
Ki Tavo:27	למי שאינו ראוי. (מע״ש פ״א) אין מוכרין אותם אבל נותנים זה לזה מתנת חנם. וע״ש ברע״ב כגון שמזמינו לאכול עמו על שולחנו. וזה שאמר לא נתתיו למי שאינו ראוי (ז״ר):
Ki Tavo:28	לא שכחתי מלברכך. לפי שמברכים להפריש תרומה. וכן על מעשר ראשון ושני ומעשר עני וחלה:
Ki Tavo:29	לא אכלתי באוני וכו׳. וקאי רק על מעשר שני שאסור באנינות ולא שארי מעשרות:
Ki Tavo:30	מלמר שבבל יום ויום וכו׳. ודורש היום הזה וכו׳ מצוך לעשות וכבר היה מ׳ שנה מקבלת התורה. ועיין רמב״ן שכתב על הקרא הזה. שבכאן השלים משה לבאר דברי התורה והמצוה וע״ז קאי הקרא היום הזה:
Ki Tavo:31	לשון האמרת. היינו גדולה כמו התם בראש אמיר היינו בגובה האילן. עיין הראב״ע שפי׳ ג״כ כך:
Ki Tavo:32	כענין שנאמר מי פעל וכו׳ ראו איים וייראו וכו׳ כמו הכא ויראו ממך:
Ki Tavo:33	זה עשרה בניסן. כדכתיב (יהושע ד׳) והעם עלו מן הירדן בעשור לחודש הראשון:
Ki Tavo:34	נוטרין שלהם. הם המעתיקים והוא מלשון רומי נאטאר נאטאריוס על הסופרים:
Ki Tavo:35	לך. ארץ זבת חלב ודבש וע״ז אמר והיכן דבר: 
Ki Tavo:36	וקפלו את האבנים. היינו הסיד:
Ki Tavo:37	הראוי לשירות. היינו מבן כ׳ עד נ׳:
Ki Tavo:38	כל מצוה ומצוה. היינו מחמת ערבות וערבי דערבי עיין (סוטה ל״ז):
Ki Tavo:39	ונושא את חותנתו. פי׳ והיא אמה של האסופית שלקחה מקודם ומתה. וע״כ אמר ומתה כי בהיותה בחיים היתה אמה מכרת בתה:
Ki Tavo:40	כרת בידי שמים ט״ס וצ״ל מיתה בידי שמים:
Ki Tavo:41	מטה משפט גר יתום ואלמנה מיתה בידי שמים כצ״ל. והוא כדכתיב (שמות כ״ב) וגר לא תונה. כל אלמנה ויתום לא תענון ומסיים הקרא וחרה אפי והרגתי אתכם. הרי מיתה בידי שמים:
Ki Tavo:42	והברכות באות מאליהן. מלת והשיגוך דריש שיבואו מעצמם. וכן פי׳ הספורנו אע״פ שלא תשתדל להשיגם יבואו מעצמן:
Ki Tavo:43	שיהיה ביתך סמוך לבית הכנסת. (ב״מ ק״ז.) ובתנחומא ברוך אתה בבואך על תנאי בבואך לבתי כנסיות ובתי מדרשזת וכו׳:
Ki Tavo:44	כתיב כי שלמה יהיה שמו ושלום ושקט וכו׳ בימיו כצ״ל:
Ki Tavo:45	בענין שנאמר ויהמם וינגפו לפני ישראל כצ״ל:
Ki Tavo:46	פתח ה׳ אוצרו ויוצא את כלי זעמו כצ״ל:
Ki Tavo:47	שנאמר פלג אלהים מלא מים:
Ki Tavo:48	כי יפרידם בשמש. היינו במכה שבאה ע״י השמש. עיין ראב״ע:
Ki Tavo:49	ואין הפירות מרקיבין. ועכ״פ מה שזרעו לא יתקלקל:
Ki Tavo:50	לפי שדרך ב״א לבנות בית ואח״כ ליקח כרם ואח״כ נושא אשה כצ״ל:
Ki Tavo:51	רעים בשליחותם. (ע״ז נ״ה):
Ki Tavo:52	כן ישיש ה׳ את האומות.מגילה י.) אבל אחרים משיש:
Ki Tavo:53	מי יתן ערב שעבר. (סוטה מ״ט.) דבוקר דלמחר מי ידע מאי הוה:
Ki Tavo:54	ואמר להם דברי תוכחות. היינו מה שנאמר בפ׳ נצבים:
Ki Tavo:55	כך דרך הפסוק. כי מקודם כתיב לא בלו שלמותיכם מעליכם הוא לשון רבים. ואחר כך כתיב ונעלך וכו׳ לשון יחיד:
Nitzavim:1	על שהרשעים וכו׳. דורש תקות רשעים עברה לשון עבר ולשון עברה:
Nitzavim:2	יציבה בעולם. עמידה וקיום בעולם:
Nitzavim:3	וכי אפשר לו כו׳. (יבמות צ״ז) הג׳ וכי אפשר לאדם לגור בשני עולמים אלא וכו׳ יהי רצון שיאמרו. דבר שמועה בעוה״ז:
Nitzavim:4	אין כל אומה ולשון וכו׳. כבר בארתי במדרש תהלים מזמור כ״ב בביאורי (אות נ״ה) כי החילוק בין עומד ובין נצב ששניהם לשון עמידה. כי שורש נצב הונח על העומד בקומה זקופה כדיין ומושל. ומזה והנה קמה אלומתי וגם נצבה. יצאו נצבים. אין באדום נצב מלך והרבה כדומה. וכ״ה ג״כ דעת הזוהר (בראשית ק״נ) והנה ה׳ נצב עליו וכתיב אין באדום נצב מלך ע״ש סודו. וזה הוא ג״כ כוונת המחבר כתיב אתם נצבים. אין מקיימין את תורתי אין כל אומה ולשון מז׳ העממין יכולה לכם כי אתם תהיו נצבים היינו מושלים עליהם:
Nitzavim:5	אבותינו שמעו וכו׳. היינו יוצאי מצרים שכלם מתו במדבר:
Nitzavim:6	אלו הגבעונים. ואף שהגבעונים עדיין לא היו כי רק בימי יהושע באו. עיין בתנחומא. ויעשו גם הם בערמה מלמד שבאו אצל משה ולא קבלן. ופי׳ הרמב״ן הכוונה שלא יכלו לרמות את משה לכרות להם ברית אבל עשאם מיד חוטבי עצים ושואבי מים. ועיין (שבת קמו.) גבי גרים אע״ג דאינהו לא הוי מזלייהו הוי דכתיב את אשר ישנו פה:
Nitzavim:7	אשר ישנו פה. אלו המתים. ישנו דריש לשון ישן כי שינה אחד מס׳ במיתה:
Nitzavim:8	ואת אשר איננו פה אלו הדורות העתידים לבא. דהכא לא כתיב עומד עמנו היום רק עמנו היום מפני שהיו שם כל הנשמות העתידות לבוא אבל לא נראו עומדים. (הגר״א בא״א):
Nitzavim:9	כענין שהיו אומרים דורו של ירמיה. כחשו בה׳ ויאמרו לא הוא ולא תבוא עלינו רעה וחרב ורעב לא נראה כצ״ל וזה שאמר יברך את עצמו. היינו שיאמרו כשיעבדו ע״ז אז יהיו מבורכים:
Nitzavim:10	מה השתחויה שהיא עבודת פנים. עיין (סנהדרין ס:) זביחה מיוחדת שהיא עבודת פנים אבל השתחויה נחשב רק לעבודה דרך כבוד. ע״כ דברים אלו צ״ע:
Nitzavim:11	כגגד ארבעה. שפטים הרעים האמורים ביחזקאל חרב ורעב וחיה רעה ודבר ע״ש בקרא:
Nitzavim:12	כענין שנאמר בכל עצב יהיה מותר. כמו שפרש״י שם בכל יגיעת מלאכה יהיה ריוח וכן הכא והותירך ה׳ יתן לך הצלחה בכל מעשה ידיך:
Nitzavim:13	מלמד שעתידין אומות העולם וכו׳. המחבר חי במלחמת הצלב (קרייצקרי״ג בשנת תתנ״ו) כמפורש בפ׳ אמור בפ׳ המוציא אתכם מארץ מצרים אשר הרבה נהרגו ונשחטו על קידוש השם כידוע. וכשמצא פסוקים כאלו חם לבו בקרבו ונזכר בצרת ישראל:
Nitzavim:14	וכן אמר ישעיהו הכל היום יחרוש וכו׳. כל הפסוקים אלו בישעיה קשי ההבנה מאד הרד״ק בפירושו האריך בזה בדברים נכונים מאד. גם רש״י והמבאר האריכו בפסוקים אלו ודעת המחבר נראה בזה כי מתחלה ביאר הנביא הנהגת האדם בעת החרישה אשר לכל מין ומין אופן החרישה לפי ערכו כמו שאמר שוה פניה והפיץ קצח וכמון יזרוק (היינו זה בנפיצה וזה בזריקה) ושם חטה ושעורה נסמן (היינו חטים ע״י שורה היא הזריעה ושעורה נסמן סביב לסימן) ובכאן הפסיק הנביא באמצע. ויסרו למשפט אלהים יורנו. נטה המחבר מדרך המפרשים ופי׳ כשהנביא מוכיחם שילמדו תורה וזה ויסרם למשפט היינו משפטי התורה ואומרים ע״ז אלהים יורנו היינו שקשה להם להבין דברי התורה. וע״ז קאי דברי המחבר עד שאתם עמלים בדרך ארץ (שג״כ קשה לכם אעפ״כ אתם עוסקים בעבודת האדמה) עסקו בתורה. ואח״כ מסיים הנביא ג״כ הפסוקים לא בחרוץ יודש קצח וכו׳ שזה ג״כ אחר שנגמרה התבואה בזמן קצירה יש ג״כ מלאכה מרובה לכל מין ומין מלאכה אחרת ואין אתם עמלים בזה ע״כ עסקו בתורה. וזה שהתחיל המחבר תן דעתך עליה כשם שהפועל נותן דעתו על מלאכתו. וכן מסיים ומה אלו צריכין דעת כזה התורה לא כ״ש. ועיין (עירובין נ״ה) לא בשמים היא שאם בשמים היא אתה צריך לעלות אחריה וע״ש בפרש״י שצריך לטרוח ולהעמיד סימנים ולהערים בתחבולות כדי שתתקיים התורה בידך. כנ״ל לפרש פסקא זו אף שדברי המחבר מעורבבים והבוחר יבחר:
Nitzavim:15	שהיא יפה לקצח כצ״ל:
Nitzavim:16	לא ירד מן השמים ט״ס. וצ״ל לא נשתייר המנה בשמים. וכ״ה ברבה:
Nitzavim:17	עלה הלל מבבל. בירושלמי פ״ו דפסחים ה״א ושם הגירסא על ג׳ דברים עלה הלל מבבל וכצ״ל הכא:
Vayeilech:1	דע כי נצבים וילך נחשבים לסדרא אחת. וכן הובא בספרי עם ביאור הגר״א מהמגיה בשם הגר״א בתיקונים כ״י להגר״א ג״ן סדרים דאורייתא כי נצבים וילך סדרא אחת רק נחלקים כשחל ב״ג המל״ך (היינו כשחל ר״ה ביום ב׳ או ג׳) וכן הוא במסורת הפסוקים שחשב וילך ע׳ פסוקים הוא ביחד עם נצבים. וכן נראה דעת המחבר הזה כי בכל הסדרות כתב בהתחלתו איזה דרוש ומתחיל בפסוק שנמצא בו מלת טו״ב או טוב״ה לרמז בו שם המחבר הרב טובי״ה ובפרשה זו לא כתב כלל ונכלל בפרשה אחת עם נצבים: וכן בספרי דריש נצבים וילך ביחד. ועיין בספר שם הגדולים מערכת ספרים אות נ׳ ג״ן פרשיות ע״ש מה שכתב:
Vayeilech:2	ענין זה מוקדם ומאוחר. עי׳ מכילתא בשלח ע״פ אמר אויב וכו׳ חשיב כל המוקדמין והמאוחרין בתורה וזה לא חשיב:
Vayeilech:3	שהלך לו עם אבות העולם. היינו לחיי עוה״ב:
Vayeilech:4	שנאמר קח לך את יהושע בן נון כצ״ל:
Vayeilech:5	וויעד את כל ישראל. פירוש הקהיל את ישראל:
Vayeilech:6	ולהלן הוא אומר כי אתה תביא את בני ישראל אל הארץ וכו׳. (סנהדרין ה׳) ונ״ל הכוונה כי הכא כי אתה תבוא את העם הזה. תרגם אונקלוס ארי את תיעול עם עמא הדין וכו׳. והכוונה כי משה. רק הבטיח ליהושע כי יבוא ביחד עם העם לא״י אבל לא יהיה לו מעלה על העם. וזה שאמר התיעץ בהם. (היינו עם הזקנים) וחוץ מהם לא תעשה דבר. אבל לקמן כי אתה תביא את בני ישראל תרגם אונקלוס ארי את תיעול ית בני ישראל לארעא וכו׳ והיינו כי הכל תחת רשותו כי הוא יהיה המוציא והמביא ובלעדו לא ירים איש את ידו וזה שסיים טול מקל וכו׳. וכ״ה הכוונה ברש״י בחומש:
Vayeilech:7	אחינו אתה. שאמו היתה מישראל:
Vayeilech:8	ועד שמע ושמע והיה אם שמוע כצ״ל:
Vayeilech:9	כי תכלה לעשר ופרשת המלך כצ״ל:
Vayeilech:10	נמני מהשתא. היינו משנת ארבעים והלאה שבערבות מואב נאמרה פרשה זו. ושמיטין ויובלות התחילו למנות אחר י״ד שכבשו וחלקו:
Vayeilech:11	כיון שנפתח ס״ת אסור לדבר אף בדבר הלכה כצ״ל:
Vayeilech:12	ת״ל את כל דברי. וכל רבויא הוא אפילו מצוה אחת:
Vayeilech:13	עוברים את הירדן לרשתה כיון וכו׳ כצ״ל לרשת״ה דריש:
Vayeilech:14	שכל האותיות יש להם זוגות. שמ״ר פ׳ ט״ו ומסיים שם הקרא ה״ן עם לבדד ישכון:
Vayeilech:15	וה הוא שכתוב ה״ן קרבו ימיך וכו׳. והפסוק הנך שוכב וכו׳ ט״ס:
Vayeilech:16	קרבו ימיך למות ביעקב כתיב וכו׳ בר״ר פ׳ צ״ו:
Vayeilech:17	שלא הגיע לימי ישי. בר״ר שם שישי חי ד׳ מאות שנה:
Vayeilech:18	שלא יאמרו ישראל. דורש סיפא דקרא קרא את יהושע כו׳ ואצונו היינו שהקב״ה ידבר עמו בפני משה. וזה שאמר בחיי משה לא היה מדבר עם הקב״ה ועכשיו הוא מדבר:
Vayeilech:19	נתגבר כחו של משה. בספרי פינחס הלשון העמידו מן הארץ והושיבו על הספסל. היינו שזה עשה משה מעצמו כי אף ביום מיתתו היה לו כ״כ כח מרובה. ובספרי שם מסיים שלא יאמרו ישראל בחיי רבו לא הורה ועכשיו הוא מורה ע״כ הושיבו על הספסל להורות כי הוא ראוי להוראה. כי דרכם היה הרב יושב על הספסל ותלמיד יושב על הארץ:
Vayeilech:20	אף להלן. בתחלת הפרשה וילך משה הלך אל אוה״מ לקבץ כל ישראל:
Vayeilech:21	שם נתבקשה מיתתו של אהרן. שחזרו לאחוריהם ז׳ מסעות:
Vayeilech:22	וכן אתה מוצא בשמואל דכתיב. (ש״א כ״ה) וימת שמואל וכתיב (שמואל א׳ כ״ח) ושמואל מת ויקבצו פלשתים כצ״ל ובכאן עירבובי דברים בקרא. וע״ש בפרש״י הרי כבר נאמר וימת שמואל. אלא לפי שבא לדבר בשאול שהוצרך לדרוש בבעלת אוב פתח ואמר ושמואל מת שאילו היה שמואל קיים ממנו היה שאול דורש עכ״ל רש״י וזה שסיים המחבר נתבקש שמואל והנה מת:
Vayeilech:23	מלמד שנתבקש יהושע וכו׳. כי אלו היה יהושע קיים לא עשו בני ישראל הרע:
Vayeilech:24	הרי אלף וכו׳. המחבר כחב כאן קץ לימי המשיח בשנת קס״ד לאלף הששי. ובעוה״ר כבר עבר עדן ועדנים:
Vayeilech:25	שנאמר ויעד ה׳ וכו׳. ביד כל נביא וכל חוזה כצ״ל:
Vayeilech:26	וכן היה דרך במקדש שהיו לוים אומרים שירה כצ״ל:
Vayeilech:27	וה ספר התורה. היינו שכתב כל התורה גם פרשת האזינו וזאת הברכה. וכן פי׳ הספורנו:
Vayeilech:28	דיבר להם שני פעמים. שגם בהאזינו אחר השירה כתיב ג״כ ויבוא משה וידבר את כל דברי השירה הזאת וזה חד לכתיבה שכתבה בתוך התורה. וחד לקריאה שהגיד להם בע״פ:
Ha'Azinu:1	שלא נתוודע וכו׳. אלא מתוך תוכחה דכתיב ולא יכלו אחיו לענות אותו כי נבהלו מפניו. ועיין בר״ר פ׳ צ״ג אוי לנו מיום הדין וכו׳ יוסף קטן של שבטים ולא היו יכולים לעמוד בתוכחתו כו׳:
Ha'Azinu:2	האוזן לגוף כקנקן. רבה במקומו. והוא כלי מלא נקבים ונותנין מוגמר תחתיו ובגדים עליו והם מתגמרין דרך הנקבים (מ״כ):<br>ב. האזינו השמים ואדברה מנין שהשמים מקלסין וכו׳ כצ״ל:
Ha'Azinu:3	שנא׳ ויבואו בני ישראל כצ״ל:
Ha'Azinu:4	גבים גבים. וסיפא דקרא והנחל ימלא מים:
Ha'Azinu:5	לשון ריבוי. פי׳ כי ז׳ רקיעים הם ע״כ פתח האזינו לשון רבים:
Ha'Azinu:6	האזנה מקרוב. יתכן כמו שפי׳ הראב״ע כי מלת האזינו מגזרת אזן כאלו אמר הטו אוזן והוא מקרוב:
Ha'Azinu:7	ובימי יהושע הם העידו בעצמם. היינו שהיו אז זכאים וכ״ה בספרי בהתחלת הפרשה:
Ha'Azinu:8	שמא הארץ שינתה מדתה. וזה ותשמע הארץ:
Ha'Azinu:9	כמו הרעיפו שמים ממעל. שהוא לשון הזלה כמו הכא יערוף כמטר לקחי שיזל כמטר לקחי:
Ha'Azinu:10	ולבסוף תזל כטל בנחת כצ״ל:
Ha'Azinu:11	טעם לכאו״א מהן וכו׳. בגפן לפי מה שהוא בזית לפי מה שהוא כ״ה בספרי. לפי שכל מיני פירות טעמם מחולקים כך דברי תורה:
Ha'Azinu:12	זו רוח מערבית. (ב״ב כ״ה:) שבא מערפו של עולם רש״י פי׳ מערב קרוי אחור דכתיב אחור וקדם צרתני:
Ha'Azinu:13	רוח צפונית. שמזלת את הזהב דכתיב (א.וב ל״ז) מצפון זהב יאתה:
Ha'Azinu:14	כרביב. ומגדלת עשבים כצ״ל:
Ha'Azinu:15	אלא לאחר כ״א דבור שהם פ״ה אותיות כנגד פרשת ויהי בנסוע הארון כצ״ל והיינו מן האזינו עד ה׳ אקרא יש כ״א תיבות ופ״ה אותיות:
Ha'Azinu:16	אמר משה וכו׳. לאחר שלש קדושות שנאמר קדוש קדוש קדוש וכו׳ כצ״ל וכ״ה בספרי די להיות פחות מז׳ ממלאכי השרת. פי׳ כי משה הזכיר השם אחר כ״א תיבות וז׳ פעמים ג׳ הם כ״א כי המלאכים אמרו בתחלה ג׳ פעמים קדוש. והנה הז״א הקשה ע״ז (חולין צא:) חביבין ישראל לפני הקב״ה יוחר ממלאכי השרת שישראל מזכירין את השם אחר שתי תיבות שנאמר שמע ישראל ה׳ וכו׳. ומלאכי השרת אחר ג׳ תיבות קק״ק ומשה בודאי ג״כ קרא ק״ש ע״ש שהרבה להקשות. ואם כי באמת בדברים כאלה הנעלמים לא שייך לפלפל בקושיות ותירוצים. אולם לדידי לא קשה כלל כי באמת גבי תפלה ישראל חביבין שמזכירין השם לאחר שתי תיבות. גם במשה גופא ת׳ ואתחנן שהתחיל ה: אלהים אתה החלות הרי שהתחיל בהשם בראשונה. אך דהכא לגבי שירה שמשה אמר שירת האזינו והנה גבי מלאכי מעלה שהם שכלים נבדלים לא שייך בהם לשון תפלה רק לשון שירה כמו שם בחולין ג׳ כחות מלאכי השרת אומרים שירה וכו׳. והכא פרשת האזינו הוא שירה שמשה אמרה ע״ז קאמר ממי למד משה ממה״ש שאין מזכירין את השם. (היינו בעת שירה) רק אחר ג׳ תיבות ומשה אמר אחר כ״א תיבות ומה שתפס הלשון דיי שאהיה בפחות מז׳ ממלה״ש. דע כי מספר שבעה קדוש הוא עיין בפדר״א פ׳ י״ח וכן במדרש תהלים מזמור צ״ב כי שביעי קדוש הוא. ובלי ספק יש בו סוד גדול ליודעים. אחר כתבי זאת מצאתי להגאון מהר״ל מפראג בדרושו דרוש נאה. ביאר ג״כ המאמר הזה בפנים אחרים:
Ha'Azinu:17	מכאן אמד רשב״י. (נדרים י׳) והטעם דילמא אמר לה׳ ולא יאמר קרבן ומפיק ש״ש לבטלה:
Ha'Azinu:18	וכה״א ואולם וכו׳. וסיפא דקרא ולמען ספר שמי בכל הארץ:
Ha'Azinu:19	לא ברא הקב״ה וכו׳ אלא על האמת. יובן עפ״י מאמרם ז״ל אר״א הכל ברא הקב״ה חוץ מן השקר שלא בראו אלא ב״א בודין אותן מלבן:
Ha'Azinu:20	ואין עול גובה שלו באחרונה. היינו השכר לצדיקים והעונש לרשעים הכל באחרונה בעה״ב:
Ha'Azinu:21	שחת לו ישראל וכו׳. מפרש שחת לו היינו ישראל שחתו בעצמן כמו התם שחתך ישראל חבלת בעצמך:
Ha'Azinu:22	כל מקום שנאמר. (סנהדרין נ״ז.) ע״ש. ואולי כוונת המחבר לפרש בקרא כי ב״י בעזרך כמו שפירשו המבארים החדשים שהיה באותן הימים אליל הנקרא ב״י (bie) כידוע בהבלי המיטאלאגיע וזה שחת ישראל כי ב״י בעזרך. שעבדו לאליל ב״י:
Ha'Azinu:23	וכה״א ונתתיך ביר אנשים בוערים. מפרש בוערים לשון בוער באש:
Ha'Azinu:24	עם נבל ולא הבין. דורש נבל על שעבר וכן פרש״י:
Ha'Azinu:25	עמי לא התבונן על העתידות. פי שורש נבון הוא המבין דבר מתוך דבר היינו מה שעתיד להיות:
Ha'Azinu:26	כדכתיב ימותו וכו׳. רישא דקרא הלא נסע יתרם בם ימותו ולא בחכמה ומפרש כפי פי׳ הרלב״ג שכבר נסע ממקום יתרונם אשר בם על שאר בעלי חיים והוא השכל והלך לו וכו׳ ע״כ ימותו ולא בחכמה. וכן הכא מחמת שהם עם נבל ע״כ ולא חכם כי חכמת מה להם:
Ha'Azinu:27	רמ״א כרכא דכולא ביה. (חולין נ״ו:) דורש ויכוננך כמו ואת כנו היינו שברא להס בסיס לישב עליו (רש״י):
Ha'Azinu:28	ונתן לך מה שנשבע לך. והורישך מה שהבטיחך כ״ה בספרי. והיינו שהושיבך על כנ״ך בארץ ישראל:
Ha'Azinu:29	אלו הנביאים. שנקראים אב״י כדמסיים:
Ha'Azinu:30	תזכרו במה טובות ונחמות. דריש זה מסיפא דקרא בינו שנות דור ודור קאי על ימי המשיח שיקבלו אז הרבה טובות ונחמות:
Ha'Azinu:31	ליטול שני תחומין. היינו שני חלקים כי שני פעמים ע׳ הם ק״מ:
Ha'Azinu:32	יעקב שהיה שלישי לאבות. עיין ספרי כשנולד אברהם מהו אומר ואח לצרה יולד כשנולד יצחק מהו אומר טובים השנים מן האחד כשנולד יעקב מה הוא אומר והחוט המשולש לא במהרה ינתק:
Ha'Azinu:33	יסובבנהו לפני הר סיני שנאמר והגבלת את העם סביב כצ״ל:
Ha'Azinu:34	יבוננהו בעשרת הדברות. כי בינה הוא המבין דבר מתוך דבר וכן בי׳ דברות נכלל בו כל התורה כולה. עיין בספרי כשהיה הדיבור יוצא היו ישראל יודעין כמה הלכות ומדרשות וק״ו וג״ש יש בו שהכל בכלל בינה:
Ha'Azinu:35	ימצאהו. כגון ומצא להם. דורש ימצאהו יפרנסהו. ועיין בתרגום סיפק צרכיהון:
Ha'Azinu:36	יבוננהו נתן בהם בינה יתירה. כי ע״י אכילת המן ניתן להם בינה יתירה וזה מאמרם לא נתנה תורה אלא לאוכלי המן. וכ״ה (נחמיה ט׳) ורוחך הטוב נתת להשכילם ומנך לא מנעת מפיהם (הז״א בשם הבעה״ט):
Ha'Azinu:37	אלא מד׳ רוחות. שנאמר ה׳ מסיני בא. וזרח משעיר למו. הופיע מהר פארן הרי ג׳ רוחות. ופסוק (חבקוק א׳) אלוה מתימן יבוא הוא רוח רביעית:
Ha'Azinu:38	שלא ישלטו עליכם שרי הכנענים כענין שנאמר. ואני יוצא ושר מלכות פרס עומד לנגדי וכו׳ ושר יון וכו׳ כצ״ל. והמחבר שסיים הפסוק ואין אחר כי אם מיכאל שרכם. לא כדברי הרמב״ן שכתב ה׳ בדד ינחנו כי אין לישראל שר ומושל מכל בני אלהים היינו המלאכים שינחנו או שיעזור לו בלתי ה׳ לבדו כי הוא חלקו ונחלתו. ועיין ג״כ באדרת אליהו להגר״א זלה״ה:
Ha'Azinu:39	כענין שנאמר והאלילים כליל יחלוף. קאי על הכנענים עובדי כוכבים ומזלות ולא על הע״ז עצמה:
Ha'Azinu:40	זיתי גוש חלב. ששמנן מרובה עיין (מנחות פ״ה.) המעשה מאנשי לודקיא ששלחו לגוש חלב לקנות שמן ע״ש בארוכה:
Ha'Azinu:41	מעשה שאמר ר׳ יהורה לבנו בצפורי. בספרי הג׳: ר׳ יוסי והוא נכון כי ר׳ יוסי דר בצפורי (סנהדרין ל״ב:) אחר ר׳ יוסי לצפורי:
Ha'Azinu:42	כענין שנאמר עשרה בקר בריאים ועשרים בקר רעי ומאה צאן לבד מאיל וכו׳ כצ״ל:
Ha'Azinu:43	עם חלב כרים ואילים בני בשן אלו עשרת השבטים וכו׳ כצ״ל:
Ha'Azinu:44	חמאת בקר אלו הכנענים. אולי מפרש חמאת כמו שפרש״י הוא שומן הנקלט מלמעלה ע״ג החלב ודימה זאת לכנענים כי הם הראשונים שהחזיקו בארץ ישראל כמו השומן ע״ג החלב:
Ha'Azinu:45	שהצדיקים יורשים אותם. אולי דרש ענ״ב על ישראל כמו (הושע ט׳) כענבים במדבר מצאתי ישראל:
Ha'Azinu:46	שמנת בימי ירבעם. שהוא היה תחילה לקלקלה שחטא והחטיא בעגלי זהב:
Ha'Azinu:47	עבית מימי אחאב. (סנהדרין ק״ב.) קלות שעשה אחאב כחמורות שעשה ירבעם:
Ha'Azinu:48	כשית כל ימי יהוא. דורש כשית כמו כסית בסמ״ך (וכן פרש״י). והכוונה כי יהוא כיסה מעשיו שביטל עובדי הבעל כדכתיב וישמד יהוא את הבעל מישראל:
Ha'Azinu:49	טופכין של ע״ז. דפוסין של ע״ז היה בירושלים:
Ha'Azinu:50	הנחתם זכות אבותיכם. דורש תשי לשון שכרה כמו נשיתי טובה. והיינו הנחתם ושכחתם זכות אבות ואמהות. וצור קאי על האבות ומחוללך קאי על האמהות כדמסיים:
Ha'Azinu:51	שעשאך מחילין מחילין. פי׳ כי אדם חלול הוא באמצע וזה כדברי ר׳ מאיר (אהלות פ״י מ״ב) נתן את רגלו מלמעלה עירב את הטומאה דברי ר״מ שאין אדם נעשה אוהל מפני הטומאה כי אדם חלול הוא. וע״ש (פרק י״א) ב״ה אומרים אדם חלול הוא. כתבתי זאת כי ראיתי בספרי עם פי׳ זרע אברהם הגיה מן הצד דברי ר׳ יהודה וטעות הוא. וכ״ה בספרי בביאור הגר״א גורס ר״מ:
Ha'Azinu:52	להודיעם מה יהיה בסופם. מפרש אראה מה אחריתם בעבור שאני רואה מה יהיה באחריתם. כי קמי שמיא גליא. עיין בראב״ע ורמב״ן. ותפס הכתוב לשון אראה להודיע שאין ידיעתו מכרחת כאשר האריך הרמב״ם בשמונה פרקים בסופו (נכדי החכם ח״נ שיחיה):
Ha'Azinu:53	נכנסתם לארץ ונתתי לכם בית הבחירה. אמרתי לא תהיו גולים ממנה לעולם. כיון שאמרתם אין לנו חלק בדוד וכו׳ אף אני אמרתי לכם (עמוס ז׳) וישראל גלה יגלה מעל אדמתו כצ״ל:
Ha'Azinu:54	זה הבבואה. שהיו עובדים גם לזה שאין בו ממש:
Ha'Azinu:55	אלו כשדים. יתכן הכוונה (סוכה נ״ב) ד׳ הקב״ה מתחרט עליהן שבראן וחשב ג״כ כשדים ומביא האי קרא הן ארץ כשדים עם לא היה שלא היה נצרך להבראות:
Ha'Azinu:56	אלו שהם באים מברבריא. (יבמות ם״ג.) ה״ג אלו אנשי ברבריא שהם מהלכין ערומים בשוק שאין לך וכו׳. והכוונה ערומים בשוק שאין להם שום מדה אנושיית. וע״כ הרעו מאד לישראל:
Ha'Azinu:57	ד״א ותלהט מוסדי הרים אלו ד׳ מלכיות שנאמר (זכריה ו׳) ואשא עיני והנה ארבע מרכבות יוצאות מבין שני ההרים וההרים הרי נחושת ומלכיות דומין להרים מחמת תוקפן כצ״ל:
Ha'Azinu:58	חצי כלין והסאינסכלים. (סוטה ט׳) והוא ברכה בתוך הקללה כי ישארו אחר כל הצרות לברכה:
Ha'Azinu:59	מזי רעב שיהי׳ מוזין ומושלכים באשפות. בספרי לפי גרסת הגר״א שיהיו.מאוזין ברעב וכו׳ ונ״ל פירושו כי על קרא כמוץ אשר תדפנו רוח תרגם התרגום על מלת מוץ מזיא (וכן בכל ספרי אמ״ת כשבא מילת מוץ תרגם מזיא) ומוץ הוא קש הדק (פלעווע בל״א) ומפרש ג״כ הכא מזי רעב מלשון מזיא. היינו שהרעב ידפנו כמו קש לכל מקום ומקום. וע״ז מסיים הקרא יהיו מושלכים בחוצות ישראל וכו׳ המה נשיהם ובנותיהם וכו׳:
Ha'Azinu:60	מלשון ואתונא אזה יתירא. ויהיה פי׳ מזי מלשון אז״א והוא לשון שריפה:
Ha'Azinu:61	שהוא מרירי. בספרי הגי׳ שהוא מורר. ופי׳ החכם הספרדי מלשון ויורד רירו על זקנו. והוא משוגע:
Ha'Azinu:62	והיא בריה מהלכת בין חמה לצל. במ״ר פי״ב וכן במדרש תהלים מזמור צ׳. ועיין (פסחים קי״א):
Ha'Azinu:63	והיא מעלה נימי. היינו מכת ארסי כמו הזאב והערוד שנשיכתן מסוכנת:
Ha'Azinu:64	שנאמר בהן נחש שרף ועקרב וצמאון כצ״ל. והם ד׳ כנגד ד׳ מלכיות:
Ha'Azinu:65	אלו הכנים. בספרי הג׳ אלו התנינים (היינו הנחשים) שאין שלטונם אלא בעפר:
Ha'Azinu:66	ומספר הוצות ירושלים שמתם מזבחות לבושת:
Ha'Azinu:67	מי גרם לי כו׳. הכוונה מי גרם לי שלא אבדתי אותם. כעסן של האויבים כמו שמסיים שלא יאמרו ידינו רמה. וכ״ה בא״א להגר״א:<br>סז. ור״נ דורשו כלפי הכנענים. היינו הפסוק כי גוי אובד עצות:
Ha'Azinu:68	ונראין דברי ר׳ יהודא כצ״ל:
Ha'Azinu:69	אלו המתנתם שעה אחת. והיינו שלא עשו את העגל:
Ha'Azinu:70	אמר הקב״ה לישראל כו׳. זהו דברי ר׳ יהודא שדורש כלפי ישראל וקאי איכה ירדוף א׳ קאי על ישראל בעת הברכה וע״ז מסיים בסוף מלמד שהקב״ה מסרן ביד הכנענים לא מפני שהם גבורים וכו׳:
Ha'Azinu:71	זה אברהם וכו׳ שבחר לו הגליות בר״ר פ׳ מ״ה:<br>עא. ר׳ יהודא דורשו כלפי ישראל כצ״ל:
Ha'Azinu:72	כי מגפן סדום. חסר כאן וכצ״ל והוא דברי ר׳ יהודא כמו שהתחיל וכי מגפנה של סדום אתם או ממטעה של עמורה אתם. והלא אתם ממטע קודש שנאמר ואנכי נטעתיך שורק זרע אמת:<br>עב. בניו של אדם הראשון. דורש ענבמו ענבי ראש קאי על אדה״ר וסובר עץ שאכל אדה״ר גפן היה כדברי ר״מ (סנהדרין ע׳):
Ha'Azinu:73	אלו הגדולים שבכם. מרתן פרוסה בכם כאשכול ואין אשכול אלא גדול שנאמר אין אשכול לאכול וכו׳ כצ״ל וכ״ה בספרי: ויתכן כפי שכתבו חכמי התולדה שבשפת הירדן יש אילנות קטנים ועליהם פירות כמו ענבים גדולים טובות מראה. אך טעמם מוזר מאוד כמו עפר אדמה מרה מאוד וזה שאמר מרתן פרוסה כו׳:
Ha'Azinu:74	הכשרים שבהם וכו׳. (יומא כ״ב כ״ג) כל ת״ח שאינו נוקם ונוטר כנחש אינו ת״ת:
Ha'Azinu:75	שונים שבכם. בספרי הגי׳ ראשים שבכם והוא יותר נכון כלישנא דקרא ורא״ש פתנים:
Ha'Azinu:76	כך וכו׳. פי׳ כי ישראל עדיין לא נטלו רב טוב הצפון להם וכן להיפך הרשעים:
Ha'Azinu:77	אמר הקב״ה אני בעצמי עתיד ליפרע לירושלים כצ״ל. ודורש לי נקם ושלם אני בעצמי אשלם:
Ha'Azinu:78	בזמן שיביא הקב״ה על שכרם. דורש לעת תמוט רגלם קאי על הכנענים היינו בעת שיתמוטטו רגלם ויפקוד עונם אז יבוא הקב״ה לישראל על שכרם:
Ha'Azinu:79	ידין עמים וכו׳. כי הכל דרשת ר׳ יהודה שדורש הפסוק כלפי ישראל ודורש ידין עמו ידין עמים מה שעשו בעמו:
Ha'Azinu:80	ר״א כי יראה וכו׳. פי׳ שיתיאשו מן הגאולה:
Ha'Azinu:81	מודה מאוד כצ״ל וסיפא דקרא ואפס עצור ועזוב כמו קרא דהכא:
Ha'Azinu:82	שהיו מקניטין וכו׳. פי׳ שהאומות היו מקניטין את ישראל לעבוד עבודת כוכבים:
Ha'Azinu:83	וישראל אומרים להם כו׳. כפרש״י בישעיה שמא תאמרו להיות כמותם לדרוש צרכי החיים מן המתים היינו הע״ז שחשוב כמת:
Ha'Azinu:84	אין אברהם מציל. (סנהדרין ק״ד.) ברא מזכה אבא ואין אבא מזכה ברא:
Ha'Azinu:85	אין להם תשלומין. בממון אבל תשובה דוקא מועלת:
Ha'Azinu:86	והרשעים גורמים לישבע דכתיב וישא ידו להפיל אותם במדבר כצ״ל:
Ha'Azinu:87	אם אינו גובה אפותיקי שלו כצ״ל. והיינו חובו שיש לו:
Ha'Azinu:88	שאין מדה״ד חוזרת ריקם. בספרי ליתא זה. וכוונתו נראה שנופת צוף דברי הזוהר היה ידוע ג״כ להמחבר הזה שחי יותר משתי מאות שנה קודם שנתגלה הזוהר. עיין בזוהר דברים בסופו בהשמטות דף ש״ד ש״ה המעשה הארוכה באדם א׳ שחטא ושלחו מן שמיא חויא להענישו ופגע ר״א את החויא א״ל ר״א חויא חויא סטי לך מאורחך דהא תב ההוא גברא ואתנחם על מה דעביד וכו׳ א״ל ר״א חויא ידענא מה דאת בעי תוב מאורחך דהא עובד כוכבים חייבא אתי דעביד ביש לחד יהודאי והא נאים שכיב במערתא דילך זיל וקטלין וכו׳. פתח ר״א ואמר מאשר יקרת בעיני נכבדת ואני אהבתיך דהא לית רחימו להקב״ה בהדי בר נש בהאי עלמא אלא כמאן דתאיב מחוביה וע״ד ואני אהבתיך. אבל מאי אעבוד דהא יהיב רשו לחויא לנזקא דא הוא עיטא ואתן אדם תחתיך ההוא אדם רשע דאתי מעמא אחרא ע״ש בארוכה. וכן הוא כוונת הפסיקתא אם שנותי ברק חרבי שהפורעניות יוצאת מלפני הקב״ה כברק קלה (היינו על ישראל כשחוטאין) ומסיים שאם עושין תשובה הקב״ה מחזירה (היינו הפורעניות מהם) ומסיים ותאחז במשפט ידי שאין מדת הדין חוזרת ריקם היינו הפורעניות נותנה על רשעי העמים כמו דברי הזוהר שהעתקתי. ובהיותי במאהלוב פאדאלסקי הראני ידידי הרב ר׳ קלמן ראפאלאוויץ ראיה שאין עליה תשובה לקדמות ס׳ הזוהר אשר גם חכמי התלמוד ידעו מאתו וזה הוא (ע״ז ס״ח.) גבי מחלוקת שהשביח ולבסוף פגם קושיית ר׳ חגא לעולא ועולא השיב לו חגא לא מידי ידע מאי קאמרי רבנן תיובתא קא מותיב. דבריו אלו מותאמים לדברי הזוהר (שלח קנ״ז) מעשה ארוכה. ר״מ ור״י דאזלי באורחא ולבסוף בדף קנ״ח א״ר יסא וודאי דא הוא ר׳ חגא בכל יומא לא בעי לאחזאה גרמי במאי דידע הרי מצאנו מדתו וחסידותו של ר׳ חגא שהסתיר כח תורתו בלי לידע בבית חכמי התלמוד וזה הלשון חגא לא ידע מידי מאי קאמרי רבנן. ודפח״ח:
Ha'Azinu:89	אלו צוררי יהודא ובנימין כצ״ל. והיינו הכותים כדכתיב (עזרא ד׳) וישמעו צרי יהודה ובנימין כי בני הגולה כו׳:
Ha'Azinu:90	פורע מן הכנענים. פרעות אויב לשון פרעון:
Ha'Azinu:91	והורדתים אל עמק יהושפט. ואח״כ כתיב מחמס בני יהודה (היינו הגזילות שעשו) אשר שפכו דם נקי בארצם ונקיתי דמם כו׳ כצ״ל:
Ha'Azinu:92	ששפיכות דמם היא כפרתם. (סנהדרין מ״ז.) כיון דאקטלי קריה להו עבדיך:
Ha'Azinu:93	הוא הושע בן נון הוא יהושע כצ״ל. והיינו כי כבר קראו משה להושע יהושע ולמה נכתב כאן הושע לאמר שלא נתגאה אף שנעשה פרנס כמו שהיה מקודם בעת שהיה תלמידו של משה. וכ״ה בהדיא בספרי:
Ha'Azinu:94	אמר להם צריכין וכו׳. בכאן הלשון מתוקן קצת ובספרי משובש. והגר״א הגיה ומבארו וז״ל צריך. אני להחזיק טובה לכם (שבאתם ללמוד לפני) שתקיימו התורה אחרי. אף אתם צריכין להחזיק טובה לבניכם שיקיימו את התורה אחריכם. משה גדול הוא ואילו לא באו אחרים וקיימוהו לא היתה תורתו שוה אנו עאכו״כ עכ״ל:
Ha'Azinu:95	בשלשה מקומות הוא אומר בעצם היום הזה. כ״ה ג״כ בספרי. ועיין ב״ר פ׳ מ״ז בעצם היום הזה נימול אברהם אר״ב לא מראש בסתר וכו׳ אמר הקב״ה אילו מל אברהם בלילה היו בני דורו אומרים אילו היינו רואים אותו לא היינו מניחים אותו למול אלא בעצם היום הזה דרגיש ליה ימלל. ואת אשר הספרי וכן הפסיקתא לא חשיב הך דאברהם נ״ל עיין (יבמות ע״ב) וכ״ה בתוספתא שבת פט״ז גבי מילה שלא בזמנה מילת גרים וכדומה. דחכמים סברי אף הנמולים שלא בזמנה הוא ג״כ דווקא ביום ולא בלילה. ור״א ב״ר שמעון סובר מילה בזמנה דווקא ביום ושלא בזמנה בין ביום בין בלילה. והנה הספרי והפסיקתא סוברים כת״ק דאף מילה שלא בזמנה דווקא ביום ולא בלילה ולא יכול לחשוב הך בעצם היום דגבי מילה באברהם אלו מל אברהם בלילה שלא היה יכול למול בלילה אבל המדרש סובר כר״א בר״ש שמילה שלא בזמנה ביום ובלילה. שייך שפיר הדרשא אלו מל אברהם בלילה. וסיים דרגיש ליה ימלל:
Ha'Azinu:96	הר נבו שמתו בו ג׳ נביאים. דריש נב״ו לשון נבואה (חכם הספרדי):
Ha'Azinu:97	שלא ע״י עבירה. (ב״ב י״ז) שמתו בעטיו של נחש:
Ha'Azinu:98	אצבעו של הקב״ה היה מטרונו של משה. פי׳ היה המורה ומלמד למשה האיך חלקו א״י ומטרון הוא מלה יונית מורה ומלמד:
V'Zot HaBerachah:1	מאי למעלה למעלה מס׳ רבוא. (ברכות ז.):
V'Zot HaBerachah:2	הושע וכו׳. תן להם ה׳ מה תתן להם רחם משכיל ושדים צומקים הכל לקללה כמו שפרש״י שם:
V'Zot HaBerachah:3	אלו בתי דינין שלהם. כסיפא דקרא העושקות דלים הרוצצות אביונים וכו׳:
V'Zot HaBerachah:4	הברכה נאמרה בפרט. פי׳ לכל שבט ושבט בפ״ע:
V'Zot HaBerachah:5	איני יודע וכו׳ אם התפלה וכו׳. חסר ועיין בספרי וקאי על תפלה למשה איש האלהים שג״כ משה אמרה (עיין שו״ט מזמור צ׳ כי העשרה מזמורים מן תפלה למשה ולהלן משה אמרן ע״ש) וע״ז קאי איני יודע איזה אמר מקודם וע״ז אמר וזאת הברכה הוא״ו מוסיף שמקודם אמר תפלה למשה ואח״כ אמר וזאת הברכה:
V'Zot HaBerachah:6	במקום שפסק יעקב וכו׳. עיין שו״ט מזמור א׳ ועמד יצחק לברך את ישראל בנתינה וחתם קבריאה ויקרא יצחק אל יעקב ויברך אותו ועמד יעקב ופתח במה שחתם יצחק הה״ד ויקרא יעקב אל בניו וחתם בזאת שנאמר וזאת אשר דבר להם אביהם עמד משה ופתח לברך את ישראל במה שחתם יעקב בזאת וזאת הברכה וכ״ה ברבה:
V'Zot HaBerachah:7	אלישע נקרא וכו׳ בכאן חסר וכצ״ל אלישע נקרא איש האלהים שנא׳ (מלכים ב ד) כי איש אלהים קדוש הוא. מיכה נקרא איש האלהים שנאמר (מלכים א כ) ויגש איש אלהים אמוץ נקרא איש אלהים שנאמר (ד״ה ב׳ כ״ה) ואיש אלהים בא אליו כצ״ל. והוא במספר י׳ נביאים שנקראו כך:
V'Zot HaBerachah:8	וכה״א הנה אנכי שולח לכם את אליה הנביא. וכי עלה על דעתך שלאחר ביאה היה אליהו מתנבא מה ת״ל לפני בא יום ה׳. סמוך לביאתו כמו הכא לפני מותו סמוך למיתתו:
V'Zot HaBerachah:9	קומה ה׳ לנוחך כצ״ל:
V'Zot HaBerachah:10	וכן תקנו חכמים ונביאים. (ברכות לד) ג׳ ראשונות דומה לעבד שמסדר שבח לפני רבו אמצעית לעבד שמקבל פרס מרבו אחרונות לעבד שקיבל פרס מרבו ונפטר והולך לו:
V'Zot HaBerachah:11	שנאמר לא בסתר דברתי כצ״ל:
V'Zot HaBerachah:12	נכנסו כל האומות אצל בלעם וכו׳. עיין ספרי. וכן (זבחים קט״ז.) כשנתנה תורה לישראל היה קולו הולך מסוף העולם ועד סופו וכל מלכי העמים רעדה אחזתן. וע״ז שייך סוף המאמר הקב״ה מחזיר העולם לתוהו:
V'Zot HaBerachah:13	אמרו לו כל עצמנו בגניבה. בספרי הגי׳ כל עצמנו לסטים הם. וע״ז שייך הקרא והוא יהיה. פרא אדם ידו בכל וכו׳. אבל קשה מה שייך זה ללאו לא תגגוב. אבל עיין במכילתא פ׳ יתרו פ״ה הובא ג״כ מאמר זה וה״ג א״ל בזה הברכה נתברך אבינו והוא יהיה פרא אדם וכתיב כי גונב גונבתי מארץ העברים והיינו הישמעאלים שקנו יוסף מאחיו מכנה להם בשם גנבים. ובכאן וכן בספרי נשמט הקרא מן גונב גונבתי. וברור:
V'Zot HaBerachah:14	מלמד שכבודו של הקב״ה מלא עולמו. כוונתו על הקרא ויאמר ה׳ מסיני בא דה״ל למכתב לסיני או בסיני. וע״ז אמר שכבודו של הקב״ה מלא כל העולם. ומביא ראיה מקרא התשלח ברקים וילכו (משמע ששלחם מנגד פניו) ואח״כ מסיים ויאמרו לך הננו משמע שהם לפניו:
V'Zot HaBerachah:15	ד״א ויאמר ה׳ מסיני בא לשון נחת. והכוונה כי למעלה אמר כשנתן התורה הרעיש כל העולם על יושביו ועתה דורש להיפך לשון נחת כמו שמסיים פני ילכו והנחותי לך:
V'Zot HaBerachah:16	ארבע הופעות הן. פי׳ מקום שהיה גילוי שכינה:
V'Zot HaBerachah:17	כל המשתמש בה ניכר. שעושה בגופו רושם. וכ״ה בהדיא בספרי:
V'Zot HaBerachah:18	התורה ניתנה בימין. קאי על הקרא מימינו אש דת למו:
V'Zot HaBerachah:19	כל העוסק באש. היינו ד״ת:
V'Zot HaBerachah:20	מלמד שחיבב הקב״ה. עיין ספורנו. ואע״פ שאתה חובב עמים כמאמרך והייתם לי סגולה מכל העמים ומזה הודעת שמין אנושי סגולה אצלך מ״מ ישראל חיבב יותר מכל הכנענים:
V'Zot HaBerachah:21	מתכתתין לרגליך. בספרי אע״פ שאנוסין אע״פ שלוקין אע״פ ששבוים אעפ״כ ישא מדברותיך מקיימין התורה מתוך צער כמו שמסיים:
V'Zot HaBerachah:22	אלא לנו בעבורנו. והיינו שנקבל שכר על שמירתה:
V'Zot HaBerachah:23	שנאמר הבונה בשמים מעלותיו. וכמו שתרגם המתרגם די אשרי בתקוף רומה שכינת יקריה. והיינו אימתי השכינה עליהם מלמעלה אם למטה הם באגודה אחת:
V'Zot HaBerachah:24	יחי ראובן ואל ימות. מה ענין זה אצל זה כצ״ל:
V'Zot HaBerachah:25	אין מחליפין לא זכות בחובה. היינו מי שעשה עון לא ינוכה לו נגד זה מצוה שעשה:
V'Zot HaBerachah:26	יחי ראובן במעשה יוסף. היינו הזכות שעשה בעת מכירת יוסף עמדה לו לכפר מעשה בלהה:
V'Zot HaBerachah:27	זכר לו מעשה הצלע. היינו עון דבת שבע כי צלע זו אשה:
V'Zot HaBerachah:28	מעשה ההר דכתיב ויורדת בסתר ההר כצ״ל גבי אביגיל:
V'Zot HaBerachah:29	לעמתו שלמה בנה את המלוא (מלכים א׳ י״א) וזה את אשר הרים יד במלך (קאי על ירבעם) שלמה בנה את המלוא (זה לשבח) סגר את פרץ עיר דוד הוא לגנאי עיין (סנהדרין קא:) והוא ג״כ כעין זה מה שחטא במה שסגר את פרץ עיר דוד שעשה דוד פרצות בכדי להרבות דרכים לישראל בעת עלייתן לרגל תיקן במה שבנה את המלוא (כן פירש חכם הספרדי):
V'Zot HaBerachah:30	אלו גבורים בכח. שנאמר (ישעיה ג) מתיך בחרב יפולו וגבורתך במלחמה גבורים בתורה שנאמר גבורי כח עושי דברו כצ״ל:
V'Zot HaBerachah:31	וכה״א בארה בנו וגו׳. הוא נשיא לראובני שהיה גבור בתורה וע״ש בילקוט למה נקרא שמו בארה שהיה בארה של תורה:
V'Zot HaBerachah:32	יהא מתפלל לפניך. פי׳ שתפלתו יקובל לפניך (וזה מאמרם ב״מ פ״ה.) גזר רבי תעניתא איתנהו לר׳ חייא ובניו אמר משיב הרוח וכו׳ הוא מזרעא דיהודא עיין (כתובות ס״ב) דר׳ חייא אתי משמעי אחי דוד:
V'Zot HaBerachah:33	שנקבר עמהם לארץ. (סוטה ז:):
V'Zot HaBerachah:34	שעירבן בנחלה. שחלק של שמעון היה בתוך חלקו של יהודה. וכן הוא בקרא (יהושע י״ט) מחבל בני יהודה נחלת בני שמעון:
V'Zot HaBerachah:35	של שמעון ושל לוי כאחת. פי׳ כי שמעון נכלל בברכת יהודה כאמור למעלה ואין שמע אלא שמעון וכו׳ ואח״כ נאמר לוי:
V'Zot HaBerachah:36	שמעון ולוי שניהם לוו מן הקב״ה. שחטאו במעשה שכם:
V'Zot HaBerachah:37	שניסיתיו עמך בנסיונו. הלשון לא ידעתי לכוון ובספרי ה״ג הרבה נסיתיו ונמצא שלם. והיינו שכל הי׳ נסיונות שנתנסו בני ישראל במדבר בכולם לא היה שבט לוי עמהם וכן פירש הרמב״ן:
V'Zot HaBerachah:38	שלא נמצא במשה ואהרן וכו׳. בספרי ה״ג אם משה אמר שמעו נא המורים אהרן ומרים מה עשו. ולפ״ז אשר נסיתיו במסה תריבהו על מי מריבה קאי על אהרן אף שהיה לו פתחון פה לומר שלא חטא אעפ״כ קיבל דינו מן השמים בשמחה:
V'Zot HaBerachah:39	שהיה אבי אמו מישראל כצ״ל:
V'Zot HaBerachah:40	כי שמרו אמרתך במצרים. שמ״ר פ׳ י״ט במצרים בטלו ישראל את המילה חוץ משבטו של לוי למה כי שמרו אמרתך ובריתך ינצורו במצרים:
V'Zot HaBerachah:41	שיהו כל ההוראות וכו׳. (יומא כ״ו) לא משכחת צורבי מרבנן דמורי אלא דאתי משבט לוי ובכאן הלשון משובש וכצ״ל יורו משפטיך ליעקב כמה דכתיב והגידו לך את דבר המשפט ותורתך לישראל כדכתיב עפ״י התורה אשר יורוך:
V'Zot HaBerachah:42	אלו מנחות שאינן נאכלין. וכולן כליל ע״ג המזבח:
V'Zot HaBerachah:43	ברך ה׳ חילו. בנכסים כצ״ל:
V'Zot HaBerachah:44	מחץ מתנים. כענין שנאמר ומתניהם תמיד המעד רש״י וזה מי שמעורר על הכהונה בפרהסיא יהיה נופל כמו קרח כמו שמסיים:
V'Zot HaBerachah:45	ומשנאיו ששונאין אותו בלב. עיין לעיל בפ׳ נצבים בפסוק ונתן ה׳ אלהיך את כל האלות האלה על אויביך אלו המפורסמים ועל שונאיך אלו שבסתרו דורש זה על עוזי׳ כמו׳ שכחוב בקרא (דה״ב כ״ו) ובזעפו עם הכהנים והיינו שהראה להם פנים זועפים והוא שנאה בלב:
V'Zot HaBerachah:46	שנאמר ויהי מצורע עד יום מותו וישב בבית החפשית כצ״ל:
V'Zot HaBerachah:47	חביב הוא ביותר. בספרי לפי גרסת הגר״א שהרבה אוהבים הם וחביב מכלם ידיד והיינו שלשון ידיד מראה יותר אהבה:
V'Zot HaBerachah:48	שנא׳ שמו ידידיה בעבור ה׳ כצ״ל כדכתיב מקודם וה׳ אהבו:
V'Zot HaBerachah:49	ידיד זה אברהם שנקרא ידיד וכו׳ כצ״ל:
V'Zot HaBerachah:50	ויבנה ידיד זה בהמ״ק. במנחות שם גורס הקרא מה ידידות משכנותיך:
V'Zot HaBerachah:51	ישכון לבטח. חופף עליו במקדש ראשון כל היום זה בנין האחרון ובין כתפיו שכן בנין משוכלל לע״ל כצ״ל:
V'Zot HaBerachah:52	וכה״א כל ממלכות וכו׳.וסיפא דקרא הוא אלהים אשר בירושלים. היינו אף בחורבנו הוא אלהים בירושלים ששם מקומו והשראת שכינתו כה״ג הגר״א. בספרי:
V'Zot HaBerachah:53	הכתפים מקום גבוה שבשור. בספרי ה״ג הכתפים. מקום נאה שבשור עיין (זבחים נה:) סבר למבני בעין עיטם דמדלי אמרי נחתי ביה קליל כדכתיב ובין כתפיו שכן ובנאוהו בירושלים. והיינו גבי שור אף שקרנותיו יותר גבוהות אבל כתפיו יותר נאה אף שאין גבוה כ״כ וזה כוונת המחבר וכן בהמ״ק היינו ירושלים גבוה מכל הארצות נדמה לכתף שבשור:
V'Zot HaBerachah:54	וכאן הוא אומר ועלה הגבול. גי בן הנם אל כתף היבוסי מנגב הוא ירושלים וכו׳ והוא גבול יהודה אצל גבול בנימין. וע״ז קאי מלמד שהמקדש הוא בחלקו של בנימין לחלק יהודה ועיין בזבחים שם האריך רש״י בזה אך לשון הגמ׳ שם בשבט בנימין ועלה כתיב וירד לא כתיב הוא היפך מקראי ביהושע שם דגבי בנימין כתיב תמיד וירד ולא ועלה. והמהרש״א בח״א העיר ג״כ בזה. אבל לדעתי ברור שט״ס נפל בגמ׳ וצ״ל להיפך ותמיהני על מגיה הש״ס החדשים שלא הרגישו בסתירה כזה:
V'Zot HaBerachah:55	בית הבחירה יהי׳ בחלק בנימין. היינו המזבח עיין (זבחים נג:) וקרן מזרחית דרומית לא היה לה יסוד לפי שלא היתה בחלקו של טורף:
V'Zot HaBerachah:56	דושנה של ירחו לבני יתרו. עד שנבנה בהמ״ק בחלקו של בנימין ואז לקחו בני בנימין דושנה של יריחו:
V'Zot HaBerachah:57	שהיו מתנדבים זבחים כשהיו באים בנמל. כמ״ש ביונה א׳ ויזבחו זבח לה׳ וידרו נדרים ודרכם היו כשבאים בשלום מן הים לזבוח זבחים:
V'Zot HaBerachah:58	כי שפע ימים וכו׳. כי ארצו היה שני ימים ים הגדול וימה של יפו:
V'Zot HaBerachah:59	וסממיות. היא מין חיה קטנה המזקת:
V'Zot HaBerachah:60	זו טרית. פי׳ מיני דגים:
V'Zot HaBerachah:61	כלפי מזרח. כי נחלתם היה (במדבר ל״ד) מעבר לירדן קדמה מזרחה ושם היה מרחיב תחומו לצד המזרח היו כובשין עמים. וכמו שסיים הקראי מדה״י. וסופו ויבריחו את כל העמקים למזרח. והיינו שברחו ממקומם העמים ודורש העמקים לשון עמים ע״ש בפרש״י:
V'Zot HaBerachah:62	מלמר שהיה סמוך לספר. קאי על סיפא דקרא כלביא שכן שכל הסמוכין לספר צריכין להיות גבורים:
V'Zot HaBerachah:63	ומן הגדי נבדלו אל דויד היינו שבשבט גד היו גבורים הרבה:
V'Zot HaBerachah:64	וטרף זרוע אף קדקד. וטרף זרוע לשעבר אף קדקוד לעוה״ב כצ״ל:
V'Zot HaBerachah:65	ואומר עטרות ודיבון וכו׳. הארץ אשר הכה ה׳ לפני עדת בני ישראל כצ״ל. והיינו הערים הראשונים שכבשו היו לשבט גד וזה וירא ראשית לו:
V'Zot HaBerachah:66	שנאמר לא אוכל עוד לצאת ולבוא. והיינו בראש העם. וכן פירש הספורנו:
V'Zot HaBerachah:67	ד״א שעשה את התורה וכו׳. הכוונה משה קיים את התורה מא׳ ועד תי״ו דורש וית״א נוטריקון:
V'Zot HaBerachah:68	צדקת ה׳ עשה שכהב להם לישראל כי יהיה בך אביון: בספרי צדקת ה׳ עשה וכי מה צדקות עשה בישראל והלא כל מ׳ שנה שהיו ישראל במדבר באר עולה להם ומן יורד להם וכו׳ אלא שלמד תורה לישראל שנאמר וצדקה תהיה לנו כי נשמור לעשות את כל דברי התורה הזאת: 
V'Zot HaBerachah:69	מלמד שהצדקה קשורה עם המשפט תחת כסא הכבוד. שנאמר צדק ומשפט מכון כסאך כה״ג הגר״א:
V'Zot HaBerachah:70	גד גדוד חסר כאן וכצ״ל ד״א ויתא ראשי עם קאי על גד כדכתיב גד גדוד יגודנו מלמד כשם שבא בראש תחלה כך לע״ל יבוא בראש וזה ויתא ראשי עם לע״ל ועיין בפרש״י:
V'Zot HaBerachah:71	כמו ששנינו. (חולין פ״א) דיה אם זינקה כצ״ל וזינקה היינו קילוח היוצא מן הבהמה בעת שחיטתה שהדם יוצא לכמה צדדים כך הם קבלו נחלתם בא״י בשני מקומות:
V'Zot HaBerachah:72	ואומר ויעלו בני דן. ומקודם כתיב ויצא גבול דן מהם ויעלו בני דן וילחמו עד לשם וע״ש בפרש״י כאן נטלו קצת ועוד להם גורל במקום אחר רחוק מגבולם ע״ש וזה שאמר חלקו של דן מתחלק לב׳ מקומות:
V'Zot HaBerachah:73	יזנק קופץ וכו׳. ודורש יזנק לשון ידלג מהר הבשן וכן פי׳ הראב״ע:
V'Zot HaBerachah:74	לבני נפתלי יצא הגורל הששי כצ״ל:
V'Zot HaBerachah:75	שמח בחלקו בימים. בספרי בימים ובדגים ובפרגיות שהיה כ״ז בחלקו:
V'Zot HaBerachah:76	כמפורש במס׳ מגילה כצ״ל:
V'Zot HaBerachah:77	ולאשר אמר. לפי שנאמר ומקצה אחיו לקח וכו׳ כצ״ל וכ״ה בספרי. והיינו מקצה אחיו שהיו חלושים ואשר אחד מהם ע״כ הוצרך לברכו ברוך מבנים אשר שגם הוא יהיה מבורך כנ״ל:
V'Zot HaBerachah:78	שנתברך בבנים כאשר. הרמב״ן הראה מקום לזה בקרא (דה״א ז׳) כל אלה בני אשר ראשי בית האבות ברורים וכו׳ מספרם אנשים עשרים וששה אלף ולא נאמר בשאר השבטים כשבח הזה:
V'Zot HaBerachah:79	ורחצו רגליהם.לקיים מה שנאמר וטובל בשמן רגלו כ״ה בספרי ועי׳ מנחות פ״ה:
V'Zot HaBerachah:80	כיוצא בו אמר שלמה וכו׳. כמו זה שנוהג עצמו כעני שעושה עבודתו בשדה אף שיש לו הון רב (רש״י שם):
V'Zot HaBerachah:81	וכשם שהזית משכח. (הוריות י״ג) ושם כשם שהזית משכח לימוד של ע׳ שנה כך שמן זית משיב לימוד של ע׳ שנה:
V'Zot HaBerachah:82	ברזל ונחושת מנעליך מלמד שארצו של אשר וגו׳. רש״י פי׳ ארצכם נעולה בהרים שחוצבין מהם ברזל ונחושת וארצו של אשר היתה מנעולה של א״י בהרים הללו. ועיין רמב״ן גבול אשר היה בסוף א״י כמו שכתוב ופגע בכרמל ע״ש באורך:
V'Zot HaBerachah:83	מנעליך כמו מן יקומון. דורש מנעליך לשתי תיבות מן עליך אסיר מעליכם. והיינו הקללה ברזל ונחושת דכתיב ונתתי את שמיכם כברזל וארצכם כנחושה ויסיר מעליכם והביא ראיה מקרא מן יקומון שהכוונה שלא תהיה תקומה להשונאים:
V'Zot HaBerachah:84	יהיו כל הארצות דובאות וכו׳. מפרש דבאך לשון חוזק ותוקף (וכן פי׳ הקונקרדנציע) היינו כל ימיך יהיה לך חוזק מכסף וזהב שכל הארצות יקנו ממך שמן ויעשרוך כמו שמסיים:
V'Zot HaBerachah:85	כך ימי זקנותך. היינו שתחיה חיים טובים שלא יוכר אצלך בין ימי הזקנה לימי הנעורים. ואצלך יהיה כימיך (היינו ימי הנעורים דבאך כך יהיו ימי הזקנה):
V'Zot HaBerachah:86	שהאיש דובב וכו׳: ויהיה דבאך משורש דוב״ב והאלף תחת אות הכפל (כמו (ישעיה י״ח) אשר בזאו נהרים ארצו כמו בזזו:
V'Zot HaBerachah:87	דאבך כמו שמלה שלמה. ויהיה משורש דא״ב לשון עצבון. והיינו אפילו ימי דבאך היינו ימי עצבונך תואר לזקנה יהיה כמו בחרותך בטוב:
V'Zot HaBerachah:88	ופגע בכרמל. ששם הוא היותר מובחר:
V'Zot HaBerachah:89	לכך נאמר יהי רצוי אחיו. שהכל אוהבין אותו ואת ארצו:
V'Zot HaBerachah:90	בכל דבר כלום. פי׳ אין אתם יכולים לדמותו לשום דבר:
V'Zot HaBerachah:91	ולא יכול לזון עיניו ממנו. בספרי הג׳. מיד נפל לארץ והוא יותר נכון כפי הנמשל:
V'Zot HaBerachah:92	עתיר לגרש מפניך אויב. עיין בר״ר פ׳ מ״ד לזרעך נתתי את הארץ אתן לא נאמר אלא נתתי מכאן שמאמרו של הקב״ה מעשה:
V'Zot HaBerachah:93	שבירך יצחק ליעקב כו׳. וסיפא דקרא ורוב דגן ותירוש:
V'Zot HaBerachah:94	על פלטרין שלהם. על ערי המלוכה ועיר המלוכה במדינה נקרא במתי ארץ ששם מושב המלכים והשרים שהם הראשים:
V'Zot HaBerachah:95	עליה היתה למשה. כי גדולים צדיקים במיתתן כו׳:
V'Zot HaBerachah:96	שהראה הקב״ה למשה שלשלת המלכים כצ״ל:
V'Zot HaBerachah:97	מה הפסגה הזאת. דריש פסגה לשון פסיגין היינו ענפים שבם תלויים האשכולות כמו (עוקצין פ״א) פסיגה של אשכול:
V'Zot HaBerachah:98	מלמד שהראהו שלשלת של נביאים כצ״ל שעתידין כו׳ והיא היתה ביריחו (מגילה יד:) ח׳ נביאים ומהם כהנים יצאו מרחב הזונה:
V'Zot HaBerachah:99	מה שעתיר להיות עם תחיית המתים. דרש ים כמו יום:
V'Zot HaBerachah:100	ושמה לא תעבור. ונאמר להלן ושמה לא תבוא כצ״ל:
V'Zot HaBerachah:101	וימת שם משה. אפשר שמת משה וכתב וימת שם משה כצ״ל:
V'Zot HaBerachah:102	שהיה משה כותב. בב״ב הגי׳ משה כותב בדמע:
V'Zot HaBerachah:103	קולו היה נשמע. כשבירך את ישראל:
V'Zot HaBerachah:104	ועדיין לא ניתן מוראו עליהם. שנאמר ביום ההוא גידל ה׳ את יהושע באותו שעה ניתן מוראו עליהם כצ״ל:
V'Zot HaBerachah:105	ובלעם דמהו לטבחו של מלך. במד״ר שם מה טבח שואל אותו המלך כמה יציאות נצרך כי בלעם היה יודע מה עתיד לדבר אתו:
V'Zot HaBerachah:106	וכמוהו לא היה לפניו מלך. לא כתיב בישראל:
V'Zot HaBerachah:107	זו מכת בכורות. הז״א חמה הלא מכת בכורות היה ע״י הקב״ה כו׳. ואפשר לפרשה ע״פ מאמרם (זבחים ק״ב) ויצא משה מעם פרעה בחרי אף מאי בחרי אף אר״ל סטרו ויצא ע״ש ולפי זה יפה דורש ולכל היד החזקה על משה בעת מכת בכורות שסטרו לפרעה:
V'Zot HaBerachah:108	ד״א אשר עשה משה זו מלחמת סיחון ועוג כענין שנאמר ונך אותו כצ״ל:
V'Zot HaBerachah:109	זה העמדת החמה. מדברי המחבר נראה שדורש ג״ש ת״ת ת״ת. ועיין (תענית כ.) ג״ש אחל אחל גבי משה כתיב אחל תת פחדך וגבי יהושע כתיב אחל גדלך:
V'Zot HaBerachah:110	מכאן אמרו. (תענית שם) ג׳ קדמה להם חמה:
