Bamidbar:1	וידבר לשון זריזות. כמו וידבר ה׳‬ אל יהושע כצ״ל. ועיין (מכות י״א.) קרא ליה הגמ׳‬ וידבר לשון עז וכפי שמסיק שם. חד אמר מפני ששיהם (היינו שלא הפריש הערי מקלט לאחר שחלקו עד שנאמר לו מפי הקב״ה. פירש״י שם) ויהי כוונת המחבר דהכא לשון זריזות. דהיינו לאחר שחלקו אמר לו הקב״ה בזריזות שיפריש תיכף הערי מקלט ולא ישהה עוד:
Bamidbar:2	הכליל המנין. היינו שכתב המנין בסופו כמו שנאמר כשש מאות אלף:
Bamidbar:3	וכתיב בקע לגולגולת. וסיפא דקרא לשש מאות אלף גו׳‬ כמו המנין דהכא שבס׳‬ במדבר:
Bamidbar:4	וזה היה בשנה ראשונה וכו׳‬ ויפול מן העם וכו׳‬. הביא ג״כ האי קרא כי אחר שנפל מן עון העגל ג׳‬ אלפים נשתיירו במנין שש מאות אלף וג׳‬ אלפים וה׳‬ מאות ונ׳‬ כמו המנין דהכא.
Bamidbar:5	וזה היה באחד לחודש השני בשנה השנית כצ״ל:
Bamidbar:6	שישראל מתיחסים לאבות. (ב״ב קי״ב.) משפחת אב קרויה משפתה ע״ש: [ואיתא בספרים דכשמונה יחוס או״ה מיחסם לאמותם כמו שנים משר נשיאים לאמותם אל תקרא לאמותם אלא לאימותם ובישראל כתיב תמיד למשפחותם לבית אבותם. ה״ר חיים צבי ביארסקי]:
Bamidbar:7	שלא העמידו שופטים ונביאים כצ״ל עיין (סוכה כ״ז:):
Bamidbar:8	מפני בנות צלפחד. כונתו כדכתיב בקרא שם כי בנות מנשה נחלו נחלה בתוך בניו והיינו בנות צלפחד:
Bamidbar:9	שהיו בניהם זכרים. עיין בבעל הטורים על התורה מביא להיפך שבשבט נפתלי היו בנות יותר מזכרים. וכ״ה בס׳‬ פענח רזא. ודעת הפסיקתא הביא המנחת שי:
Bamidbar:10	למדנו כל זמן שהיו ישראל וכו׳‬. עיין פרש״י פ׳‬ תשא שסובר ג״כ כהמחבר דהכא שמנין השקלים הוא כמו המנין דהכא והכל היה בשנה אחת וכ״ה במ״ר פ׳‬ במדבר. והנה הרמב״ן פ׳‬ תשא הרבה לתמוה עליו. וז״ל ואני תמה איך יתכן שיהיה קהל גדול כמוהו ולא ימותו בחצי שנה למאות ולאלפים והנה לפי דברי הרב עמדו כ״ז חדשים ולא מת א׳‬ מהם. ועוד הא כתיב ויהי אנשים אשר היו טמאים לנפש אדם ע״ש ברמב״ן באריכות. וקושיתו השניה מקרא ויהי אנשים עי׳‬ בספרי במקומו. וכ״ה (סוכה כ״ה.) מי היו נושאי ארונו של יוסף היו דברי ר״י ר״ע אומר מישאל ואלצפן היו. אשר באמת לפלא שאלתם מי היו. מה לנו לידע שמות האנשים שמתו באלו הימים. אבל באמת גם אלו תנאים סוברים כדעת רש״י וכדעת המחבר שכל זמן שהיו עסוקין במלאכת המשכן לא חסרו מהם נפש א׳‬ ע״כ שאלו מי היו המתים באלו הימים י ע״כ סובר ר״י נושאי ארונו של יוסף. ולא מת א׳‬ בימים האלו. ור״ע סובר מישאל ואלצפן היו שטמאו א״ע לנדב ואביהוא והם היו מלויים ולא נכללו לא בנתינת השקלים ולא במנין דהכא אשר שבט לוי נמנה אח״כ ועולים דברי רש״י כמין חומר וזכרוני זה רבות בשנים הגדתי דברים אלו לפני א״א הגאון החסיד זלה״ה וקלסוהו:
Bamidbar:11	וכה״א בדוד וכו׳‬. וסיפא דקרא כי לא דרשנוהו במשפט. וככתוב בתחלת הפרשה שם אז אמר דוד לא עלי לשאת את ארון אלהים כי אם הלוים. וע״ש בביאור הגר״א:
Bamidbar:12	וסביב למשכן יהנו. זה באוה״מ במדבר כדכתיב בקרא המה ישאו את המשכן ואת כל כליו:
Bamidbar:13	מטכסים. פי׳‬ סדר שנתן להם אביהם:
Bamidbar:14	ונפתלי מצוייר בו נשר. במ״ר פ״ב ה״ג ונפתלי מצוייר בו אילן זית ע״ש מאשר שמנה לחמו ע״ש:
Bamidbar:15	שכל מי שנמשך אחריהם מכושלי המחנות וכו׳‬ כצ״ל:
Bamidbar:16	מכאן אמר רשב״ג. (סנהדרין י״ט:) ע״ש:
Bamidbar:17	שמלאו מקום אביהם וכו׳‬. כי בני אהרן כולם נמשחו בשמן המשחה:
Bamidbar:18	ת״ר ונלוו עליך וכו׳‬. (תמיד כ״ו:) ע״ש:
Bamidbar:19	ואחר אחורי בית הכפורת כצ״ל וכה״ש:
Bamidbar:20	למזרח הלוים ששה כצ״ל:
Bamidbar:21	אמרינן במס׳‬ תמיד. חסר קצת וע״ש:
Bamidbar:22	וחד בהפשט וניתוח. טעות הוא כי הלוים פסולים להפשט וניתוח עיין (ערכין י״א:) מה אתם בעבודת המזבח אף הם בעבודת המזבח וקאי דווקא על השיר שהיו משוררים בעת עבודה ע״ש. ואולי צ״ל חד בשירה וחד בשיער מה שהיו מסייעים בעת הגפת הדלתות:
Bamidbar:23	חסר יו״ד. היינו בשתי התיבות נתונים נתונים חסר יו״ד עיין במנחת שי:
Bamidbar:24	מכאן לויה שביכרה. (בכורות ג׳‬ ע״א) ע״ש.
Bamidbar:25	כ״ד מתנות כהונה. (חולין קל״ג):
Bamidbar:26	וכולם לאהרן ולבניו בכלל ובפרט וברית מלח. פי׳‬ כי בפרשה קרח כתיב לכל קדשי בני ישראל לך נתתים הוא כלל. ואח״כ פרט הכתוב וזה יהיה לך מקודש הקדשים לכל מתנותיהם וברית מלח כתיב בסיפא דקרא ברית מלח עולם הוא:
Bamidbar:27	חותך השדרה. פי׳‬ השדרה:
Bamidbar:28	היה יורד לתוך שדהו וראה תאנה שבכרה אשכול שביכר קושרו בגמי או במשיחה וכו׳‬ כצ״ל:
Bamidbar:29	פדיון פטר חמור כצ״ל:
Bamidbar:30	ואם עבר היובל ולא פדאה יוצאת לכהנים ביובל כצ״ל.
Bamidbar:31	וביקש להוציאן מן הגזרה. ע״כ מנאן בפני עצמם:
Bamidbar:32	שאלה זו שאל קונטרוקוס השר וכו׳‬ כצ״ל (בכורות ה׳‬):
Bamidbar:33	כיצד אעשה וכו׳‬. עיין כ״ז (סנהדרין י״ז):
Nasso:1	מבן שלש כצ״ל. ליטול מנת הלוים וכו׳‬ כי מבן ג׳‬ נתנו להם חלקם ככתוב בדברי הימים:
Nasso:2	עבודה שהיא צריכה עבודה. כי בעת הקרבת הקרבן היו הלוים אומרים שיר:
Nasso:3	במס׳‬ ערכין. (י״ג) ע״ש:
Nasso:4	תשעה כנורות וכו׳‬. היינו י״ב כלי שיר וכל לוי היה לו כלי שיר בפני עצמו לנגן עליו לי״ב לוים:
Nasso:5	אלא זירוז מיר ולדורות. עיין בספרי שלמד זה מנרות דכתיב גביה צו וכו׳‬ ומסיים חוקת עולם לדורותיכם:
Nasso:6	צו אזהרה. הגירסא זו נכונה מאוד כי ס״ל צו הוא לאו וכמו דרשת רבי שמסיים בספרי אין צו בכל מקום אלא אזהרה דכתיב ויצו ה׳‬ אלהים על האדם ומעץ הדעת טוב ורע לא תאכל ממנו. ובספרי הלשון אזהרה לא שמענו ת״ל צו את בני ישראל וישלחו מן המחנה. ומפרשי הספרי הבינו כוונת הספרי מן וישלחו מן המחנה והוקשה להם הרי זה עשה ולא לאו והרבה המבארים הבינו בזה דר״ל מסיפא דקרא ולא יטמאו את מחניהם אבל האמת יורה דרכו כי מלשון צו דריש ללאו וכן הוא כוונת הספרי:
Nasso:7	שהרי כתיב ואיש אשר יטמא וסיפא דקרא ונכרתה הנפש הרי עונש אזהרה מנין ת״ל צו כנ״ל:
Nasso:8	הצווי לשון זירוז. היינו צו לשון זירוז שישלחו תיכף המצורעים כמו שמסיים בסוף הפרשה:
Nasso:9	במחנה שכינה שומע אני ממחנה לויה ת״ל עד מחוץ למחנה תשלחום (הרי מחנה לויה אמור כצ״ל וכ״ה בספרי):
Nasso:10	ממחנה ארון הקל. הוא מחנה לויה ונקרא מחנה ארון הקל שהיו הלוים נושאים את הארון:
Nasso:11	אבן מסמא. אבן גדולה מונחת על הבגדים והזב יושב על האבן אע״פ שאינו מכביד על הבגדים. הבגדים טמאים:
Nasso:12	חמור טבול יום. חסר וכצ״ל כל שמחוסר כפורים פוסל טבול יום פוסל חמור ממנו טבול יום שהוא פוסל את התרומה וכ״ה בספרי:
Nasso:13	בכל אדם וכו׳‬ שלא נאמר רק בלוים לבדם הכתוב מדבר (שהם נושאי הארון) ת״ל מזכר עד נקבה תשלחום כצ״ל. וכ״ה בספרי:
Nasso:14	אלא שלא ענש וכו׳‬. הלשון אינו מדוקדק. ועיין בת״כ או אינו אלא כענין שענש מה מצאנו מטמא מקדש שלא ענש אלא גדולים אף כאן לא נאמר אלא גדולים ת״ל מזכר עד נקבה א׳‬ גדולים וא׳‬ קטנים במשמע:
Nasso:15	אף כל שראוי לעשות אב הטומאה. יצאו פחות מן ג׳‬ עד ג׳‬ שאינו ראוי לעשות אב הטומאה כ״ה הגירסא בילקוט ובספרי הגי׳‬ כמו הכא. ופי׳‬ המפרש שממעט כלי חרס שאינו נעשה אב הטומאה לעולם כמ״ש הרמב״ם בהקדמתו לטהרות ועיין (עירובין ק״ד ע״ב) אמר קרא מזכר עד נקבה תשלחו פרט לכלי חרס ועיין (נדה כ״ח:) תוס׳‬ ד״ה פרט לכלי חרס.
Nasso:16	מפתח הבית עד העזרה מחנה לויה מפתח העזרה ולפנים מחנה שכינה כצ״ל:
Nasso:17	ומשפשטו ידיהם בעבירה. אירעו בהס ג׳‬ דברים אלו זבים ומצורעים וטמאי מתים:
Nasso:18	שאף הטמאים לא עכבו. אף שיש צער לאדם שיפרוש מקרוביו. אעפ״כ קיימו גזירת המקום:
Nasso:19	לימד על גזל הגר. כדמסיים הקרא ואם אין לאיש גואל:
Nasso:20	ונשבע לו ומת הגר שישלם קרן וחומש לכהנים כצ״ל כי אם הגר קיים בחיים הקרן והחומש שלו כי בכלל עמיתך הוא (ב״ק ק״י ע״ש):
Nasso:21	עד שמת. היינו הגזלן מת אבל הגר הנגזל בחיים ע״כ מחוייבין לשלם הקרן כי אם מת הגר פטור אף מקרן:
Nasso:22	ולא אשר עשה אביו שאם אמר תן לי פקדון שהפקדתי אצל אביך והוא אמר לא הפקדת משביעך אני ואמר אמן ולאחר מכאן נזכר שומע אני שהוא חייב ת״ל והתודו את חטאתם אשר עשו ולא מה שעשה אביו כצ״ל:
Nasso:23	להביא שליח ב״ד. ערבובי דברים בכאן וכצ״ל ונתן לאשר אשם לו לפי שהוא אומר לאשר הוא לו יתננו ביום אשמתו אין לי אלא לו ולשלוחו מנין לרבות שליח בייד והיורש ת״ל ונתן לאשר אשם לו:
Nasso:24	ונשבע לו ומת הגר שישלם לו וכו׳‬ כצ״ל:
Nasso:25	להביא את האשה. היינו גיורת ג״כ משלם לה:
Nasso:26	ונותנו לכהן. קאי על הקרא האשם המושב לה׳‬ לכהן קנאו השם ונותנו לכהן:
Nasso:27	שגם הוא נאכל לכהן. שבאותו משמר וע״ז קאי הראיה מב״ק.
Nasso:28	נתן את הכסף ליהויריב ואשם לידעיה. כי משמר יהויריב קודם ובזה הביא גזילו קודם אשמו:
Nasso:29	מה תרומה מקריבין לכהן כצ״ל וקאי על הקרא לכל אשר יקריבו לכהן.
Nasso:30	לימד הכתוב שהבכורים לכהן. פי׳‬ שבאותו משמר. רמב״ן על התורה:
Nasso:31	אשתו הראויה. היינו הראויה לקיימה:
Nasso:32	פרט לקטן. היינו פחות מבן ט׳‬:
Nasso:33	אם כשבא על איסור הקל. עיין כ״ז (יבמות צ״ה.):
Nasso:34	למדנו דעדות שלימה אין בה: רק עד א׳‬ לסתירה:
Nasso:35	אבל בכהנת. (יבמות נ״ו ע״ב) אשת כהן שנאנסה בעלה לוקה עליה:
Nasso:36	וקינא את אשתו והיא לא נטמאה ר״ע אומר מה ת״ל נטמאה נטמאה ג׳‬ פעמים כצ״ל:
Nasso:37	ר״י אומר והיא נטמאה והיא לא נטמאה אם נטמאה למה שותה ואם לא נטמאה למה משקה מכאן שאין משקין אלא על הספק כצ״ל:
Nasso:38	מה סוטה רה״י. וחסר עוד מה סוטה דבר שיש בו דעת לשאול כו׳‬:
Nasso:39	שהיא ערוה חמורה בכרת. משא״כ סוטה בלאו:
Nasso:40	אינו מקיץ לה. פי׳‬ אין מנכה לה מכתובתה:
Nasso:41	מפני שלבה גס בהם ולא תודה כצ״ל:
Nasso:42	אין קדושים כו׳‬. דלפיכך קראו להם קדושים שנתקדשו בכיור:
Nasso:43	מביא עפר ממקום אחר ונותנו בקרקע המשכן והמקום מקדשו כצ״ל:
Nasso:44	אמר רבא מפני מה אמרה תורה כצ״ל:
Nasso:45	כהן פונה לאחוריה. דכתיב האשה לפני ה׳‬ ולא הכהן:
Nasso:46	ואמרינן בתלמוד (סוטה ל״ב) מנלן דכתיב ואמר אל האשה כצ״ל:
Nasso:47	וכ״כ למה. בכדי שתדע שאם נאנסה או ששגגה בזה לא יבדקו המים ולא תוציא לעז עליהם:
Nasso:48	מכאן אמרו פותחין כו׳‬. (סנהדרין ל״ב):
Nasso:49	מעשה שאירע. (סוטה ז׳‬:)
Nasso:50	אם טמאה את. צ״ל להיפך אם טהורה את הנקי ואם טמאה חנקי פותחין לטוב תחלה:<br>נ. להביא אשת הסריס. היינו סריס חמה שמותר לקיימה או שנעשה אח״כ סריס כשנשאה:
Nasso:51	וכי יש אשה מזנה תחת בעלה. היינו שבעלה רואה כשהיא מזנה:
Nasso:52	מכאן אתה דן. מסיפא דקרא בשבועת האלה:
Nasso:53	תנן התם במדה כו׳‬. (סוטה ח׳‬:):
Nasso:54	בצילצול. היא חגורה:
Nasso:55	זה בטנו וירכו של בועל. מיתורא דקרא דריש:
Nasso:56	אמר רבא מגלת סוטה וכו׳‬ כצ״ל:
Nasso:57	תנן התם בא לו. (סוטה י״ז.):
Nasso:58	דברי ר״י כצ״ל וכה״ש במשנה:
Nasso:59	אלא על המגלה שכתב בספר כצ״ל.
Nasso:60	שאם פרסה נדה כו׳‬. שהרי הכהן לא יכול ליקח מידה שלא תטמאנו ונם המנחה נטמאת ע״כ לא היתה שותה עד שתטהר:
Nasso:61	לימד על מנחת סוטה וכו׳‬ והניף את המנחה לימד על מנחת סוטה שטעונה הנפה והגשה כצ״ל.
Nasso:62	אמרו מעשה בב׳‬ אהיות. תנחומא וכן ברבה:
Nasso:63	מצוה לדורות. היינו נוב וגבעון שילה ובית עולמים:
Nasso:64	אשר תשטה. חסר. ובספרי להביא אשת חרש ואשת שיעמום ושהלך בעלה למדה״י שב״ד מקנאים לה לא להשקותה אלא לפוסלן מכתובתן:
Nasso:65	להוציא הארוסה. דריש מקרא מבלעדי אישך שקדמה שכיבת הבעל לבועל:
Nasso:66	כיון שקינא. אף לר״י שסובר לעיל וקינא רשות אעפ״כ אחר שקינא לה חובה להשקותה:
Nasso:67	אם עשה נקה. היינו שיעשה דווקא כסדר האמור בפרשה זו. ודורש זה מן ועשה לה הכהן את כל התורה הזאת כסדר דווקא:
Nasso:68	ובידו כח לעשות כפי שידו מגעת וכו׳‬ כצ״ל:
Nasso:69	מלמד שהכנענים וכו׳‬. ישראל למעוטי כנענים:
Nasso:70	להיות נוהג לדורות. הכוונה לדורות בנוב וגבעון שילה ובית עולמים. ובזמן הזה אם נדר בנזירות הרי הוא נזיר עולם וחייב לעלות לא״י לנהוג שם נזירות עד שימות או עד שיבנה בית המקדש שיכול להקריב קרבנותיו:
Nasso:71	מה בין נדר לנזירות שאם נדר יום כצ״ל:
Nasso:72	מכאן אמרו במס׳‬. (נדה מ״ה):
Nasso:73	ולא שנדר בקרבן. אם נדר בקרבן אינו נזיר דכתיב לנדור נדר להזיר עד שידור בנדרו של נזיר:
Nasso:74	להזיר עצמו וכו׳‬. ט״ס וכצ״ל נדר נזיר את עצמו הוא מזיר ואינו מזיר את אתרים.
Nasso:75	אמר שמעון הצדיק. (נדרים ד׳‬):
Nasso:76	שאין עונשין מן הדין. כי אם על משרת ענבים חייב ענבים עצמן לא כל שכן:
Nasso:77	כל ימי נדר נזרו תער לא יעבור על ראשו הרי הכתוב מוצאו וכו׳‬ כצ״ל:
Nasso:78	לעשות המגלח כמתגלח כצ״ל. פי׳‬ לוקה:
Nasso:79	שאם אמר הריני נזיר וגילח בתוך ל׳‬ יכול יצא כצ״ל:
Nasso:80	כל ימי הזירו. ט״ס וצ״ל כל ימי נזרו קודש הוא לה׳‬ להביא נזיר עולם כצ״ל למה נאמר לפי שהוא אומר עד מלאת הימים אין לי אלא שיש הפסק לנזירתו (היינו סתם נזיר שמנלח ליום ל׳‬) נזיר עולם מנין (שאינו מגלח רק לפרקים אם הכביד שערו) ת״ל כל ימי נזרו להביא נזיר עולם כצ״ל.
Nasso:81	וכתיב כל ימי הזירו לה׳‬ על נפש מת לא יבוא כצ״ל:
Nasso:82	אפילו בנפש בהמה. כדכתיב מכה נפש בהמה (נזיר מ״ח.) ע״ש:
Nasso:83	ק״ו לאמו. שהיא וודאית:
Nasso:84	מה אמו האמורה להלן בכ״ג במותם אינו מטמא אבל מטמא הוא לזיבתן אף אמו האמור בנזיר במותם אינו מטמא אבל מטמא הוא לנגעים ולזיבתן כצ״ל:
Nasso:85	שאין הקטנים נזירין. ובנזיר שם וברבה ליתא דרשה זו ואם יהיה הפירוש שאין האב יכול להדיר בנו בנזיר קשה הלא האב מדיר בנו קטן בנזיר (נזיר כ״ח):
Nasso:86	זו קדושת הגוף. שלא יטמא למתים. אף שמגלח אם הכביד שערו:
Nasso:87	להוציא את הספק. היינו טומאת התהום אינו סותר בנזיר (נזיר ס״ג.):<br>פז. פתע להביא את האונס. ובספרי הגי׳‬ פתע זה שוגג פתאום זה אונס:
Nasso:88	במס׳‬ (כריתות ט׳‬) כצ״ל:
Nasso:89	ומהו עליו. היינו כי ימות מת עליו וכו׳‬:
Nasso:90	תנן התם על אלו טומאות וכו׳‬. (נזיר פ״ז משנה ח׳‬):
Nasso:91	מת כל דהו. אפילו עצם כשעורה.
Nasso:92	במי שהיה טהור ונטמא הכתוב מדבר. אבל לא בעת שנדר בנזיר והוא בבית הקברות זה אין טעון גלוח (נזיר י״ח) ואינו מגלח את כל בשרו. דה״א ללמוד ממצורע שמגלח כל שערו.
Nasso:93	מכאן אמרו תגלחת הטומאה. פי׳‬ כיון דצריך לגלח בשביעי ולהביא קרבנותיו בשמיני מכאן אמרו וכו׳‬ ואם הביא ואח״כ גילח לא יצא:
Nasso:94	שלא יביא תורים וכו׳‬. פי׳‬ מה שמביא א׳‬ לחטאת וא׳‬ לעולה לא יביא תור לחטאת ויונה לעולה או להיפך אלא או כולם תורים או כולם בני יונה י
Nasso:95	מלמד שהואחהייב בטיפול הבאתן. כי אל פתח אהל מועד קרא יתירה הוא כי הכהן לא יקריבנו בחוץ:
Nasso:96	שנטמא למתים. וזהו מאשר חטא על הנפש.
Nasso:97	מעכבין את הכפרה. כדאמרינן הביא כפרתו אוכל בקדשים. חוץ מזה שאף קודם שהביא אשמו מתחיל למנות ימי נזירותו בטהרה:
Nasso:98	ולא שנה למנין עולם. שהפבש נצרך להיות בן שנתו מיום ליום:
Nasso:99	ואין רתגלחת סותרת הכל. שאם נזר יותר מל׳‬ יום וגילח באמצע אינו סותר אלא ל׳‬ יום דאין גידול פרע פחות מל׳‬ יום משא״כ בטומאה שסותרת הכל :
Nasso:100	לעשות ימים שלאחר נזירתו וכו׳‬. שאם השלים ימי נזירותו ועדיין לא הביא קרבן אסור לטמא למתים ולשתות יין עד שיביא הקרבן:
Nasso:101	ואהר נזיר עולם. נזיר עולם מגלח מי״ב חודש לי״ב חודש ומביא ג׳‬ בהמות לקרבן חטאת עינה ושלמים ואם נעמא מביא קרבן טומאה:
Nasso:102	שיביא את י ?צמו. עיין בספורנו על התודה שנתן תבלין בדרשה זו גם לרידפי הפשט:
Nasso:103	לימד לנזיר וכו׳‬. פי׳‬ שהג׳‬ בהמות מצות מחולקות הם. ע״כ אם גילח על אחת משלשתן יצא ועי׳‬ (נזיר מ״ה) גבי תגלחת טהרה:
Nasso:104	אין בכלל אלא מה שבפרט. פי׳‬ שאין טעון ד׳‬ מיני חלות כמו בתודה רק מצות ורקיקין:
Nasso:105	ואת האיל וכו׳‬ על סל המצות. ועשה הכהן את מנחתו ואת נסכו הלא כבר כתיב בפ׳‬ נסכים שאיל צריך נסכים אלא מפני שיצא מן הכלל שצריך לחם ה״א שא״צ נסכים ע״כ כתיב כאן את מנחתו ואת נסכו וזהו שמסיים והחזירו הכתוב לכללו:
Nasso:106	וגלח הנזיר וכו׳‬. כל הפיסקא משובשת וכצ״ל. וגלח הנזיר פתח אוה״מ בשלמים הכתוב מדבר (היינו שיגלח אחר שחיטת שלמים. ופתח אוה״מ פירוש השלמים ששם שוחטים שלמים) לפי שאין דרך כבוד שיהיה מגלח פתח אוה״מ. ר׳‬ יצחק אומר אינו צריך הרי הוא אומר ולקח את שער ראש נזרו ונתן על האש אשר תחת זבח השלמים מי שאינו מחוסר אלא לקיחה ונתינה יצא זה (היינו אם נאמר שיגלח פתח אוה״מ ממש) שיהיה מחוסר לקיחה ונתינה והבאה:
Nasso:107	וזה שאמר פתח אוה״מ וכו׳‬. גם בכאן משובש וכצ״ל. וגלח הנזיר פתח אוה״מ הא אין שם פתח אהל מועד לא היה מגלח. והכוונה שיהיה האוה״מ פתוח בעת התגלחת:
Nasso:108	אפילו בגבולין. היינו נוב וגבעון ושילה:
Nasso:109	אין בשילה אלא שלמה. עי׳‬ (חולין צ״ח:):
Nasso:110	אלו אחר התגלחו וכו׳‬. היינו התנופה הוא אחר התגלחו אבל הבאת קרבנותיו קודם הגילוח כדכתיב בהדיא בקרא:
Nasso:111	לפני ה׳‬ במזרח. עיין (מנחות ס״א:) פרש״י אף במזרח קרינן לפני ה׳‬:
Nasso:112	ויצא זה מכללם. פי׳‬ בזה נשתנה משאר שלמים שנותנים רק חזה ושוק ובשלמי נזיר נותן אף הזרוע לכהן:
Nasso:113	אחר כל המעשים. היינו אחר התגלחת ואחר הקרבן:
Nasso:114	לא בא מקרא זה לחדש כלום כצ״ל והוא דברי ר״י בספרי:
Nasso:115	לומר לך זאת תורת הנזיר לדורות. הוא דברי ר׳‬ יאשיה בספרי. ובכאן הרכיב המחבר שני דעות ביחד:
Nasso:116	קרבנו לה על נזרו וכו׳‬. ירושלמי פ״ב דנזיר. שאם הפריש קרבן נזירות קודם שנדר בנזיר אינו קדוש:
Nasso:117	לה׳‬ על נזרו ולא קרבן אחרים. בספרי הגי׳‬ ולא קרבן אחר על נזרו וחכם הספרדי מפרש אפי׳‬ על קרבן שהפריש אביו אינו מגלח אבל מגלח על מעות סתומים שהפריש אביו לנזירתו:
Nasso:118	ע״מ לגלח על מאה עולות. קורא אני עליו כפי נדרו ואסור לשתות יין עד שיקריב את כולם:
Nasso:119	שאל ר״א את רשב״י כצ״ל י
Nasso:120	רבותינו אמרו. (נזיר ה׳‬) מאמר בן פדא:
Nasso:121	שקדושת נזיר כקדושת כה״ג. ששניהן אין מטמאין לקרובים:
Nasso:122	זה כלל בתורה. הלשון אינו מדוקדק והכוונה שדברים הנעשים בכהנים אז נאמר הדבור רק לאהרן ולבניו כמו הכא גבי ברכת כהנים בישראל מעשה ישראל כמו פרשת עריות אשר זה רק לישראל ולא לגרים. ואם דבר בישראל ומעשה בכל אדם כגון שארי הדינים צריך להביא הגרים מיתורא דקרא. ועיין בקרא גבי שחוטי חוץ (ויקרא י״ז) שנוהג בכהנים ובישראל נאמר דבר אל אהרן ואל בניו ואל כל בני ישראל:
Nasso:123	ושרת בעמירה דכתיב ושרת וכו׳‬. וקשה הלא בקרא דלעיל כתיב ג״כ לעמוד לפני ה׳‬ לשרתו הרי שרות בעמידה. וכבר עמד בזה הג׳‬ ר״ע איגר בגליון הש״ס (סוטה ל״ח.):
Nasso:124	שיהיה כל הקהל כולו שומע כצ״ל:
Nasso:125	והוא עונה. קאי על הכהן:
Nasso:126	כענין שנאמר. אך את נפשו שמור כצ״ל (איוב ב׳‬):
Nasso:127	וכן הוא אומר קרית חנה דוד. דורש העיר הזאת היתה חינו של דוד ושלום ושקט אתו על ישראל בימיו:
Nasso:128	ששינה קדוש. היינו הקדוש ברוך הוא:
Nasso:129	ששינה מלאך. שדיבר עם מנוח מפני השלום שלאשה אמר הנה נא את עקרה ולא דיבר זה למנוח:
Nasso:130	וכנגד אלו האותיות חילק יחזקאל. עיין (ב״ב צ׳‬.) בתוס׳‬ ד״ה והשקל והר״ר משולם אומר דנקט קרא חשבון זה (היינו כ׳‬ שקלים כ״ה שקלים ט״ו שקלים) כנגד ברכת כהנים ביברכך ט״ו אותיות ביאר כ׳‬ בישא כ״ה ומסיים התוס׳‬ ושמא במדרש הוא כך והוא כאן לפנינו בדברי המחבר שהוא נחשב ג״כ מן המדרשים:
Nasso:131	כותבין את השם בג׳‬ יודיין. אולי הכוונה כי היה מנהגם כשהיו כותבין שם הוי״ה היו מסמנים אותו ג׳‬ יודי״ן בכדי שלא לכתוב השם על ניירות וכן מקודם היה המנהג ג״כ בסידורי תפלה היה המדפיס מציין השם ב׳‬ יודי״ן.
Nasso:132	במקדש בשם המפורש ובמדינה בכנוי כצ״ל:
Nasso:133	ונפילתן בחוץ. בספרי המלאך מדדן מתים עד שיצאו ונפלו בעזרה:
Nasso:134	רי״א. בספרי וכן (מנחות נ״ז:) הגי׳‬ ר״י אומר מדת הלח נמשחו מבפנים ונמשחו מבחוץ מדת היבש נמשחו מבפנים ולא נמשחו מבחוץ ופו׳‬:
Nasso:135	בנראה הביאום. אולי צ״ל בנדבה הביאום:
Nasso:136	את שתי העגלות ואת ארבעת הבקר נתן לבני גרשון כפי עבודתם שבני גרשון וכו׳‬ כצ״ל:
Nasso:137	אבל בני מררי. שעבודתם כבדה נתן להם את ארבעת העגלות ואת שמונת הבקר.
Nasso:138	המזבח. מסיים בספרי ולא קיבל משה מהם עד שנאמר לו מפי הקב״ה יקריבו את קרבנם לחנוכת המזבח:
Nasso:139	אע״פ שלא שוו במשקל כצ״ל. והיינו שבשניהם היה מדה אחת סולת וע״ז מקשה מה הפרש יש בין קערה למזרק. היאך יכול להיות ששניהם ישוו במדה אחרי שהקערה משקלה ק״ל והמזרק ע׳‬. ע״ז משנה זו גלדה עבה היינו הקערה והמזרק גלדו דק:
Nasso:140	רבותינו אמרו כו׳‬. (חגיגה כ״ג:):
Nasso:141	היא של זהב ומשקלה של כסף כצ״ל ומביא ראיה שנאמר כנ זהב הכפות עשרים ומאה שקל הרי שהיתה של זהב ומשקלה של כסף. וכ״ה בספרי וצ״ל ששקלי זהב אין משקלם שוה לשקלי כסף:
Nasso:142	מלמד שכולם כשרים לעולה כצ״ל והיינו הפר והאיל והכבש כולם הקריבו עולות:
Nasso:143	זה מביא קרבן נדבה. היינו הקטורת בנדבה והוראת שעה היתה:
Nasso:144	זה דוחה את השבת. כי הנשיאים הקריבו יום אחר יום וקרבן שבט אפרים היה ביום השביעי בשבת כמו שמסיים:
Nasso:145	ואת הטומאה. כי עדיין לא הוזה עליהם אפר הפרה כי הפרה נעשית ביום השני כאמור לעיל:
Nasso:146	שבא ראובן. וזה ששינה כאן הלשון הקריב שהקריב על כרחו של ראובן:
Nasso:147	שנמשח וכו׳‬ שביום שנמשח בו ביום הקריבו הנשיאים כצ״ל:
Nasso:148	כך שוו כולם בזכות. היינו ששכר כולם שוה אף שהקריבו יום אחר יום:
Nasso:149	ושוקלם כולם כאחד כצ״ל וכן הגיה הגר״א בספרי. והיינו אם שקלן אח״כ בבת אחת אי אפשר שיהיה משקלם שוה:
Nasso:150	זהו שאמר היא של זהב וכו׳‬. מבואר לעיל:
Nasso:151	וגמרינן אמר רב וכו׳‬. כל המאמר (שבת צ״ח) וראיתי בפי׳‬ הר״ן על שבת (נדפס מחדש בווארשא) האריך ג״כ ודבריו מה שבין דפני עגלה לגלגלים משתי רוחותיה קרו ליה צידי. וצד זה אמה וטופח ומחצה וזה השני כמו כן שהם שתי אמות ומחצה בין שתי הצדדים. ובין שתי נמי שתים ומחצה כלומר רוחב העגלה זהו רוחב שבין שתי דופנות העגלה. למה לי רוחב. העגלה שתי אמות ומחצה באמתא ופלגא סניא ברחב הקרש ומתרץ שלא יהו הקרשים מתעכבין בהוצאה ובהכנסה דרך ר״ה י״ו אמה ביצד המיסרי שהעגלה רחבה שתי אמות ומחצה ושתי צדדיה חמש אמות. ובין עגלה לעגלה חמש אמות. וכן לעגלה שניה חמש אמות הרי מ״ו אמות. ואמה לבן לוי שהיה מסבב לעגלות לתקן הקרשים שמקום אדם אמה: פירוש אטבי בזמן שלא היו הקרשים על הענלות והיו עליהם אטבי והם עמודי ברזל שסומכין עליהן את הקרשים כמו צואר של קורות משום הכי הוו רשות הרבים שלא היו על העגלות אלא אלו השפודים בלבד אבל אם הונחו הקרשים בין הענלות רשות היחיד הוה אלא יש מלבנות העגלה. כלומר שלא היתה העגלה מקורה. אמר רב עגלות תחתיהן וביניהן וצידיהן רשות הרבים. אמר אביי בין עגלה לעגלה כמלא ארך עגלה וכמה ארך עגלה המש והקשינו עלה כיון ששלשה קרשים מונחים בדרא בתראה על כל עגלה. והקרשין מונחין לרחבן. כל קרש רחבו אמה וחצי הרי אלו ד׳‬ אמות ומחצה למה לי למהוי ארך עגלה ה׳‬ אמות. בארבע ופלגא סגיא. כי היכי דלא נדחקו קרשים הרויח להם חצי אמה על עגלה זו מלא ורוחבה וחמש אמות מן הקרש בין עגלה לעגלה. כי עשר אמות אורך הקרש ולפי זאת הקשינו למה לי למהוי שתים ומחצה רוחב עגלה בפחות מיכן סניא כי אפשר שיהא הקרש אמה אחת מיכן על זו ואמה על זו או שתי אמות על זו ושתי אמות על זו וכו׳‬ הלכתא: מותאמים קצת לדברי המחבר:
Nasso:152	ת״ל ונועדתי כו׳‬. עיין בספרי כי בא הכתוב השלישי והכריע ביניהם.
Nasso:153	שמא תאמר קול נמוך ת״ל את הקול כצ״ל ומה הוא הקול המפורש בכתובים קול ה׳‬ בכח ובכאן חסר ומשובש.
Beha'alotcha:1	ומתוק האור כו׳‬. הביא פסוק זה וכל המאמר בכדי לסיים בהעלותך את הנרות וזה האורה:
Beha'alotcha:2	לפי שכל מעשה וכו׳‬ הביא את אהרן לכלל דבר זה. יתכן כפי שכתב הרמב״ן לפי שאהרן בעצמו הדליק הנרות כל ימיו ולא הניח זה לבנו כי היה מזרז במצוה הגדולה הזאת ואולי זאת המכוון בכאן:
Beha'alotcha:3	מכאן אמרו אבן. (תמיד ל׳‬:):
Beha'alotcha:4	מכאן אמר ר״נ. (מנחות צ״ח: מגילה כ״א):
Beha'alotcha:5	כפתורים נמי חד סר. כפתורים תרי דידה וששה דקנים וכפתור ופרח וכפתור הא חד סר ניהו ובכאן ט״ס:
Beha'alotcha:6	הגזוזטראות. הוא מין שברי כלים פסולה:
Beha'alotcha:7	וכה תעשה להם לטהרם הזה עליהם מי חטאת וכו׳‬ מכאן אמרו וכו וכצ״ל:
Beha'alotcha:8	והלוים הוא שנפקדו באחד לחודש השני כצ״ל:
Beha'alotcha:9	פרט לבית הסתרים. שדינם כמו מצורע:
Beha'alotcha:10	שלא ישנם מעבודה לעבודה כצ״ל:
Beha'alotcha:11	תניא עד שלא נכנסו. (חולין כ״ד.):
Beha'alotcha:12	ובשנת את״ח למלכות יונים אנחנו בזמן הזה. לפי חשבון זה כתב המחבר דבריו אלו בשנת ד׳‬ אלפים תתל״א לבריאת עולם. ובפרשה אמור מביא ג״כ גזירת תתנ״ו:
Beha'alotcha:13	בחודש הראשון. בכאן מתחיל פיסקא חדשה על פסוק וידבר ה׳‬ אל משה במדבר סיני וכו׳‬ באחד לחודש הראשון:
Beha'alotcha:14	ויעשו בני ישראל את הפסח במועדו כצ״ל:
Beha'alotcha:15	למה נאמר עוד במועדו. היינו בקרא השני:
Beha'alotcha:16	נראין הדברים וכו׳‬. דורש ולא יכלו לעשות הפסח ביום ההוא דווקא היינו שנטמאו למת מצוה וחל ז׳‬ שלהם בערב פסח ולא יכלו לעשות ביום ההוא דווקא אבל בלילה היו טהורים:
Beha'alotcha:17	והבשר יאכל לטהורים. נ״ל כי שאלתם היה כי הם ימנו על פסח אחד עם טהורים והדם יזרוק בשביל כולם ואכילת הפסח יהיה רק לטהורים ויהיה לטמאים ולטהורים שהפסח כשר ע״כ שאלו אם לכתחילה לעשות כן וכהוגן שאלו:
Beha'alotcha:18	ואין צבוד נדחין. היינו רוב הצבור אלא יעשו כולם בטומאה:
Beha'alotcha:19	וא״ת מעשה חזקיהו המלך. (סנהדרין י״ב):
Beha'alotcha:20	להביא שאר הטומאות. היינו זבין וזבות (פסחים צ״ג):
Beha'alotcha:21	וזה אחד מעשרה נקודות שבתורה כצ״ל עיין ספרי:
Beha'alotcha:22	עד מידבא שאף מלהלן היה כן כצ״ל וכ״ה בספרי ופי׳‬ הגר״א ז״ל אלא שבכאן החריבו גם את הערים ומלהלן לא החריבו אלא העם עכ״ל:
Beha'alotcha:23	ולא שהיה צריך חסר וכצ״ל ולא במצות שחוץ לגופו שיהיה צריך ביעור חמץ וכו׳‬ וכ״ה (פסחים צ״ה) ע״ש:
Beha'alotcha:24	נחלקו חכמים (יומא נ״א):
Beha'alotcha:25	להוציא את האשה. כ״ה הגי׳‬ בילקוט בשם רשב״י והכוונה כי הוא מ״ע שהזמן גרמא ונשים פטורות אולם הגר״א מחק זה בספרי:
Beha'alotcha:26	לא עשה את הראשון. כי סבר פסח שני תשלומין דראשון הוא וגר הואיל ולא היה ראוי לעשות את הראשון לא יעשה את השני:
Beha'alotcha:27	בא הכתוב והשווה את הגר. פי׳‬ מדכתיב חוקה א׳‬ קאי על שאר המצות וכ״ה בספרי:
Beha'alotcha:28	אף כאן חייב מיתה. פי׳‬ אם הלכו מעצמם בלי העלות הענן ובלי רשות משה דיליף לקמן מן ויעפילו:
Beha'alotcha:29	ימים מספר אלו חדשי השנה. רש״י פירש בחומש ימים מספר ימים מועטים. ולפי דברי המחבר לא הבנתי הלא כתיב אח״כ או חודש:
Beha'alotcha:30	ר׳‬ יותנן. בספרי איתא ר׳‬ יונתן וכ״ה (יומא ג׳‬):
Beha'alotcha:31	וכדומה לך זה דוד. פי׳‬ גם דוד השתמש בחצוצרות ונקראים על שמו כדכתיב ויעמדו הלוים בכלי דוד והשיר משורר והחצוצרות מחצרים. וכ״ה ברבה אתה משתמש בהם שאתה מלך ואין אחר משתמש בהם אלא דוד המלך:
Beha'alotcha:32	תקיעה כפני עצמה. דורש ותקעתם תרועה הוא שני קולות תקיעה ותרועה:
Beha'alotcha:33	שלש לכל דוח. הוא דעת י״א בספרי עיין בפרש״י ורמב״ן:
Beha'alotcha:34	ולא הוצדכו חכמים וכו׳‬. פי׳‬ שספק הוא אצל חז״ל מהו תרועה אם במנענע או במשבר:
Beha'alotcha:35	תמימים ולא בעלי מומין דכתיב הכהנים. ועיין בספרי דיליף בגז״ש:
Beha'alotcha:36	בהקהל. חכם הספרדי בשם הראב״ד בהקהל דכתיב הקהל האנשים והעם והיה בחג הסוכות שנת השמיטה ולא גבי הקהל העדה דמסעות דהתם בעלי מומין פסולים ודבריו נכונים וכ״ה בתוספתא סוטה פ״ז אותו היום (וקאי כשהמלך קורא פרשת הקהל) כהנים עומדים בגדרים ובפרצות וחצוצרות של זהב בידיהן תוקעין וכו׳‬ כל כהן שאין בידו חצוצרות אומרין דומה זה שאינו כהן שכר גדול היה לאנשי ירושלים שמשכירין חצוצרות בדינר זהב בו ביום ראה ר״ט חיגר עומד ומתריע בחצוצרות משם אמרו חיגר תוקע במקדש ע״ש הרי שהוא מעשה דהכא:
Beha'alotcha:37	וביובל. היינו יוה״כ של יובל שהיו מתריעין. והגר״א גורס בהדיא ביו״כ של יובל:
Beha'alotcha:38	וכי הצוצדות מזכידין. והלא דברים מזכירין כן גורס חכם הספרדי ופי׳‬ דברים תפלה:
Beha'alotcha:39	ר״נ אומר אלו תמידין. קאי על ובמועדיכם:
Beha'alotcha:40	זו מלכות שמים. היינו מלכיות:
Beha'alotcha:41	ויסעו שלא נסעו מעולם כצ״ל ופי׳‬ שזה המסע הראשון שלהם:
Beha'alotcha:42	אם משה אינו נכנס אף אנו אין נכנסים כצ״ל:
Beha'alotcha:43	ומה אני מקיים והיה השבט וכו׳‬. וסיפא דקרא שם תתנו נחלתו י
Beha'alotcha:44	מתכפר לו שאם טעו בהוראת צבור. ס״ל דכל שבט ושבט מביא פר בפ״ע כר״ש והגר מתכפר לו באותו שבט שגר בו.
Beha'alotcha:45	להטיב לגרים. וזה אשר דבר טוב על ישראל שישראל ייטיבו לגרים כ״ה בספרי.
Beha'alotcha:46	ת״ר כ״ד משמרות. (תענית כ״ז):
Beha'alotcha:47	לבני יונדב בן רכב. והמה מבני יתרו דכתיב (דה״א ד׳‬) המה הקינים הבאים מחמת אבי בני רכב:
Beha'alotcha:48	והרבית את גבולו. היינו בתלמידים ללמוד תורה כמו שמסיים הם היו חסרים היינו בני קני למדו אצל יעב״ץ:
Beha'alotcha:49	וענן ה׳‬ וכו׳‬ ז׳‬ עננים הם וענן ה׳‬ יומם ועננך עומד וכו׳‬ כצ״ל:
Beha'alotcha:50	על הזבים וכו׳‬. דורש וענן ה׳‬ עליהם מיותר הוא:
Beha'alotcha:51	שנא׳‬ לעיני כל ישראל בכל מסעיהם הא אפילו אדם נכנס חדר לפנים מחדר עמוד האש מאיר לפניו כצ״ל.
Beha'alotcha:52	פי׳‬ אך ורק. קאי על מה שהסימן דומה לכ׳‬ ור׳‬:
Beha'alotcha:53	ויפוצו אויביך אלו המכונסים כצ״ל:
Beha'alotcha:54	וכשהיו חונים היה עומד עמוד הענן מקופל ולא היה פורס כצ״ל:
Beha'alotcha:55	ד״א שובה ה׳‬ רבבות אלפי ישראל מגיד הכתוב שאין השכינה שורה למעלה אלא באלפים ורבבות שנא׳‬ רכב אלהים רבותים אלפי שנאן וכשם שאין השכינה שורה למעלה אלא באלפים ורבבות כך אין השכינה שורה למטה אלא באלפים ורבבות שנאמר שובה ה׳‬ רבבות אלפי ישראל כצ״ל:
Beha'alotcha:56	אין ויהי וכו׳‬. הלשון אינו מדוקדק: ועיין ספרי אין ויהי אלא שהיה להם דבר מתחלה מלמד שהיו מקולקלים וחזרו לקלקולם הראשון:
Beha'alotcha:57	על הנער אל הנער. ט״ס וצ״ל להיפך (שמואל א׳‬ א׳‬) אל הנער הזה התפללתי כמו על הנער היינו שזה יחיה:
Beha'alotcha:58	האבן הגדולה וכו׳‬. כאן ט״ס וצ״ל (שמואל א׳‬ ו׳‬) ועד אבל הגדולה כמו האבן הגדולה וע״ש ברש״י.
Beha'alotcha:59	לא בין המתים לחיים ולא בין החיים למתים. ופי׳‬ שלא היו יודעים מי הוא חי ומי הוא מת שאף החיים נחשבים כמתים:
Beha'alotcha:60	במוקצים בקצינים. חסר וכצ״ל חד אמר במוקצים היינו הרשעים שבקצה המחנה וח״א בכשרים שבהם ודורש בקצה המחנה בקצינים שבמחנה:
Beha'alotcha:61	אמר להם וכו׳‬. בספרי אין תבערה אלא כאדם שהוא אומר תבער אש פלוני במקומו (כלומר שהאש כבר מצויה באלו אמר שתבער ותדלק במקומו) וע״ז קאי עשיתם תשובה תהא שוקעת וכו׳‬:
Beha'alotcha:62	מפני שהם קשים לתלמוד. בספרי הגי׳‬ שקשים למעוברת:
Beha'alotcha:63	מה אתה מקיים ויתר וכו׳‬. הרי שהוצרכו לנקבים:
Beha'alotcha:64	רבותינו דרשו. (יומא ע״ה):
Beha'alotcha:65	לישה שמן ודבש. נוטריקון דריש לש״ד לישה שמן דבש:
Beha'alotcha:66	והכל טפילה לו. מה שלקחו מתגרי כנענים:
Beha'alotcha:67	כאן הקב״ה ממיך וכו׳‬. פי׳‬ הוא בא בנחת עם ישראל ומשה מגביה שנא׳‬ ובעיני משה רע כאשר מסיים הקרא למה הרעות לשום כל משא העם הזה עלי. ובעגל איפכא הקב״ה אמר ויחר אפו וכו׳‬ ומשה אמר למה ה׳‬ יחרה אפך בעמך וכו׳‬:
Beha'alotcha:68	על מצות בני ישראל. היינו מחלקותם:
Beha'alotcha:69	והוצאתו מאור כשרים ושמת שמו אברהם. (בתוספת ה״א) ואז ומצאת את לבבו נאמן לפניך והוא בהשראת השכינה בתוך לב אברהם.
Beha'alotcha:70	וי״א במתאוננים. נהרגו הזקנים:
Beha'alotcha:71	הוי בכ״מ לי מקודש לשם כצ״ל:
Beha'alotcha:72	אמר ר׳‬ אבא אין מושבין וכו׳‬. (סנהדרין י״ז) ושם הגי׳‬ ר׳‬ יוחנן:
Beha'alotcha:73	מלמד שאין אדם יושב בישיבה של מטה וכו׳‬ כצ״ל:
Beha'alotcha:74	הכשרים וכו׳‬. כ״ה בספרי ועי׳‬ (יומא ע״יה:) הגירסא להיפך בינונים לאלתר מתו ורשעים עד חודש ימים. גם לשון בינונים יותר נכון מלגרוס כשרים כי כשרים לא התאוו תאוה:
Beha'alotcha:75	שתהא מרחקים אותם יותר. דורש לזרא כמו לזרה בה״א מלשון זרה הלאה:
Beha'alotcha:76	לא די לכם וכו׳‬. והכוונה כי דבר הרגיל מסיר הפחד:
Beha'alotcha:77	שנאמר הצאן ובקר וכו׳‬. ט״ס וצ״ל הפסוק וגם ערב רב וכו׳‬ וצאן ובקר. יכול ששחטו במדבר ת״ל ומקנה רב היה לבני ראובן כצ״ל:
Beha'alotcha:78	אבל המה לא יאמרו די לנו. וזה היד ה׳‬ תקצר:
Beha'alotcha:79	למה הפסקה זו. קאי על הקרא ויצא משה וידבר אל העם:
Beha'alotcha:80	על השליו. (סנהדרין י״ז.):
Beha'alotcha:81	שנפסקה נבואתם. שלא נתנבאו אלא אותו יום בלבד.
Beha'alotcha:82	אלא והמה בכתובים. ופי׳‬ שהיה בידם נייר חלק וע״כ לא מסיים כאן הואיל ומעטתם עצמכם. ולדברי רשב״י פתקם נשאר שעלו זקן. אך מפני הענוה לא הלכו ליטול פתקם. וע״ז מסיים הואיל ומעטתם עצמכם:
Beha'alotcha:83	ביד עבדי ישראל הנבאים בימים ההם שנים להביא אותך. א״ת שנים אלא שניים כצ״ל וכ״ה בסנהדרין ובכאן ט״ס:
Beha'alotcha:84	במס׳‬. (סנהדרין י״ז) ע״ש.
Beha'alotcha:85	פסוק זה משמע בשני ענינים וכו׳‬. לא סיים המחבר המאמר הלז ודבריו צ״ע:<br>פה. שהיתה פורחת ועולה כגזון של צמר כצ״ל:
Beha'alotcha:86	אמר רב חנן בר רבא כצ״ל עיין (יומא ע״ה).
Beha'alotcha:87	כדרך יום כה כלפי צפון וכדרך יום כה כלפי דרום כצ״ל:
Beha'alotcha:88	מלמר שהן טעונין שחיטה. עיין (יומא ע״ה) הגי׳‬ משמיה דריב״ק כמו הכא שירד עם המן לישראל דבר הטעון שחיטה. ותיבת עם המן ט״ס בבבלי וצ״ל כמו הכא שדרש רק כי השליו טעון שחיטה ותמיהני על מגיהי הש״ס שלא הרגישו בזה. (הערני לזה ידידי ר׳‬ זאב ליבערט מפינסק):
Beha'alotcha:89	כיון שנתנו לתוך פיו כצ״ל.
Beha'alotcha:90	מלמד שלא הביא הקב״ה עליהם וכו׳‬. בז״א ביאר שלומד מג״ש כתיב הכא ויך ה׳‬ בעם וכתיב התם ויך בכורי מצרים.
Beha'alotcha:91	נקרא שם המקום. ולא שהיה שמו מקודם לכן:
Beha'alotcha:92	הכל צופים וכו׳‬. בספרי צפורה צפו וראו מה נאה:
Beha'alotcha:93	רק מיעוט ואך מיעוט. ואין מיעוט אחר מיעוע אלא לרבות שגם באבות העולם דבר:
Beha'alotcha:94	אף משה רבינו שמע שנאמר וישמע ה׳‬ והאיש משה כצ״ל:
Beha'alotcha:95	הכל ענו בזה. פי׳‬ הכל אמרו שמשה עניו:
Beha'alotcha:96	רוח ה׳‬. וסיפא דקרא לבשר ענוים שלחני:
Beha'alotcha:97	מושכו למה שהוא רוצה. פי׳‬ שאם שלשה עומדים ואחד רוצה לדבר סוד עם חבירו לא יאמר להשני קרב אלי היינו גש הלאה אלא מושך עצמו לצד אותו שרוצה לדבר אתו (זית רענן):
Beha'alotcha:98	שאין אומרים וכו׳‬. חסר בכאן מלת ד״א:
Beha'alotcha:99	במראה ולא בחידות במראה זו מראה דבור יכול מראה שכינה ממש וכו׳‬ כצ״ל:
Beha'alotcha:100	לא דברתם וכו׳‬. כי עבד מלך מלך:
Beha'alotcha:101	נמצאת מפסיד לאחותו וכו׳‬. עיין זבחים (ק״ב.) תוס׳‬ ד״ה אני מסגירה שהקשו במה היה מפסידה הא דאין רואה את הנגעים כש״כ שהיתה טהורה:
Beha'alotcha:102	למדנו שהיה אהרן דורש אין אדם רואה נגעי קרוביו כצ״ל:
Sh'lach:1	פסוק זה נדרש וכו׳‬. עיין מדרש תהלים פ״א בהתחלתו ע״ש בבאורי (באור הרא״ם) הבאתי דברי אלו ע״ש:
Sh'lach:2	באותו שעה קרבו לפני משה כצ״ל ותקרבון אלי כולכם וכו׳‬ והיינו שדרשו רעה לעצמם שלא האמינו לדברי ה׳‬ כמו שמסיים:
Sh'lach:3	כל מה שאתה יכול לבחור. דורש איש אחד איש אחד כי האחד מיותר כל נשיא בהם גדולים שבהם כי הם לא היו נשיאים ועיין ספורנו:
Sh'lach:4	שנא׳‬ בן ארבעים שנה וגו׳‬. הוא גבי כלב:
Sh'lach:5	לפי שהמדבר היה שמו מדבר פארן והמקום היה שמו קדש ברנע כצ״ל:
Sh'lach:6	לא תלכו בדרך המלך אלא בשביל של יחיד כצ״ל ודורש ממלת עלו זה שמראה להם באצבע באיזה דרך ילכו. ואולי כוונתו בנגב כמו כגנב (בהפוך האותיות וחלוף ב׳‬ בכ׳‬) שדרכם לילך בסתר:
Sh'lach:7	הלכו באותיי המשעול. קאי (ויבא לשון יחיד) על המשעול שהולך עד חברון:
Sh'lach:8	ויבוא עולה על כלב כצ״ל ע״כ כתוב ויבוא לשון יחיד:
Sh'lach:9	מאי נבנתה. (סוטה ל״ד):
Sh'lach:10	ואמר ר״ח מ״ד ואתן. (כתובות קי״ב.):
Sh'lach:11	תניא אמר ר׳‬ יוסי. (שם קי״א):
Sh'lach:12	ובמקום אחר אומר ובשלוח ה׳‬ אתכם מקדש ברנע כצ״ל:
Sh'lach:13	אמר ר״י משום רשב״י. (סוטה שם):
Sh'lach:14	דרך ביאת הארץ הם יושבים והיאך נלך כצ״ל:
Sh'lach:15	אלא הכל דגשין. עיין במנחת שי שהאריך בזה. ונראה לי כי המחבר שלנו סובר כפי דעת אנשי מערב שאין חילוק בין לשון רבים נוכח ללשון יחיד נסתר כולם דגשים. ועיין (ערכין י״ד ע״ב) בתוס׳‬ ד״ה אל תקרי כתבו ג״כ שכל ממנו שבתורה דגושתן כדברי המחבר להורות על נו״ן החסר כמו מן:
Sh'lach:16	לרבות כל הנוספים. היינו הגרים:
Sh'lach:17	ולא היינו מתבזים במדבר. כוונתו מה זה שביקשו לו מתנו בארץ מצרים הלא הם יראים לבוא לא״י שמא יהרגו שם מאנשי מצרים. ואיזה טובה היה להם אם ימותו מקודם במדבר. וע״ז אמר ולא היו מתבזים במדבר ולא היה להם טורח הדרך בחנם עכ״פ וכן מה שמסיים ולא היינו נופלים בחרב ג״כ על דרך זה:
Sh'lach:18	כפרו בעיקר. כפירש״י נתנה ראש קאי על הע״ז:
Sh'lach:19	אדם הגון שרואה כו׳‬. (מ״ק כ״ו):
Sh'lach:20	שהיו זורקין אבנים. (סוטה ל״ד:):
Sh'lach:21	אמרו כשעלה משה. (סנהדרין קי״א.):
Sh'lach:22	וכן היה ר״י אומר. (ערכין ע״ו.):
Sh'lach:23	שיהיו גולין לבין או״ה. וזה וימלא כבוד ה׳‬ (היינו ישראל) כל הארץ כי ילכו בגולה:
Sh'lach:24	אשרי העם שה׳‬ אלהיו. היינו שמוחל להם עוונותיהם:
Sh'lach:25	שאפילו הם מזידים. ט״ס וצ״ל מפני שהם מזידים:
Sh'lach:26	שהוא א׳‬ מז׳‬ שקפלו את העולם כצ״ל (ב״ב קכ״א:):
Sh'lach:27	יצא שבט לוי. שאין לו חלק בארץ.
Sh'lach:28	מכאן אמרו. (חגיגה ה׳‬:):
Sh'lach:29	מכאן ליום הדין מן התורה. סובר כמו שדרשו (סנהדרין ק״ט) במדבר הזה יתמו בעוה״ז ושם ימותו בעוה״ב:
Sh'lach:30	מלמד שאף שאר העם וכו׳‬. דורש את כל העדה להוציא דבה על הארץ שכולם הוציאו דבה:
Sh'lach:31	אמר ר״י משום ריב״ו. (ערכין י״ד:):
Sh'lach:32	אמר ר״י כל המספר לשון הרע כצ״ל:
Sh'lach:33	אבל ראוי לחוש. מפרשי התורה אסמכוה אקרא לא תלך רכיל בעמך ולא תעמוד על דם רעיך היינו אם חבריו מלחשים על א׳‬ להרגו מצוה להגיד לו. וזה לא תעמוד על דם רעך:
Sh'lach:34	הבטיחם שמושבותם כו׳‬. דהוקשה לו היאך שייך מושבותיכם דמשמע שישבו כבר ע״כ מתרץ כו׳‬:
Sh'lach:35	ללמדך שלא נתחייבו ישראל בנסכים כו׳‬. וצ״ע מאין היו להם נסכים להקריב אפילו היו מחויבים. ומצאתי בתרגום שיר השירים בפסוק צרור המור וכו׳‬ בכרמי עין גדי שכותב שבמדבר היו הולכין לכרמי עין גדי ולקחו משם אשכולות ענבים ועצרו מנהון חמרא ומנטפין יתיה על מדבחא ע״ש באריכות:
Sh'lach:36	ת״ל או זבח. משמע מביא אלו ומרבה אני חטאות ואשמות ת״ל (סיפא דהאי קרא) לפלא נדר או נדבה לא אמרתי וכו׳‬ אלא קדשים הבאים בנדר ונדבה כצ״ל:
Sh'lach:37	מלמד שמביא. חסר כאן וכצ״ל רבי יונתן אומר אינו צריך הרי הוא אומר זבח ועוף אינו זבח (כי עוף למזבח אין טעון שחיטה רק מליקה) א״כ מה ת״ל מן הבקר או מן הצאן לפי שנאמר אדם כי יקריב קרבן לה׳‬ מן הבקר מן הצאן יכול האומר הרי עלי עולה יביא משניהם ת״ל כאן מן הבקר או מן הצאן רצה מביא אחד רצה מביא שנים:
Sh'lach:38	לכל המתנדב מנחה בלא קרבן שלא יפחות מעשרון ולוג שמן כצ״ל:
Sh'lach:39	מלמד שמביא לזה בפ״ע. חסר כאן גם בספרי משובש קצת וכצ״ל ועשיתם אשה לה׳‬ שמענו אם אמר הרי עלי עולה הרי עלי שלמים יביא נסך א׳‬ לשניהם ת״ל עולה או זבח שמביא לזה בפ״ע ולזה בפ״ע. יכול אם אמר ה׳‬ כבשים לעולה ה׳‬ כבשים לשלמים יביא נסך א׳‬ לכולן ת״ל על העולה או לזבח לכבש האחד שמביא על כבש בפ״ע. וכן הגיה הגר״א זלה״ה:
Sh'lach:40	להביא עולת יולדת וכו׳‬ שלא שמענו בכל התורה כולה. כגירסא זו הוא ג״כ בת״כ. אבל לולא דמסתפינא הייתי אומר כי ט״ס בכאן ובספרי. וצ״ל כגירסת הבבלי (מנחות צ״א:) ר׳‬ נתן אומר לכבש זו עולת יולדת האחד זו אחד עשר של מעשר שקרב שלמים שלא שמענו בכל התורה כולה שלא יהיה טפל חמור מן העיקר וע״ש בפירש״י ותוס׳‬ שפי׳‬ אף שמעשר גופא אינו צריך נסכים אבל האחד עשר הבא מכחו קרב שלמים וטעון נסכים וזהו שהשמענו בדברו שלא מצאנו בכל התורה טפל חמור מן העיקר אלא זה בלבד:
Sh'lach:41	שמן לבילה כו׳‬. קאי על הקרא שני עשרונים סולת בלול ברביעית ההין שמן ויין לנסך רביעית ההין וע״ז קאי שמן לבילה ויין לנסך:
Sh'lach:42	שנתות כו׳‬ פי׳‬ סמנים:
Sh'lach:43	על גבי ספלים. עי׳‬ (סוכה פ״ד) במשנה ב׳‬ ב׳‬ ספלין של כסף:
Sh'lach:44	כמספרם. היינו כמספר שצותה התורה:
Sh'lach:45	מכאן אמרו. (מנחות פ״ט.) מערבין נסכי פרים בנסכי אילים וכו׳‬. הטעם ששניהם בלילתן שוה ע״ש בפירש״י אבל אין מערבין נסכי כבשים בנסכי פרים ואילים כצ״ל:
Sh'lach:46	מכאן אמרו האומר הרי עלי לוג וכו׳‬. נוסחא זו קצת מוטעה. עיין בספרי עם באור ז״א הרבה נוסחאות בזה וכולן מוטעות. והגר״א בהגהותיו מחק הכל. עי׳‬ (מנחות ק״ד.) אין מתנדבין לוג ב׳‬ ה׳‬. אבל מתנדבין ג׳‬ ד׳‬ ו׳‬ ומוא״ו ולמעלה וע״ש בפירש״י שלא מצאנו מנחת נסכים של לוג ב׳‬ וה׳‬. אבל ג׳‬ חזי לכבש וד׳‬ לאיל ח׳‬ חזי לשני אילים וכו׳‬ ועפי״ז יבואר לך המאמר הזה אף שנשתבש קצת:
Sh'lach:47	מלמד שישראל מביא נסכים ואין כנעני מביא נסכים. פי׳‬ ישראל יכול להתנדב נסכים בלא קרבן אבל לא כנעני:
Sh'lach:48	שנא׳‬ ומעוך וכתות. צ׳‬״ לפי שנאמר ומעוך וכתות וסיפא דקרא ומיד בן נכר לא תקריבו וכו׳‬ מכל אלה אבל אתה מקבל מהם שלמים פי׳‬ דוקא שלמים בלא מום אבל לא בעלי מומין (ועיין בספרי הלשון אבל אתה מקבל מהן תמימין כן הגיה הגר״א ז״ל) ולא תמידין הנכתב שם בטעות אשר מבארי הספרי נתחבטו בפירושו בחנם. (וכן נראה ג״כ דעת הפסיקתא כי על הלשון תמימין הנאמר בספרי כתב הוא שלמים) והכוונה אף שהא״י מביא קרבן אבל נסכים בפ״ע לא יכול להתנדב ועיין (תמורה ג׳‬.) בפירש״י:
Sh'lach:49	יכול שהכנעני וכו׳‬. בכאן ט״ס וכצ׳‬״ ל לפי גירסת הגר״א יכול אף עולתו (היינו עולת הא״י) לא יטעון נסכים ת״ל ככה לעכובא מכאן אמרו כנעני ששלח עולתו ולא שלח נסכיה וכו׳‬ ופי׳‬ דמי נסכיה כן פירש״י בתמורה שם וכן (זבחים מ״ה) פירש״י דמי נסכיה ועיין (מנחות ע״ג:) פלוגתא דר״י ור״ע בזה שסובר שא״י יכול להתנדב אף יין בפ״ע לנסכים:
Sh'lach:50	אין לי אלא המתגייר שנתגייר כבר מנין. החכם הספרדי פי׳‬ שנתגייר כבר היינו לפני הדבור אותם גרים שיצאו ממצרים גם הם חייבין בקרבן. אולם הגר״א הגיה אין לי אלא שנתגייר המתגייר מנין פי׳‬ כי גם גר שנתגייר צריך להביא קרבן להתירו לאכול בקדשים עי׳‬ (כריתות ח׳‬ ט׳‬) גר מחוסר כפרה עד שיזרק עליו את הדם. וע״ש כל הדרשות האלו כמו שהם בספרי והכא:
Sh'lach:51	ת״ל או אשר בתוככם לדורותיכם. והיינו כל המתגייר צריך להביא קרבן:
Sh'lach:52	רבי אומר מה ישראל וכו׳‬. (כריתות ט׳‬):
Sh'lach:53	שאין מביא אלא עולת העוף. פי׳‬ שאין צריך להביא שלמים. אבל אם הביא בהמה לשלמים מצוה מן המובחר:
Sh'lach:54	ת״ל הקהל חוקה אחת לכם. ממלת הקהל מרבה נשים כמו דכתיב לא יבוא עמוני ומואבי בקהל ה׳‬ ודרשינן שלא ישא ממזר בת ישראל הרי הקהל הוא ג״כ נשים (ז״א):
Sh'lach:55	בכל מקום שמעשה בישראל. עיין לעיל בפ׳‬ נשא בפיסקא כה תברכו:
Sh'lach:56	להביא הציץ שמרצה על ישראל שנאמר והיה על מצחו לזכרון לפני ה׳‬ כצ״ל ודורש בציץ כתיב לפני ה׳‬ וכן הכא כתיב כגר יהיה לפני ה׳‬ שהציץ מרצה על הגרים והוא כעין ג״ש:
Sh'lach:57	מכאן אמרו. (קדושין מ׳‬.) ושם הגירסא גדולה לימוד שקדמו לחלה וכו׳‬:
Sh'lach:58	ולמעשרות י״ד. כי עד שבע שכבשו ושבע שחלקו לא נתחייבו במעשרות כדמסיים לבסוף:
Sh'lach:59	ולשמטים ס״א. כי אחר י״ד שכבשו וחלקו התחילו למנות שמטים ויובלות. והיה שמטה הראשונה שנת ס״א ויובל לשנת ק״ב מיציאתם ממצרים:
Sh'lach:60	ת״ר ימי יובלות וכו׳‬. (זבחים קי״ח:):
Sh'lach:61	וליובלות ק״ג. טעות וליתא בגמרא שם. ועפ״י טעות מלמעלה נשתרבב הכא:
Sh'lach:62	וכן מצאתי. בסדר עולם פרק ט״ו.
Sh'lach:63	נתיישב על כיבוש הלכה זו. כדבריו פירש״י בזבחים שם. ועיין ביחזקאל מ׳‬ בביאור הגר״א ז״ל ג״כ חשבונו קרוב לדברי המחבר. רק דברי המחבר בסוך אשר חישב למלכות יוני וגם לבריאת עולם וכפי הנראה חושב בשם עד שנות ימי חייו כמה הוא לגלות השני ולמלכות יוני שם ט״ס ולא יכולתי לכוונו:
Sh'lach:64	מכאן אמרו פירות ח״ל שנכנסו לארץ חייבין בחלה כצ״ל ודורש בבואכם אל הארץ בביאתם לארץ חייבים אף בפירות חו״ל:
Sh'lach:65	ונאמר להלן לחם עוני כצ״ל.
Sh'lach:66	שנא׳‬ שבעת ימים תאכל עליו מצות דברים הבאים לידי חימוץ אדם יוצא ידי חובתו בפסח כצ״ל והקרא ולחם וקלי ט״ס.
Sh'lach:67	תרימו תרומה לה׳‬ בתרומה גדולה הכתוב מדבר או אינו אלא בתרומת חלה כשהוא אומר חלה תרימו תרומה הוי חלה אמור כצ״ל.
Sh'lach:68	וחלת הפסח. א׳‬ מכ״ד כסתם מתניתין (חלה פ״ב) חלת בעה״ב א׳‬ מכ״ד:
Sh'lach:69	מכאן אמרו. (חלה פ״ג מ״א):
Sh'lach:70	מה תרומה אחת אף חלה אחת. פי׳‬ בסוריא ג״כ חלה אחת כדברי ר״א (חלה פ״ד מ״ז).
Sh'lach:71	לפי שהוא אומר ראשית עריסותיכם כקרא שלמעלה שומע אני ראשונה שבעיסות. היינו העיסה שיעשה ראשונה יתן כולה חלה ומה שיעשה עיסות אח״כ פטורה ת״ל מראשית עריסותיכם מקצת ראשית. וזה לגלות דקרא שלמעלה ראשית עריסותיכם שיתן מכל ראשית חלה כן ביאר המזרחי:
Sh'lach:72	ר״א חלה תרימו פרט לעיסת תרומה. בביאור הגר״א ז״ל עריסותיכם שמענו אף עיסת תרומה ומע״ש ת״ל חלה תרימו לה׳‬ את שהמורם קודש והשאר חולין ולא שזה וזה קודש:
Sh'lach:73	עד שיהיה בה שיעור נתינה לכהן כצ״ל:
Sh'lach:74	והנחתום א׳‬ ממ״ה. (שעיסתו מרובה) והאשה המוכרת בשוק (אף שעיסתה מעוטה) ג״כ א׳‬ ממ״ח כ״ה במס׳‬ חלה שם וע״ז קאי שהאיש עינו יפה והאשה עינה רעה:
Sh'lach:75	לדורותיכם להביא עיסת שביעית. פי׳‬ לדורותיכם שנוהג בכל שנה ושנה ועיין בספרי דה״א הואיל שפטור ממעשר בשביעית יפטור ג״כ מחלה ובא לדורותיכם לרבות:
Sh'lach:76	ייחד הכתוב מצוה אחת בפני עצמו. כן הגיה הגר״א:
Sh'lach:77	ואיזה זה ע״ז. עיין (הוריות ט) אשר דבר ה׳‬ אל משה כצ״ל ויליף כמו ג״ש אשר דבר וכתיב התם את כל הדברים האלה לאמר:
Sh'lach:78	את כל אשר צוה ה׳‬ אליכם ביד משה וכו׳‬ כצ״ל:
Sh'lach:79	ומנחתו. ונסכו כמשפט כסדר האמור ג׳‬ עשרונים ושעיר עזים לחטאת ולא פר לחטאת לפי שבפרשת ויקרא וכו׳‬ כצ״ל:
Sh'lach:80	והקריבו הקהל פר וכו׳‬. והוא גבי שגגת מצות:
Sh'lach:81	זה כהן משוח בשמן המשחה. בספרי ליתא דרשה זו. ואולי למד המחבר מפר הבא על המצות דכתיב שם והביא הכהן המשיח:
Sh'lach:82	יכול בין שוגגין וכו׳‬. עיין בספרי וכפי שהגיה הגר״א לפי שנאמר מעיני העדה נעשתה לשגגה שמענו שהוראת ב״ד בשגגה ולא בזדון אבל עשיית ציבור זדון כשגגה ת״ל ונסלח להם כי שגגה היא:
Sh'lach:83	שנאמר כי שגגה היא. והיא למעט אפילו מקצת שוגגין:
Sh'lach:84	מה שגגתם לכל המעשים. (זבחים מא) הלשון שהשוו מעשים למעשים. פי׳‬ שהכא בקרבן עובד כוכבים לא נתפרש דיני הזאתם והקטרת האימורין וילפינן הכל מפר הבא על כל המצות:
Sh'lach:85	צריך להביא הגרים. ע״כ כתיב ולגר הגר בתוכם ועיין רמב״ן על התורה:
Sh'lach:86	שמור המצות. היינו פר הבא על המצות בפ׳‬ ויקרא.
Sh'lach:87	לפי. שדנין יחיד מצבור כצ״ל. פי׳‬ כמו הפרשה שלמעלה גבי צבור קאי בע״ז אף כאן ואם נפש אחת תחטא קאי בחטא עובדי כוכבים:
Sh'lach:88	וילמוד תחתון מעליון כצ״ל:
Sh'lach:89	בשגגה. להוציא את המזידה כצ״ל.
Sh'lach:90	חטאין שבידו וכו׳‬. דורש מלות כפולות נפש השוגגת בחטאה בשגגה וזה שאמר חטאין שבידו ומה שנכשל באיסור עובד כוכבים מסתמא היה לו כבר חטאין אחרים וכענין עבירה גוררת עבירה:
Sh'lach:91	להוציא את דקדוקי העובדי כוכבים. חכם הספרדי פי׳‬ כגון שראה בית עובד כוכבים וסבור בית הכנסת הוא והשתחווה לה פטור שהרי לבו לשמים:
Sh'lach:92	להוציא את הספק. דורש לכפר עליו במבורר לו שעבד עבודת כוכבים הוא דמייתי קרבן ולאפוקי אי מספקא ליה אי עבד אי לא כגון השתחווה על גבי אילן בשגגה ומספקא ליה אם היא אשרה או לא לא מייתי קרבן (חכם הספרדי).
Sh'lach:93	סליחה גמורה. דסד״א דעובדי כוכבים חמור יהיה הקרבן תולה ויו״כ מכפר קמ״ל שנתכפר כבר:
Sh'lach:94	שכ״מ שנאמר אזרח וכו׳‬. אבל כאן גבי עבודת כוכבים גם נשים בכלל כי הוקשה אשה לאיש לכל עונשין שבתורה.
Sh'lach:95	ואין הכנענים מביאין וכו׳‬. שאין הכנעני מביא חטאת:
Sh'lach:96	אף כל העשוי בשגגה. פי׳‬ דאין חייבין חטאת רק על דבר שזדונו כרת (שבת סט.) הז המגלה וכו׳‬ (סנהדרין צט):
Sh'lach:97	ולמעלה. הוא אומר וירגמו אותו אבן (היינו בלשון יחיד) כצ״ל גבי מקלל וכאן כתיב באבנים לשון רבים:
Sh'lach:98	צוה מצות תליה. כי כל הנסקלין נתלין:
Sh'lach:99	שומע אני יעשה חוט א׳‬ בפ״ע כצ״ל:
Sh'lach:100	ב״ש אומרים שלשה של צמר ורביעית של תכלת כצ״ל:
Sh'lach:101	בר״א בתחילתו אבל שיריה וגרדומיה כל שהוא כצ״ל פי׳‬ מתחלה צריך ד׳‬ חוטין שלמים אבל אח״כ השיריים והגרדומין כ״ש:
Sh'lach:102	אמר ציצית. (פי׳‬ ציצית הוא כל חוט בפ״ע) ואמר גדילים (וגדילים הוא כל החוטים מקולעים יחדיו דעבות מתרגמינן עובד גדילו) ועל זה אמר שיהיה גדילה מן הכנף וציצית מן הגדילה. היינו מן הכנף יהיה הענף ואח״כ יהיה החוטים בפ״ע כמו שאנו עושים:
Sh'lach:103	על כנפי בגדיהם. שומע אני אף בעלת שלוש בעלת חמש בעלת שש וכו׳‬ במשמע ת״ל על ארבע כנפות כסותך יצאו אלו כצ״ל:
Sh'lach:104	ונותנו על האריג. ונותנו הוא דוקא על גוף הבגד ולא על מקום הפתיל:
Sh'lach:105	ד״א ונתנו על ציצית הכנף למה נאמר לפי שהוא אומר ועשו להם ציצית יכול יארגנה עמה ת״ל ונתנו על הכנף הא כיצד קושרה אח״כ עמה כצ״ל.
Sh'lach:106	שנתכלו המצריים בבכורות תרגום של שיכול תכלא. ומכת בכורות היתה בלילה וכן צבע התכלת דומה לרקיע המשחיר לעת ערב (רש״י בחומש):
Sh'lach:107	ביום ולא בלילה פרט לכסות לילה. יכול שתהא כסות סומא פטורה וכו׳‬ כצ״ל.
Sh'lach:108	ומיעט בה עובד כוכבים. דכתיב ה׳‬ אחד אבל והיה אם שמוע אע״ג דמיעט בה עובדת כוכבים הוא רק כדי לקבל עול מלכות שמים (חכם הספרדי):
Sh'lach:109	שנאמר שמח בחור. וסיפא דקרא והלך בדרכי לבך לכך נאמר אחרי לבבכם:
Sh'lach:110	כשתחלק ל׳‬ וכו׳‬. פי׳‬ הלמ״ד מן לציצית יחולק על ג׳‬ יודין ויהיה ג׳‬ פעמים ציצית הנאמרים בפ׳‬ ציצית מלאים ובזה יובן מה שכתוב לעיל וכ״ה בספרי כי ציצית עולה ת״ר כי חושב ציצית מלא. וכן סרה קושיית הרמב״ן על התורה ע״ש:
Sh'lach:111	שנאמר ראו כי נתן. ובתורה כתיב ויתן לכם את לוחות הברית והוא כעין ג״ש:
Sh'lach:112	אמר ר״נ כו׳‬. מעשה באדם א׳‬ כו׳‬ (מנחות מ״ד) ע״ש כל המעשה בארוכה:
Sh'lach:113	כיון שנתחייב אדם במצוה זו נתחייב בכל המצות כולן מלמד ששקולה וכו׳‬ כצ״ל:
Sh'lach:114	והלילה ט״ס. וצ״ל וכסות לילה פטור מן הציצית:
Sh'lach:115	דכתיב מהחל חרמש בקמה. ודורש בקומה לשון מעומד:
Sh'lach:116	ועכשיו חייב מלקות. בגמ׳‬ ליתא ולא ידעתי פירושו ואולי כוונתו מלקות מרדות:
Sh'lach:117	שב״ש פוטרין. פי׳‬ סדין הוא של פשתים וכתונת אמרא ויהיה כלאי׳‬ ע״ש במנחות מ׳‬:
Sh'lach:118	ומעשה דמלאך וכו׳‬. (מנחו׳‬ מא):
Korach:1	שתפלתו נשמעת. וקאי על משה רבינו מה שביקש על עדת קרח:
Korach:2	והיה דתן ואבירם בני אליאב כצ״ל:
Korach:3	שכבר אמר. ובני פלוא אליאב ולא חשב און:
Korach:4	ויפול על פניו מכאן שחשדוהו מא״א וכה״א ויקנאו למשה וכו׳‬ שכ״א קינא לאשתו מפני משה כצ״ל:
Korach:5	מכאן שמזמנין את בע״ד (מ״ק ט״ז.):
Korach:6	אשר אמרת (שמות ל״ד) נגד כל עמך אעשה נפלאות וכו׳‬ כצ״ל:
Korach:7	משה עמד. היינו שהתפלל על בני אהרן ואהרן עמד וכו׳‬ שהציל את בני ישראל :
Korach:8	אות השמור לדורות. מסיפא דקרא למשמרת לאות כו׳‬:
Korach:9	ומה לוים וכו׳‬ אולי כוונתו ויאמרו בני ישראל כי גם בני לוי בכלל התרעמו גם הם. וזהו הקרב הקרב ב׳‬ פעמים:
Korach:10	כראוי. הגר״א בספרי מחקו:
Korach:11	ואינו ידוע לשם מי. אע״ג דכל הזבחים שנזבחו שלא לשמן כשרים חוץ מחטאת ואשם. אעפ״כ הכהנים נושאין עון.
Korach:12	אם זכה בבשר וכו׳‬. (פסחים נט:) בשר קדשים כהנים אוכלין ובעלים מתכפרין וזה דווקא אחר זריקת דמים. וזה שמסיים שהכהנים נושאים עון היינו העון חל על הכהנים אחרי שאכלו ולא כפר הבעלים.
Korach:13	ת״ל תשאו את עון המקדש. ט״ס וצ״ל סיפא דקרא תשאו את עון כהונתכם וכ״ה בספרי כי זה הוא עון הכהנים ולמעלה בדברי ר׳‬ יאשיה הוא עון המקדש שהעון הוא בזריקת הדם ע״כ מסיים רישא דקרא תשאו עון המקדש:
Korach:14	ולא ללוים ולא לישראל. היינו שלא יגעו בעבודתם אזהרה זו על הכהנים.
Korach:15	שומע אני וכו׳‬. עירבובי דברים בכאן וכצ״ל וגם את אחיך שומע אני שישראל במשמע שכולם נקראים אתים ת״ל מטה לוי שומע אני אף הנשים במשמע ת״ל את אחיך להוציא הנשים.
Korach:16	הקרב אתך. להזהיר הלוים בשיר על דוכנם כצ״ל:
Korach:17	מנה מהם גזברין ואמרכלין כצ״ל:
Korach:18	ולא משמרת הארון כצ״ל והוא מסיפא דקרא אך אל כלי הקודש וכו׳‬ לא יקריבו:
Korach:19	אזהרה לב״ד של ישראל. כי לב״ד של כהנים כבר למד ואתה ובניך וכו׳‬ תשמרו את כהונתכם:
Korach:20	וכה״א ולא יהיה עוד מבול שכבר היה וכן לא יזבחו עוד את זבחיהם לשעירים שכבר זבחו במצרים דכתיב איש שיקוצי עיניו השליכו כצ״ל:
Korach:21	מתנות כהונה בפייס. בספרי ה״ג מה מתנה בפייס וכו׳‬. ועיין בז״ר שפירש מתנה מתנות כהונה כמו הפסיקתא והכוונה מתנות כהונה צריכין לחלק בפייס דכ״א ירצה ליטול חלק יפה. וחכם הספרדי פי׳‬ בספרו מתנה בפייס היינו מתן דמים דא״א שהיו זורקין זה וזה וצריך פייס אף שאר עבודות בפייס:
Korach:22	לענין אכילת קדשים בגבולין היינו תרומה צריך נטילת ידים מקדש ידיו ואוכל כצ״ל:
Korach:23	רבי אומר מה עבודת מקדש במקדש מקדש ידיו ורגליו ואח״כ עובד אף אכילת קדשים בגבולין מקדש ידיו ואח״כ אוכל. וזה שמסיים ומקום שצריך אלא ידיו היינו בגבולין:
Korach:24	מכאן למדנו נט״י מן התורה. עיין (שבת ט״ו) שלמה גזר נט״י לקדשים היינו ג״כ מחמת שהיו לו סמך מן התורה ע״כ גזר. ולפי הכלל שכתב הרא״ש בב״ק פ׳‬ מרובה וז״ל וטובא איכא מילי דרבנן אסמכוה אקראי כגון מעשר פירות דרבנן אסמכוה אקראי וכן דמוע וכו׳‬:
Korach:25	ת״ל זכרון לבני ישראל וכו׳‬. פי׳‬ דכתיב התם להקטיר קטורת. וה״נ כתיב זה יהיה לך מקודש הקדשים מן האש דהיינו הקטרת חלבים והתם כתיב ביד משה (חכם הספרדי):
Korach:26	רבי נתן אומר ואני מוסיף. הנה בשמחה כצ״ל:
Korach:27	בארכיים. היינו בערכאות:
Korach:28	זה עור עולת בהמה. שהעולה כולה כליל ורק העור לכהנים ועיין בספרי משא״כ עולת העוף כולה כליל ואין לכהן כלום. ודורש זה מקודש הקדשים מן האש:
Korach:29	קודש קדשים לרבות לוג שמן של מצורע. יותר נכון ה״ג כפי שהוא (מנחות ע״ג) כל קרבנם לרבות לוג שמן של מצורע.
Korach:30	כרת הכתוב ברית עם אהרן על קדשי קדשים שלא יהיו נאכלין אלא בעזרה ולזכרי כהונה כצ״ל.
Korach:31	להביא דבר שטעון הרמה (כגון חזה ושוק) שיהיו טעון תנופה כצ״ל:
Korach:32	לה׳‬ זו חלה כצ״ל.
Korach:33	אשר יביאו לה׳‬ לך יהיה. נטלם השם ונתון לכהן כצ״ל:
Korach:34	שנא׳‬ אך ואך למעט. ועיין בספרי בהגהת הגר״א משנה נוסחא זו:
Korach:35	אף דבהמה. כך היינו הנפל פוטר הבא אחריו מן הבכורה דכתיב כל פטר שגר בהמה לה׳‬ כל שהבהמה שוגרת הוא לה׳‬. והבא אחריו פטור. ודורש זה מן ואו ובבהמה:
Korach:36	אף בבהמה כן. היינו בדקה ל׳‬ יום (בכורות כ״ו):
Korach:37	דרש ר״ט אך פדה תפדה כו׳‬. ואת בכור הבהמה הטמאה תפדה פודה אתה את הטמאה ואין אתה פודה את הטהורה לא חיה ולא מתה (והיינו בכור חמור תפדה בשה אבל בכור בהמה טהורה אינה נפדית רק היא עצמה קריבה). כ״ה בספרי לפי גירסת הגר״א:
Korach:38	פדה תפדה שומע אני אף שאר בהמה טמאה במשמע כצ״ל:
Korach:39	אם אינו ענין שפודין אותו. היינו שאר בהמה טמאה:
Korach:40	תפדה מיד. קדשי ב״ה נפדין מיד ולא נצרך להמתין ל׳‬ יום כמו פדיון הבכור:
Korach:41	עשרים גרה להביא שוה כסף. פי׳‬ כי מקודם כתיב חמשת שקלים ועשרים גרה יתר הוא. ובביאור הגר״א שינה הנוסחא:
Korach:42	להביא וכו׳‬. ט״ס וצ״ל להוציא את הנדמה:
Korach:43	בחלב תותב. היינו חלב שעל הקיבה. (חולין מ״ט) ע״ש:
Korach:44	ומנין להביא פסח ומעשר וכו׳‬. עיין (פסחים סד:) את דמם תזרוק כו׳‬ ואת חלבם כו׳‬ דמו לא נאמר כו׳‬.
Korach:45	את הבכור בע״מ שנותנו מתנה לכהן. שלא מצאנו בכל התורה כולה כן הוא בזבחים שם ופי׳‬ כי שאר קדשים כשנעשו בע״מ פודהו ונותן אחר תחתיו וזה ניתן לכהן ונאכל במומו:
Korach:46	פרשה זו כוללת בתחלה וכוללת לבסוף ופורטת באמצע כצ״ל פי׳‬ מתחילה וזה לך תרומת מתנם כלל כל חלב יצהר כל בכור כו׳‬ פרט ולבסוף כל תרומת הקדשים כלל:
Korach:47	גדולה ברית שנכרתה לאהרן מברית שנכרתה לדוד. אהרן זיכה לבנים בין צדיקים בין רשעים ודוד זיכה לצדיקים דווקא וכה״א אם ישמרו בניך בריתי וכו׳‬ ובכאן משובש:
Korach:48	יכול ברצונו. מדכתיב חלף עבודתם שומע אני רצה יעבוד רצה לא יעבוד ת״ל ועבד הלוי בעל כרחו.
Korach:49	שנת השמיטת ושנת היובל. שאין בהם מעשרות יכול לא יעבוד:
Korach:50	ת״ל הוא כהנים בעבודתם ולוים בעבודתם כצ״ל:
Korach:51	הם ישאו עונם. הלוים נושאים עונם של ישראל אם יגעו בקודש ולא ישמרו כראוי ולא הכהנים:
Korach:52	להזהיר ב״ד על כך. שלא יטלו הלוים חלק בארץ:
Korach:53	מגיד הכתוב שבמעשר פירות הכתוב מדבר כצ״ל:
Korach:54	לפי שנתן להם א׳‬ מעשרה בפירות כצ״ל. וסובר מעשר פירות דאורייתא. שלא יתרום ממין על שאינו מינו ולא מן החדש על הישן כצ״ל.
Korach:55	שלא יתרום שבולים. היינו מין שאינו גמור על הגמור:
Korach:56	מכאן אמרו. (מעשרות פ״א) התבואה משתמרח והיין משיקפה והשמן משירד לעוקה כצ״ל:
Korach:57	להביא את עצמם. שהכהנים שיש להם תבואה צריך להפריש והתרומה שלו:
Korach:58	כאשר תקחו כן תתנו. אולי כוונתו כי סובר שתרומת מעשר צריך למדוד דווקא כר׳‬ ישמעאל לעיל וזה שאומר כאשר תקחו המעשר הוא במדוד דווקא כן תתנו תרומת מעשר:
Korach:59	בתרומה גדולה הכתוב מדבר. עפירש״י בחומש שאם הקדים לוי את הכהן בכרי וקיבל המעשר קודם שקיבל הכהן תרומה גדולה צריך להפריש הלוי מן המעשר א׳‬ מחמשים תרומה גדולה ויפריש אח״כ תרומת מעשר:
Korach:60	אזהרה לב״ד. הגר״א בספרי מוחק זה וגורס את חלבו ממנו אזהרה ללוים שלא יהיו תורמין אלא מן המובחר:
Korach:61	מלמד שאין בו קדושה עולמית. היינו אחר שתרם תרומת מעשר מותר לזרים:
Korach:62	אפילו בבית הקברות. היינו המעשר שאין בו קדושה:
Korach:63	להביא בת ישראל הנשואה ללוי שנותנת רשות לתרום כצ״ל:
Korach:64	חוץ מדבר א׳‬. היינו שאינו מודה בעבודה:
Korach:65	להביא תרומה טמאה. חכם הספרדי פי׳‬ שגם תרומה טמאה יפריש מן המובחר. והגר״א מחק הכל וגורס אין לי אלא תרומת מעשר שיפרוש מן המובחר תרומה גדולה מנין ת״ל ולא תשא עליו חטא בהרימכם את חלבו:
Korach:66	הרי זו אזהרה לכהנים וללוים וכו׳‬. החכם הספרדי ביאר אזהרה שלא יחללו הקדשים שיקחו מישראל ואם חללו עוברים הלאו. ועיין בספרי פלוגתא דר״י ור״ע ע״ש:
Chukat:1	תניא חביבה תורה. ברייתא הוא בספרי:
Chukat:2	זה א׳‬ משלשה מקומות שהיה הדיבור כצ״ל:
Chukat:3	מה ששרתו ידי שכחתי. אין הכוונה כי ריב״ז עשה פרה אדומה הרי לא מצאנו שהיה כהן רק בזמנו נעשית פרה אדומה. עיין (פרה פ״ג) וזקני ישראל היו מקדמין ברגליהן להר המשחה כי סמכו ידיהן עליו. וריב״ז היה מהזקנים שסמכו ידיהן על הכהן העושה הפרה. ועיין בתוספתא פ״א גבי צדוקי א׳‬ שהעריב שמשו ורצה לעשות הפרה וידע בו ריב״ז ובא וסמך ידיו עליו וצרם לו באזנו וכו׳‬ ע״ש מעשה בארוכה. ואולי ע״ז קאי מה ששרתו ידי שכחתי:
Chukat:4	כדי לחדד. בתוספתא וכן בספרי ה״ג לחזק את התלמידים ופי׳‬ לזרזם לחזור תלמודם שלא ישכחו:
Chukat:5	ונאמר להלן חוקת. גבי יוה״כ ושם עבודת פנים בבגדי לבן.
Chukat:6	אשר. לא עלה עליה עול תבוא פרה אשר לא עלה עליה עול ותכפר על אומה שפרקו עול כצ״ל:
Chukat:7	מכאן אמרו ט׳‬ פרות. (פרה פ״ג) ואמרינן במס׳‬ (יומא ח):
Chukat:8	שמא שלישי ט״ס וכצ״ל שני שמא שלישי:
Chukat:9	בני ישראל יקחו וכו׳‬. הכוונה שנקחת דווקא מישראל ולא מכנעני:
Chukat:10	פעם אחת וכו׳‬ כל המעשה בפסיקתא רבתי דר״כ פרשה פרה ע״ש:
Chukat:11	מתרומת הלשכה. אף דפרה אינה נשחטת בעזרה אעפ״כ באה מתרומת הלשכה דחטאת קריה רחמנא.
Chukat:12	ואין מום פוסל בעגלה ערופה. דה״א ללמוד ק״ו מפרה עיין ספרי.
Chukat:13	ונתתם אותה וכו׳‬. היינו דתנן וכו׳‬. אין מוציאין עמה וכו׳‬. דרשה זו נכתבה בטעות רק מקרא דלהבא והוציא אותה שלא יוציא אחרת עמה כמו שמסיים המחבר לקמן:
Chukat:14	ואין שאר פרות ע״י אלעזר. עיין ספרי וכן יומא פלוגתא אי דווקא בכ״ג או אף בהדיוטים.
Chukat:15	הכהן שיהיו בכהונו. דרשה זו לא שייך על קרא דהכא. וקאי על קרא דלקמן ולקח אלעזר הכהן בכהונו. בבגד. שרד היינו בגדי כהונה וכ״ה לקמן בדברי המחבר. ועיין יומא מ״ג. וכבס בגדיו הכהן וע״יש בפרש״י דורש בגדיו הכהן שיהיה בבגדי כהונה. ועכ״פ הכא ט״ס ע״כ הסגרתי במוסגר:
Chukat:16	שיהיו אחר שוחט ואלעזר רואה כצ״ל:
Chukat:17	הרגילה שבאצבעות. היינו אצבע יד הימינית.
Chukat:18	לא היתה פרה וכו׳‬. והיא פסולה.
Chukat:19	מגיד שחוזר לדם. פי׳‬ שבכל הזאה צריך טבילה בדם:
Chukat:20	ושרף את הפרה לעיניו שאם התעסק וכו׳‬ כצ״ל ומלת לעיניו דריש.
Chukat:21	לרבות את הפקיעים. היינו האברים שפקעו מעל האש יחזירם.
Chukat:22	את כל אלה יחזיר. פי׳‬ זה דווקא בבשר ועור יחזיר ואם לא החזיר פסול אבל בעצם אם לא החזיר כשר:
Chukat:23	ישרוף ריבוי אחר רבוי בכאן חסר וכצ״ל. ישרוף ומקודם כתיב ושרף את הפרה אין ריבוי אחר ריבוי אלא למעט דברי רבי ישמעאל. ופי׳‬ תיכף כשיתבקע הפרה משליך בתוכה האזוב. ור״ע סובר משיצית האור ברובה אז ישליך האזוב ור״ע סובר שלא ימעיט העצים כצ״ל וכ״ה בספרי. אולם חכם הספרדי קיים הגי׳‬ כמו הכא. ואכמ״ל.
Chukat:24	מרבה היה לה חבילי אזוב וכו׳‬. לאו לענין השלכת עץ ארז ואזוב ושני תולעת לתוך שריפתה מתניא אלא לענין ריבוי עצים שמרבה לה בכדי להרבות האפר (חכם הספרדי) ולזה אמר הכא איזוב יוני כשר ג״כ אחרי שנותנו לשם עצים:
Chukat:25	ששינתו תולעת. מלת ושני תולעת דריש שנשתנה מראה צבע שלו תולעת (קארמיזין):
Chukat:26	והשליך אל תוך שריפת הפרה הא כיצד משיצית האור ברובה דברי ר׳‬ יהושע כצ״ל:
Chukat:27	תנן התם. פרה פי״א:
Chukat:28	למדנו על המשליך האזוב וכו׳‬. אף שאינו נוגע בפרה אעפ״כ מטמא בגדים:
Chukat:29	ולהלן הוא אומר ולקח אזוב וכו׳‬. מה כאן צריך הערב שמש פי׳‬ הנושא כי המזה טהור:
Chukat:30	ולא בגדים המנוגעים. פי׳‬ שאף שהבגדים טעונים שרפה. אעפ״כ לא נטמא השורף אם לא נגע בהם:
Chukat:31	שמקום שטובל וכו׳‬. ואיזה זו מקוה מ׳‬ סאה. דברי המחבר צ״ע הלא טבילת כלים ובגדים אינם צריכים מ׳‬ סאה דברביעית סגי להטביל מחטין וצינורות. ועיין בספרי הלשון מה אדם בראוי להם אף כלים בראוי להם. ופי׳‬ חכם הספרדי מה אדם טובל בראוי לו היינו מ׳‬ סאה שכל גופו עולה בהם אף כלים בראוי להם שכל גופן עולה בהן ולא בעי מ׳‬ סאה. והנה הז״א רצה לפרש דברי הספרי שקאי לטבילת כלים חדשים שצריך מ׳‬ סאה. (ואף שהקשה ע״ז הלא טבילת כלים מדרבנן והאיך מרבה קרא. כבר כתבתי לעיל בשם הרא״ש שכמה דברים נמצא בספרי שהם גזירות דרבנן ואסמכוה אקרא ע״ש) עכ״פ לשון הפסיקתא שטובל שם הבגדים בלתי אפשר לפרשו כפירוש הז״א הלא רק כלים העשויים להשתמש לאכילה צריכין מ׳‬ סאה ולא בגדים:
Chukat:32	מגיד שמשמרת וכו׳‬. אולי כוונתו כי פרה שעשה משה נחלקה לג׳‬ חלקים וא׳‬ נתן בחיל למשמרת לדורות (פרה פ״ג בסופו) וע״ז קאי ימים על ימים ושנים על שנים:
Chukat:33	למי נדה שהם טמאין הרי הם מי נדה. עיין בספרי גרסא אחרת בזה ודברי המחבר נעלמה ממני ואולי הכוונה דווקא כשהם טמאין היינו שלא נעשה מלאכה במים קודם שקידשו ואז הנוגע בהם טמא הרי הם מי נדה היינו שהכשירו להזאה אבל אם נפסלו במלאכה קודם הקידוש אזי המים הם פסולין ואין מטמאין הנוגע בהם ואינם מוכשרים להיות מי נדה להזות מהם על הטמא ודוחק:
Chukat:34	האוסף. שהוא נוגע לא כ״ש:
Chukat:35	להביא את דמו. רביעית דם מטמא:
Chukat:36	יכול יטהר בשביעי בלא הזיה שכבר הוזה בשלישי ויהיו פי׳‬ הקרא הוא יתחטא ביום הג׳‬ היינו ביום ג׳‬ צריך הזיה וביום השביעי יטהר בלא הזיה ת״ל סיפא דקרא ואם לא יתחטא ביום הג׳‬ וביום הז׳‬ שינה עליו הכתוב שאם נתעכב וכו׳‬ כצ״ל:
Chukat:37	ולא יתחטא בו בדמים. פי׳‬ כגון זב וזבה ויולדת ומצורע שלא הביאו כפרתן ולא נזרק הדם עליהם:
Chukat:38	שכרת הוא מיתה. פי׳‬ שמיתה האמור שם הוא כרת דהכא אבל במיתה בידי שמים לכרת יש חילוק:
Chukat:39	לעשות קרקעו של בית. שאם טומאה בבית כל מה שבקרקע הבית עד התהום טמא:
Chukat:40	אינו מטמא מכל צדדים כשהוא פתוח. פי׳‬ אם פתת פתוח יצאת הטומאה בפתח זה. אזי רק אותו הפתח טמא ושאר טהורין:
Chukat:41	ועל כל הכלים. יצאו קש ועצים שאינם כלים ואינם מקבלים טומאה:
Chukat:42	כלי שנטמא ואין לו טהרה עולמית. פי׳‬ מדכתיב טמא הוא ולא כתיב יטמא הוא בדבר שאין לו טהרה וע״ז שייך לשון יטמא:
Chukat:43	וכל כלי פתוח וכו׳‬. שומע אני כולו וכו׳‬ פי׳‬ אם נפחת רובו דרובו ככולו ובטל מתורת כלי לגמרי ת״ל פתוח (חכם הספרדי):
Chukat:44	אשר אין צמיד פתיל עליו. פתיל זה העודף צמיד זה הדופק וראי׳‬ לדבר ויצמד ישראל וכו׳‬ כצ״ל וכ״ה בספרי. ופי׳‬ פתיל זה העודף פי׳‬ זה הטיט שממרח בין הכסוי לכלי חרס ודופק הוא הכסוי בעצמו (חכם הספרדי):
Chukat:45	להוציא את העובד. (חולין ע״ב:) פני השדה משמע דבר הגלוי:
Chukat:46	או במת להביא כזית מן המת או בעצם אדם להביא עצם כשעורה כצ״ל:
Chukat:47	זה קבר סתום שמטמא בכל צדדיו הנוגע בו. אבל לא כן בקבר פתוח אינו מטמא הנוגע בצדדין כי טומאה בוקעת ועולה:
Chukat:48	שאם נשתנה פניה. פי׳‬ אם נשתנה מראה של האפר לפי רוב השנים ודומה לעפר כשר ומשום הכי קריא ליה עפר (חכם הספרדי):
Chukat:49	שיהיו חיותן בכלי כצ״ל וכ״ה (סוטה ט״ז פסחים ל״ד) שלא יתן מן המעין בכלי אחר ויתן לתוך כלי זה:
Chukat:50	כל הכלים ככלי הדם. דלא ללמוד מסוטה ששם הקפידה התורה על כלי חרס דווקא:
Chukat:51	שיהיה במים כדי טבילה. (פרה פי״ב) ובלבד שלא יספוג היינו שלא יקנח שיהיה במים כדי הזאה:
Chukat:52	זה טבול יום שיהי׳‬ טמא לתרומה וטהור לחטאת כצ״ל והשאר ט״ס ועיין לעיל פיסקא ואסף איש טהור ולמדין המזה מן האוסף את הפרה מה שם טבול יום כשר אף המזה כשר בטבול יום:
Chukat:53	טהור על הטמא טמא דר״ע. (יומא י״ד):
Chukat:54	מכאן וכו׳‬. פי׳‬ כמו שהכא אם לא הוזה בז׳‬ יזה בימים שאח״כ. כמו כן גבי נדה אם לא טבלה בז׳‬ תטבול בשאר הימים:
Chukat:55	על טומאת מקדש. כדכתיב בקרא כי את מקדש ה׳‬ טמא:
Chukat:56	מים שיש בדם שיעור הזאה. מטמא אדם לטמא בגדים. ומים שאין בהן שיעור הזאה מטמא אדם לטמא אוכלין ומשקין וכ״ה בספרי. ופי׳‬ מזה הוא הנושא שאין המזה טמא:
Chukat:57	כאן בחבורים. פי׳‬ אדם שנוגע במת עצמו טמא טומאת שבעה. ואדם שנוגע באדם שנטמא למת הוא ראשון לטומאה וטמא רק טומאת ערב:<br>נז. ולא בהיסט. היינו הטמא מת אינו מטמא את חבירו אם הסיטו (היינו הניעו ולא נגע בו) אבל המת עצמו מטמא ג״כ בהיסט:
Chukat:58	מה ראה לסמוך. (מ״ק כ״ח).
Chukat:59	והלא פרשה פרה וכו׳‬. הוא לשון המחבר ולא לשון הגמרא:
Chukat:60	והלכה כר״ג. (מ״ק פ״יג במשנה שם):
Chukat:61	אבל אינו עולה וכו׳‬ כל המאמר משובש וכצ״ל אבל אם מת בר״ה (וה״ה בשאר יו״ט) עולה במנין שבעה ואינו מפסיק האבילות אחר שלא נהג אבילות שעה אחת קודם יו״ט:
Chukat:62	והלכה כרשב״א (מ״ק כ״א ע״ב) ושם ר׳‬ שמעון סתמא. והיינו כשגדול הבית בבית אז הבא מונה עמהם:
Chukat:63	בא ממקום קרוב. שבא ביום השביעי. קודם שעמדו המנחמין. וזה שתפס המחבר בלשונו שבא ממקום קרוב היינו קודם שעמדו המנחמין.
Chukat:64	פנים כנגד פנים. כוונתו כי הם הריבו ג״כ עם אהרן רק למשה הריבו פנים כנגד פנים ולא עם אהרן שהי׳‬ רודף שלום לא העיזו לו לדבר בפניו. ועיין בילקוט כעין זה.
Chukat:65	חזרו ושתפו את אהרן. שאמרו ולמה הבאתם וכו׳‬ לשון רבים:
Chukat:66	נתנו מקום לשעה. היינו שלא השיבו כלום לישראל רק הלכו לאוה״מ לבקש רחמים:
Chukat:67	ואהרן עומד. ורואה לכך נענש ג״כ אהרן:
Chukat:68	ונחלים ישטופו. עיין ברבה וכן (מדרש תהלים מזמור ע״ח) ששטפו הרבה לצני הדור שלא היו מאמינים בו:
Chukat:69	לא כ״ש. שנשלח שלוחים אליו:
Chukat:70	ואתן לעשו את הר שעיר. ע״כ אמר בארצך:
Chukat:71	זה הוא שאמר הכתוב אתם עוברים. וסיפא דקרא ויראו מכם. והיינו כי בני עשו יראו שלא יעשו להם ישראל רעה משנאת עשו ליעקב:
Chukat:72	על מעשה שנהיה וכו׳‬. אולי כוונתו כמו שפרש״י מפני שנתחברו לעשו הרשע חסרו הצדיק הזה.
Chukat:73	קחנו בדברים. הוקשה לשון קח שלא שייך על בעלי חיים:
Chukat:74	אמר הלך התייר שלהם. פי׳‬ שנסתלקו ענני הכבוד ע״כ בא להלחם:
Chukat:75	כל המתרעם. (סנהדרין ק״י):
Chukat:76	שני. מצורעים וכו׳‬ והמצורעים שמותם את והב.<br>עו. דכתיב כי רק עוג וכו׳‬. ערשו ערש ברזל הלא היא ברבת בני עמון הרי שעיר רבות שהיתה לעמון לקתה סיחון מאתו במלחמה:
Chukat:77	יו״ד וא״ו משתמשים כמו. שפו ואנם (בראשית לו) כתיב שפי ואונם שפו בוא״ו ובד״ה א׳‬ א׳‬ כתיב שפי ואונם שפי ביו״ד הרי יו״ד וא״ו מתחלפים:
Chukat:78	מרוב שידול. פי׳‬ מרוב השתדלות שחמדו לעבור את נחלי ארנון:
Chukat:79	מי יתן סופה וסערה. היינו סופה וסערה לעבור את נחלי ארנון:
Chukat:80	ודומה לו כרם חמר וכו׳‬. המחבר ביאר כאן פשוטו של מקרא בטוב טעם ועיין להראב״ע כי עלי באר היא תחילת השירה ולא נכתבה כולה ענו לה לשון ציווי וכו׳‬ עכ״ל ולכן בא לבאר כי המלות ענו לה היא פקודה להמזמרים (מקהלה) שיענו אחרי כל כרוז וכרוז מהשירה את המלות עלי באר (והשירה לא נכתבה כאן) וכן ביאר הכתוב בישעי׳‬ כרם חמר ענו לה ר״ל הוא מצוה להמקהלה שיענו אחרי כל ענין וענין המלות כרם חמר רק בישעיה היא פקודה לעתיד שבימי הגאולה יענו המשוררים כרם חמר. וכאן הוא דבר בעתו ומביא ראיה משירת משה כי גם הכרוז אשירה לה׳‬ כי גאה גאה ענו ג״כ המקהלה כפעם בפעם. וכן מרים ענתה זאת בלוית נשים אשירה לה׳‬ וכו׳‬. ועיין במכילתא פרשת השירה משה היה פותח דבריו תחילה וישראל עונין אחריו ועיין (סוטה ל.) כיצד אמרו ישראל שירה כגדול המקרא את הלל ע״ש. הארכתי בזה להראותך כי גם חכמי ישראל הקדמונים ידעו לפרש פשוטו של מקרא והמחבר הזה אשר שיבה זרקה בו יותר משש מאות שנה הוא היה האחד מהם.
Chukat:81	ע״ז שהיא במדבר. אולי הוא האליל אפאלאן במקום דעלס (אי בחלק ים האמצעי) אשר אנשי אתינא בימי סאקראטס היווני עבדו שם והוא כעת ת״י ישמעאל חרב מאין יושב. וכל חוצבי אבן מאיים הסמוכים באים שמה לקחת שארית הבנינים אבני שיש וכדומה ככתוב בתולדות סאקראטוס בספר פעדאן:
Chukat:82	כמו הן עד ירח. ופירושו לשוןהסרה
Chukat:83	ונך אותו ואת בנו כצ״ל:
Chukat:84	לא חיסר הכתוב. פי׳‬ שזה מסע האחרונ׳‬ מהמסעות:
Balak:1	בן שהיה מצפיר להלחם וכו׳‬. לא ידעתי לפרש לשון מצפיר עיין בבע״ט פירש בן ציפור שעף עליהם כצפור לקללם. ובזוהר פרשה זו. פירש בן צפור שעשה מכשפות ע״י צפור ע״ש:
Balak:2	תני מדין ומואב וכו׳‬. (סנהדרין ק״ה.):
Balak:3	מפני מה נתנה נבואה לאו״ה הקדמונים. עיין רבה ותנחומא.
Balak:4	ודומה לו נעשה אדם. כמו אעשה אדם וכן הכא נכה כמו אכה.
Balak:5	ד״א. נכה לשון גדולה וכו׳‬. ע״כ אמר נכה לשון רבים כי דרך גדול ומושל שמדבר דבריו בלשון רבים כי הוא האחד שבו תלוי דעת הרבים:
Balak:6	לפי שהוא היה ממשפחת קמואל אבי ארם. והם ברכו את רבקה אחותינו את היי לאלפי רבבה ונתקיים ברכתם.
Balak:7	כענין שנאמר קסם על שפתי מלך. המחבר מפרש קסם לשון בחינה וסימן. וזה כוונתו וקסמים בידם שלקח לסימן אם יבוא תכף יצליח ואם ימאן אין הצלתח. וע״ז וי״א וקסמים ממש פליג אלמעלה.
Balak:8	זה אחד מג׳‬ בני אדם. עיין מדרש רבה במקומו ועיין (בזוהר ר׳‬) גירסא אחרת וחשיב ג״כ יחזקאל לשבח דאמר ליה התחיינה העצמות האלה. ואמר ה׳‬ אלהים אתה ידעת:
Balak:9	ולבסוף נביא שקר היה. מפסוק הזה אין שום ראי׳‬ שהיה נביא שקר ואולי קאי על הקרא הקדום מאן ה׳‬ לתתי להלוך עמכם דווקא וזה היה שקר שהקב״ה אמר לו לא תאור את העם כלל רק המחבר ציין ע״ז הפסוק כי בכאן הוצרך בלעם להודות לא אוכל לעבור את פי ה׳‬:
Balak:10	מכאן אמרו. (סנהדרין ק״ה):
Balak:11	ואמיתתו מש עול. פי׳‬ אמיתת המילה משעול מש עול:
Balak:12	כלומר ההשכל השלכתי. פי׳‬ הנו״ן האחרונה ממלת ההסכן כמו ל׳‬. ומביא ראי׳‬ ע״ז נשכה לשכה שגם שם נחחלף נ׳‬ על ל׳‬:
Balak:13	כדי שיארע הדבר וכו׳‬. היינו שיתבייש לפני השרים:
Balak:14	כלומר כל העם מקצה. שראה כולם וכן פי׳‬ הראב״ע:
Balak:15	כמו שפיפון וכו׳‬. (סוטה נ׳‬ סנהדרין ק״ה) פרש״י כמו דשף מדוכתיה:
Balak:16	הביא עליו טומאה. דורש ויקר לשון קרי:
Balak:17	כענין בן אדם נהה על המון ממצרים. והורידהו אותה וכו׳‬ כן הכא הורידו בלק לבלעם מגדולתו:
Balak:18	ארבעה רגלי ישראל. דורש רובע רביעית שנחלקו לארבעה חלקים:
Balak:19	לפיכך כתיב. והנו בוא״ו למעט שלא היה שמחה לבלעם בשעה שבירך את ישראל:
Balak:20	ודיבר ולא יקימנו. דכתיב וידבר ה׳‬ אל משה וכו׳‬ וארא אל אברהם וכו׳‬ כצ״ל ודורש ודיבר כמו התם וידבר:
Balak:21	רבותינו ז״ל אמרו. (גיטין סח.):
Balak:22	אלו המזיקין. ראם אלו המזיקין כצ״ל. וע״ז קאי שרואין ואינם נראין וכ״ה בגיטין:
Balak:23	לכך נאמר וישת אל המדבר פניו. כתרגומי לקבל עגלא דעבדו ישראל במדברא:
Balak:24	ואנכי לא אשכחך. היינו מה שקבלו אנכי ה׳‬ אלהיך:
Balak:25	ואומר אינו עיקר. ט״ס וצ״ל ואו אינו עיקר כמו ויכו האחד את האחד גבי אשה התקועית ע״ש ברד״ק הכינוי טרם ההודעה (דה״ל למכתב ויך א׳‬ את א׳‬) והואו נוסף וכן הכא הכינוי טרם ההודעה:
Balak:26	א״ר אלעזר וכו׳‬. כל המאמר (סנהדרין ק״ה:) ע״ש:
Balak:27	ביקש לאמר לא יהיה להם זתים וכרמים כצ״ל ת״ל כגנות עלי נהר וכ״ה בסנהדרין שם:
Balak:28	לא יהיה ריחן נודף. היינו מעשיית המצות (רש״י שם):
Balak:29	ארשב״ג אר״י וכו׳‬. (סנהדרין שם):
Balak:30	מכאן אמרו. (נדרים פ״א) והזהרו בבני עניים שמהם תצא תורה כצ״ל.
Balak:31	אל מוציאו ממצרים כצ״ל. כי הכא כתיב מוציאו לשון יחיד ולעיל פרשה כ״ג פסוק כ״ב כתיב אל מוציאם וכו׳‬ בלשון רבים וע״ז קאי דברי המחבר יחדם גוי א׳‬ ע״כ כתיב מוציאו לשון יחיד:
Balak:32	ארור השלים בארורה. היינו בלעם שהוא ארור אבל יצחק וכו׳‬ כצ״ל ומלת יעקב ט״ס.
Balak:33	אשר יעשה העם הזה לעמך. לעם זה מבעיא ליה למימר אמר ראב״כ כאדם שתולה וכו׳‬ כצ״ל:
Balak:34	תנא משום רבנן. בסנהדרין צ״ז הובא תחילת מאמר זה בשנויים רבים:
Balak:35	והיה ירשה. שעיר אויביו שהיה אויבו מחיי יעקב וכו׳‬ כצ״ל:
Balak:36	א״ר יוחנן אוי לאומה כו׳‬. (סנהדרין קי:) ע״ש:
Balak:37	בלעם שבלעם בעצתו כצ״ל:
Balak:38	בכל מקום שנאמר ישיבה כו׳‬. אינו אלא לשון צער כצ״ל:
Balak:39	שנאמר וקרא לך ואכלת מזבחו כצ״ל וע״ז קאי הקושיא ואימא עד דאכיל.
Balak:40	מעשה בסרטבא כו׳‬. כולה בסנהדרין ס״ד פ״ב:
Balak:41	שמעון כולו מהויב. כי כולם פרצו בעבירה:
Pinchas:1	בעי מיניה רב כהנא מרב וכו׳‬. כל הענין (סנהדרין פ״ב.):
Pinchas:2	כי אתי רבין וכו׳‬. משום נשג״ז שם. וע״ש בתוספות משום זונה אם הוא כהן:
Pinchas:3	אמר אביי מלקין כו׳‬. (קידושין פ״א):
Pinchas:4	והמעיד וכו׳‬. חייב מלקות ארבעים. אולי כוונתו על עד א׳‬ המעיד יחידי בדבר עיין (פסחים קי״ג:) טוביה חטא כו׳‬ מיהו הפרוש מלקות ארבעים מכת מרדות:
Pinchas:5	פסוק זה מופרד. פיסקא באמצע הפסוק:
Pinchas:6	ובא זאב וטרף מהם כצ״ל:
Pinchas:7	וכבר קרח וכו׳‬. ט״ס וצ״ל וכי קרח היה מן הר״ן איש.
Pinchas:8	ישמעאל אומר שאול. בסנהדרין פ״ב ה״ג רבי יוחנן:
Pinchas:9	חסרו משמעון שבעה ושלשים אלף ומאה וכו׳‬ כצ״ל:
Pinchas:10	הוא אצבון וכו׳‬. מל׳‬ אצית והאזין ע׳‬ פירש״י:
Pinchas:11	אלה משפחות יהודה. ששה ושבעים אלף וחמש מאות ובמדבר כתיב ארבעה ושבעים אלף ושש מאות עדפו מהם אלף ותשע מאות מפקידי מדבר סיני כצ״ל וכל המאמר משובש:
Pinchas:12	אלא תחת יוב. האמור בפרשה ויגש נאמר הכא ישוב לומר לך זו היא שיבה וכו׳‬ כצ״ל:
Pinchas:13	יששכר ארבעה וששים אלף. ושלש מאות ולהלן ב״פ במדבר היה ארבעה וחמשים אלף וארבע מאות הרי עדפו תשעה אלפים ותשע מאות כצ״ל:
Pinchas:14	בני זבולון וכו׳‬. לפקודיהם ששים אלף וחמש מאות ולהלן בפ׳‬ במדבר שבעה וחמשים אלף וארבע מאות עדפו להם שלשה אלפים ומאה כצ״ל:
Pinchas:15	בני יוסף בני. מנשה פקודיהם וכו׳‬ כצ״ל.
Pinchas:16	אלה בני אפרים וכו׳‬. ולהלן ב״פ במדבר ארבעים אלף וחמש מאות חסרו ח׳‬ אלפים:
Pinchas:17	ופקודיהם מ״ה אלפים. ו׳‬ מאות וב״פ במדבר לה׳‬ אלפים ד׳‬ מאות עדפו עשרת אלפים ומאתים כצ״ל ובכאן משובש:
Pinchas:18	לא הזכיר כאן את ישוה כצ״ל:
Pinchas:19	ור״י שאמר שזמרי וכו׳‬. עיין לעיל מזה לו כח פי׳‬ מזה לו ראיה אף שהיה מיורדי מצרים לא מת בדורו של יוסף. והיה בכאן כמו סרח שהאריכה ימים עד כעת:
Pinchas:20	פקודי. אשר נ״ג אלף ד׳‬ מאות ובבמדבר היו מ״א אלף וה׳‬ מאות עדפו וכו׳‬. כצ״ל:
Pinchas:21	שש מאות אלף ואלף שבע מאות ושלשים. ובמדבר סיני היו שש מאות אלף ושלשת אלפים וחמש מאות וחמשים חסרו הפקודים הללו מפקודי משה ואהרן אלף ושמונה מאות ועשרים כצ״ל. ודע כי בפרשה זו רבו הטעותים עד אין להכיל:
Pinchas:22	אבל הלוים. בכאן ג״כ טעות כי בפ׳‬ במדבר היו הלוים כ״ב אלף חוץ הבכורות שהיו ג׳‬ מאות ע״ש בפרש״י והוא בבכורות ה׳‬ כי במספר הפרטי יתר ג׳‬ מאות והם היו בכורות אבל במספר דהכא כ״ג אלפים היו עם הבכורות שלהם. וסוף המאמר בכאן ט״ס ע״כ הסגרתי במוסגר:
Pinchas:23	ופסוק זה וכו׳‬. כל המאמר עיין ספרי וכן (ב״ב קי״ז) וע״ש ברשב״ם ותוס׳‬ שנחלקו בביאור הלכה זו:
Pinchas:24	משונה נחלה וכו׳‬. חסר כאן וכצ״ל ואלא מה אני מקיים לשמות מטות אבותם (אתרי כי ס״ל לבאי הארץ נתחלקה) וע״ז קאי המאמר משונה נחלה וכו׳‬
Pinchas:25	הרי שיצאו ממצרים וכו׳‬. זה קאי למאן דסובר ליוצאי ממצרים נתחלקה הארץ קורא אני עליו לרב תרבה נחלתו וכו׳‬:
Pinchas:26	לפי פקודיו וכו׳‬. עיין בז״א בספרי שהאריך בביאור פיסקא זו. ובקיצור אגיד לפי דברי הרמב״ן בחומש וכפי שהאריך ג״כ המזרחי. יהיה כוונת הלשון דהכא שלא נתחלקה וכו׳‬ אלא לפי מה שהוא היינו שנתחלק לי״ב שבטים. לפי מספר אנשיהם כפי מה שהיו בצאתם ממצרים במנין הראשון בר עשרים. וזה דקדוק לשונו כפי׳‬ מה שהוא היינו כפי המספר שהיה אז. והנה במנין השני שבערבות מואב עדפו בני מנשה בן יוסף יותר מכל השבטים בסכום עשרים אלף ה׳‬ מאות ממנין הראשון ע״כ באו בקובלנא לפני יהושע מדוע נתת לי גורל א׳‬ וחבל א׳‬ ואני עם רב. ולפי דברי אלה יעלה כל הדרשות כהוגן:
Pinchas:27	יכול מעורבים. פי׳‬ שחלק שבט א׳‬ יהיה מעורב בשבט אחר ת״ל אך בגורל ואך חלק שיהיה כל שבט בפני עצמו:
Pinchas:28	שנאמר ויתנו לכלב וכו׳‬. כאשר דבר משה:
Pinchas:29	יצא יהושע וכלב. שלא נטלו עפ״י הגורל אלא עפ״י ה׳‬:
Pinchas:30	להוציא הגרים ואת העבדים. שאין להם משפחת בית אב:
Pinchas:31	אלא בשומא בית כור כנגד בית סאה. היינו עדית כנגד זבורית:
Pinchas:32	ולא זכר כאן שמעי. עיין בפרש״י שחסר עוד משפתת העוזיאלי וקצת מן יצהר:
Pinchas:33	שהארץ מתחלקת לשבטים כצ״ל וכ״ה בספרי. והכוונה אחרי כי הארץ נתחלקה לשבטים ע״כ תבעו חלק אביהן:
Pinchas:34	וכשם שהיה צלפחד בכור. עיין (ב״ב קי״ח.) ברשב״ם דורש מדכתיב הכא והעברת את נחלת אביהן להן וכתיב והעברת פטר רחם:
Pinchas:35	שהיה יוסף מחבב את ארץ ישראל. דכתיב והעליתם את עצמותי מזה אתכם:
Pinchas:36	אלו מרגלים. דכתיב עד מתי לעדה הרעה הזאת.
Pinchas:37	זו עדתו של קרח. דכתיב אתה וכל עדתך וכו׳‬:
Pinchas:38	מה להלן בנחלה. הגר״א הגיה בספרי להיפך מה כאן בנחלה אף להלן (דכתיב יקום על שם אחיו) בנחלה. שהיבם יקח ירושת אחיו:
Pinchas:39	תנה לנו אחוזה ולא בחזקה. בספרי הג׳‬ יותר נכונה יפה כח נשים מכח אנשים אנשים אמרו נתנה ראש ונשובה מצרימה ונשים אמרו תנו לנו אחוזה:
Pinchas:40	אלא לא היה יודע אם נוטלת בראוי וכו׳‬. עיין (ב״ב קי״ט.) הגי׳‬ אבל לא היה יודע אם נוטלות חלק בכורה או לאו. והכוונה הכל א׳‬ כי ספק היה למשה אם א״י מוחזקת אזי נוטלת ג״כ חלק בכורה כי אין הבכור נוטל בראוי כבמוחזק:
Pinchas:41	וחובה ע״י חייב. קאי על פרשת מקושש:
Pinchas:42	וכן כתוכ לפני במרום. יפרש מלת כן כמו (מלכים א׳‬ כ״ט) ועל השלבים כן שפירושו בסיס להושיב הכיור עליו. וכמו שפירשו המבארים כן צדקה לחיים (משלי י״א) וכן הכא כן בנות צלפחד (גרונד גיפאסט) היינו הדין הזה כבר כתובה לפני במרום:
Pinchas:43	נטלו ג׳‬ חלקים בנחלה. פי׳‬ הוא סובר שליוצאי מצרים נתחלקה הארץ והנה צלפחד וחפר אביו היו בני כ׳‬ שנים ביציאתם ממצרים ע״כ נטלו בנות צלפחד ג׳‬ חלקים היינו חלק צלפחד ושני חלקים בנכסי אביו חפר כי הוא היה בכור. והלשון דהכא אינו מדוקדק:
Pinchas:44	אלא בת. אם בעלה משבט אחר אזי מעביר הנחלה משבט לשבט:
Pinchas:45	הורעה וכו׳‬. ט״ס וצריך להיות אורעה כל הפרשה להיות דין ועיין (ב״ב קי״א:):
Pinchas:46	בד׳‬ מקומות ביקש וכו׳‬. ספרי מפורש הד׳‬ מקומות:
Pinchas:47	שהאדם נתון בחיים נפשו ביד קונו וכו׳‬ מת נשמתו נתונה באוצר דכתיב והיתה נפש אדוני צרורה בצרור החיים כצ״ל.
Pinchas:48	רוצה היה משה. בתנחומא מה ראה לבקש הצורך הזה אחר סדר נחלות אלא כיון שירשו בנות צלפחד בנכסי אביהם אמר משה הרי השעה שאתבע צרכי אם הבנות יורשות בדין הוא שירשו בני את כבודי:
Pinchas:49	ויעל בראשונה יואב וכו׳‬ כצ״ל:
Pinchas:50	ולפני אלעזר הכהן יעמוד וכו׳‬ כצ״ל.
Pinchas:51	ושאל לו. עיין (יומא ע״ג):
Pinchas:52	ת״ר כיצד שואלין (יומא שם):
Pinchas:53	במשפט האורים על פיו יצאו ועל פיו יבואו. הוא וכל ישראל. הוא זה מלך (דביהושע קאי ויהושע מלך) כצ״ל:
Pinchas:54	זה משוח מלחמה. וזה וכל ישראל אתו שהולכין אחריו במלחמה:
Pinchas:55	את קרבני. זה הדם דכתיב והקריבו בני אהרן את הדם:
Pinchas:56	לאשי אלו קמצים ולבונה. שהקומץ ולבונה עולה כולה לאשים:
Pinchas:57	לריח ניחוח. אלו בזיכי לבונה שיש להם ריח:
Pinchas:58	תשמרו. שיהיו מבוקר הד׳‬ ימיסקודם שחיטה:
Pinchas:59	מלמד שדוחה את השבת. היינו שחיטת הפסח כשחל י״ד בשבת כי גבי תמיד לא אצטריך דבהדיא כתיב וביום השבת שני כבשים:
Pinchas:60	כנגד היום. דריש ליום הוא השמש כמו (יתזקאל ל׳‬) ובתתפנחס חשך היום:
Pinchas:61	מכאן אמרו וכו׳‬. היה נשחט על קרן צפונית מערבית של בין הערבים נשחט על קרן מזרחית צפונית כצ״ל:
Pinchas:62	לפי שהוא אומר זה האשה וכו׳‬. שנים ליום עולת תמיד. ונאמר בפ׳‬ תצוה ג״כ כבשים בני שנה שנים יכול יקריב ארבעה שנים בבוקר ושנים בערב (דה״א דקרא בפ תצוה קרבן אחר חוץ מה שכתוב כאן) ת״ל את הכבש האחד שלא להוסיף ולא לגרוע:
Pinchas:63	למנחה בלולה בשמן כתית. להוציא את השלוק כצ״ל ומילת כתית דריש:
Pinchas:64	מה עולת הר סיני ע״ג דמזבח. דכתיב ויבן מזבח תחת ההר וכו׳‬ וישלח את נערי ב״י ויעלו עולות וסברי עולה שהקריבו במדבר עולת תמיד הואי:
Pinchas:65	ר״ע אומר מה עולת כו׳‬. עיין ספרי ולפי גרסת הגר״א וכן הגיה החכם הספרדי צ״ל להיפך מה עולת תמיד טעונה נסכים דכתיב בהדיא בקרא ונסכו רביעית ההין אף עולת הר סיני טעונה נסכים:
Pinchas:66	חי אתה מנסך. מדכתיב רביעית ההין שאם יהיה מזוג לא יהיה יין חי רביעית ההין.
Pinchas:67	והקדש יבלעו. היינו לתוך השיתין:
Pinchas:68	להביא את המים. היינו בחג הסוכות מנסך ג״כ מים:
Pinchas:69	אבל מזידים עבר היום בטל קרבנו. וע״ש (מנחות נ.) שמסיק הש״ס דווקא אותן כהנים לא יקריבו אבל כהנים אחרים יקריבו בין הערבים כי מזבח מה חטא ע״כ הגי׳‬ דהכא בטל קרבנו צע״ג:
Pinchas:70	שהזבח קרב היינו לכל תמיד יקריב אתו הנכסים. ולא שיקריב השני תמידין ואח״כ הנסכים:
Pinchas:71	ללמדך שאחד המרבה ואחד הממעיט שווין לפני הקב״ה שאין לפניו אכילה ושתיה אלא שאמר וכו׳‬ כצ״ל:
Pinchas:72	יצא שבת לדין בקבועה. אחרי כי מוסף שבת קבועה ע״כ דוחה שבת ולא קרבנות אחרים:
Pinchas:73	שיהו מבוקרים. מע״ש:
Pinchas:74	הין היה במקדש. (מנחות פז):
Pinchas:75	לא עולת חודש זה וכו׳‬. היינו שיכול אם לא הקריבו בחודש א׳‬ לא יקריבו בחודש שלאחריו שני קרבנות. וכ״ה בהדיא בספרי:
Pinchas:76	מיעוט חדשים שנים. ולא יקריב בשנה רק שני חדשים:
Pinchas:77	שאין מוספים קריבים וכו׳‬. וכ״ה גבי מוספי ר״ח שקרבין באמצע. וכ״ה בהדיא בספרי:
Pinchas:78	בארבעה עשר יום לחודש. פסח לה׳‬ קבעו הכתוב חובה. עיין במפרשי הספרי שנדחקו בפירושו. ול״נ הכוונה קבעו הכתוב חובה פי׳‬ בין חובות הקבועות להם זמן היינו שידחה שבת אם חל י״ד בשבת ועיין (פסחים סו) דריש ממועדו:
Pinchas:79	אירעו במאכל ובמשתה. תרגום על מקרא קודש מארע קודש:
Pinchas:80	מכאן אמרו (מנחות ס״ח:).
Pinchas:81	ומנחת בהמה היינו מנחת נסכים של בהמה:
Pinchas:82	שלא כשרו וכו׳‬. שחדש אסור קודם לעומר:
Pinchas:83	חוץ מן האמורים. בת״כ בפ׳‬ אמור ז׳‬ כבשים פר אחד ואילים שנים והם באו להתיר את הלחם. ובכאן הוא חובת היום:
Pinchas:84	ת״ל שבעת ימים וכו׳‬. עיין ספרי בהג׳‬ הגר״א הגיה הקרא והקרבתם עולה אפילו א׳‬ מהם ונכון כי זה הקרא כתיב הכא בחג השבועות.
Pinchas:85	יהיה לכם חסר וכצ״ל תמימים יהיו לכם ונסכיהם מקיש נסכים וכו׳‬. ומומין גבי נסכים יין שעלה בו קמחין פסול:
Pinchas:86	מעיו לנבלים. בני מעיו לכנורות כצ״ל:
Pinchas:87	שיהיה כל התקיעות כו׳‬. שגם ביו״כ של יובל היו תוקעין.
Pinchas:88	וכל מלאכה וכו׳‬. בעצם משונה וכו׳‬. כל הפסקא הוא בטעות גם ציון הקרא וכל מלאכה לא תעשו בעצם היום הוא בפ׳‬ אמור. ע״כ הרבה טעותים נפל בזה. והנני לציין לפי דעתי שכצ״ל קרא דהכא. כל מלאכה לא תעשו משונה יו״כ שנאמר בו כל מלאכה לא תעשו (ולא נאמר מלאכת עבודה כמו בכל הרגלים) ללמדך שביו״כ אסור אפילו עבודת אוכל נפש:
Pinchas:89	ולמה נאמר בעצרת ויו״כ שעיר. בלא וא״ו ובכל הרגלים בוא״ו:
Pinchas:90	עולה שבעצרת מלא בוא״ו ובכולם כתיב עלה בלא וא״ו:
Pinchas:91	ובט״ו לחורש השביעי מקרא קודש וכו׳‬. וחגותם חג לה׳‬ ז׳‬ ימים. וכבר נאמר קרבן חגיגה בפ׳‬ אמור ובא וחזר ושנה עליו כאן לקובעו חובה. כן פירש חכם הספרדי:
Pinchas:92	אף נסכי מים בחג כדי שיתברכו כצ״ל:
Pinchas:93	עם לבדד ישכון. וסיפא דקרא ובגוים לא יתחשב:
Pinchas:94	להביא שנדר קודם הרגל. ע״כ נקרא שלמיכם לשון שלם ופורקן ממה שכבר נדר:
Matot:1	כיון שעבר הרגל. פי׳‬ דברגל הראשון עובר בעשה. ובבל תאחר בג׳‬ רגלים דוקא עיין (ר״ה ד׳‬:)
Matot:2	חכם מתיר. דורש לא יחל דברו לא יעשה דבריו חולין ודרשינן אבל אחרים מוחלין לו שעושין אותו חולין ובחולין מותר שייך למימר בהו (הר״ן נדרים ע״ז):
Matot:3	אמר ר״י אמר שמואל מנין שיש היתר כו׳‬. (חגיגה י:):
Matot:4	והלכתא נדר שהודר וכו׳‬. (גיטין לו.):
Matot:5	שהיה פושע בתינוקות. פרש״י שהיו חובטן יותר מדאי:
Matot:6	את שהסמיך נדרו לדבר שאפשר לו להנדר. פירש לדבר הנדור וזה נקרא דבר שאפשר כי דבר הנדור אפשר לו שידור או לא ידור משא״כ דבר האסור:
Matot:7	אף בשבועה כן. שישבע בדבר הנדור:
Matot:8	ת״ל או השבע שבועה וכו׳‬. לאסור איסר דווקא בדבר האסור והסיום מ״מ לא ידעתי לפרשו וצ״ע:
Matot:9	אין לי אלא שהוציא מפיו גמר בלבו מנין. הגר״א מחק בספרי דרשה זו ובאמת הוא נגד תלמוד ערוך (שבועות כ״ו) אמר שמואל גמר בלבו צריך להוציא בשפתיו:
Matot:10	שלא יעשה דבריו חולין. הרי שהיו חכם ונדר לא יפר לעצמו כצ״ל:
Matot:11	שעובר בעשה ול״ת. עשה ככל היוצא מפיו יעשה ל״ת לא יחל דברו:
Matot:12	אף אשה. דה״א הואיל ובאשה אביה ובעלה מפירין נדריה לא תעבור על בל יחל ובל תאחר קמ״ל:
Matot:13	יכול אפילו קטנה. פי׳‬ שגם היא ברשות אביה.
Matot:14	וכה״א או אסרה איסר על נפשה וכו׳‬ כצ״ל:
Matot:15	בבית אביה בנעוריה. ערבובי דברים בכאן. וכצ״ל בנעוריה בבית אביה ברשות אביה להביא את שנתארמלה או שנתגרשה מן האירוסין. וקרא דסוף הפרשה בנעוריה בית אביה להוציא את שנתארמלה או נתגרשה מן הנשואין אז יצאתה מרשות האב לגמרי כצ״ל:
Matot:16	ושמע אביה להוציא את החרש. פי׳‬ חרש המדבר ואינו שומע. והפרה יכול להיות אצלו אחרי שמדבר (נדרים ע״ג.) גבי בעל בפי׳‬ הר״ן והרא״ש:
Matot:17	אפי׳‬ השמיעוהו אחרים. ואם לא היפר לה באותו יום נדרה קיים ודורש זה מקרא דלאחריו ואם הניא אביה אותה ביום שמעו אפילו השמיעוהו אחרים:
Matot:18	והחריש לה אביה. עד שיהיה מתכוון לה עיין (נדרים פ״ו:) נדרה אשתו וסבר שנדר בתו וכו׳‬ למימרא דיניא אותה דוקא וע״ש הר״ן דקאי אקרא ואם הניא אביה אותה וכו׳‬ והקשה הר״ן תינח בהפרה בהקמה מנין ע״ש שהאריך. ולפי גרסא דהכא והחריש לה אביה עד שיהיה מתכוון לה הרי קרא גבי הקמה בהדיא סרה קושית הר״ן ויש לי אריכות דברים בזה אבל אכ״מ.
Matot:19	הרי. זה יחזור ויפר ת״ל והחריש לה עד שיהיו מתכוון לה כצ״ל:
Matot:20	מגיד על נדר. דורש מלת יקום כיון שהקים שעה אחת אינו יכול להפר אח״כ:
Matot:21	הנאה זו הפרה. פי׳‬ דגבי בעל כתיב יניא אותה והפר אף גבי אביה דכתיב ואם הניא אביה אותה פי׳‬ שיפר:
Matot:22	מה הבעל וכו׳‬. פי׳‬ גבי בעל בין לענין הקם ושמע אישה ביום שמעו והחריש וקמו כו׳‬ בין לענין הפר (ואם ביום שמוע אשה יניא אותה) אף האב כן דגבי אב כתיב סתם (ושמע אביה את נדרה והחריש לה) ה״א כיון ששמע האב והחריש לא יוכל להפר אף באותו יום. ע״כ אמר שלימד אב מבעל שגם הוא יכול להפר כל היום (חכם הספרדי):<br>כב. ובטלה ולבו ט״ס וצ״ל ובטל בלבו היינו האב בטל לה הנדר והיא לא ידעה ועברה אעפ״כ צריכה כפרה ק״ו לנדרים:
Matot:23	זו ארוסה. כשהוא אומר ואם בית אישה נדרה הרי נשואה אמורה דברי ר׳‬ יאשיה. ודע כי בין ר׳‬ יאשיה ובין ר׳‬ נתן אין שום נ״מ ומשמעות דורשין א״ב שכל זמן שהיא בבית אביה אביה ובעלה מפירין נדריה. ניסת אין האב מפר נדריה כצ״ל:
Matot:24	נדרים שבאו עמה מבית אביה לבית בעלה. פי׳‬ שנדרה בעודה ארוסה והאב הפר חלקו וכשבאה לבית בעלה יפר חלקו. אבל מה שנדרה קודם שהיתה ארוסה אין הבעל יכול להפר שאין הבעל מפר בקודמין:
Matot:25	ולא מפר עד שלא נדרה. (נדרים ע״ה) והוא כדברי חכמים שם האומר לאשתו כל נדרים שתדורו מכאן עד שאביא ממקום פלוני הרי הם מופרים. וחכ״א אינו מופר והוא כמו שסיים אישה יקימנו ואישה יפירנו את שבא לכלל הקם בא לכלל הפר:
Matot:26	כנון שאם נדר בר״ה וכו׳‬. (נדרים כ״ג:) ובלבד שיהיה זכור בשעת הנדר וכו׳‬:
Matot:27	אלא כאשתו וכו׳‬. נדרים אשר עליה מיפר ולא קודם שנדרה:
Matot:28	אף אלמנה וגרושה סן הנשואין. אבל מן הארוסין מת הבעל חזרה לרשות האב:
Matot:29	זו יתומה בחיי האב. שנשאת ונתארמלה או נתגרשה כשהיא קטנה כצ״ל. ותיבת שנתקדשה ט״ס:<br>כט. זו חרישה לקיים. היינו ששותק על מנת לקיים הנדר:
Matot:30	אחרי קיום הנדר. היינו אם קיים לה הנדר אף באותו יום אינו יכול להפר:
Matot:31	מלמד שהוא מכונס וכו׳‬. היינו אחרי כי קיים לה הנדר ואם אח״כ מכריחה לעבור הנדר אזי מכונס הוא תחתיה לעון:
Matot:32	בכל המידות שאמרנו. כי דיני הקמה והפרה שוים האב להבעל:
Matot:33	עד שנוקמין וכו׳‬. ברבה מסמיך ליה על קרא ישמח צדיק כי חזה נקם:
Matot:34	והלא מואבים היו בתחילה לדבר כצ״ל. והכוונה כי המואבים הם פתחו תחלה ללחום עם ישראל כדכתיב בפרשת בלק ויאמר מואב אל זקני מדין עתה ילחכו וכן. וילכו זקני מואב וזקני מדין ועיין רש״י בחומש שכתב טעם אחר וז״ל מאת המדינים ולא מאת המואבים שהמואבים נכנסו לדבר מחמת יראה שהיו יריאים מהם שהיו ישראל שוללים אותם שלא נאמר רק אל תתגר בם מלחמה. אבל המדינים נתגרו על ריב לא להם ובאמת דברי רש״י נגד גמרא ערוכה (ב״ק ל״ח) וכי מה עלה על דעתו של משה לעשות מלחמה עם מואב שלא ברשות וכו׳‬ ועיין במזרחי שמיישב קצת דברי רש״י:
Matot:35	אלא בתחלה היה להם תגר וכו׳‬. לא ידעתי מאי מתרץ בזה הקושי׳‬. ועיין בספרי ובז״א:
Matot:36	להביא שבטו של לוי. הגר״א גורס בספרי להוציא שבטו של לוי דלא מצאתי ששבטו של לוי ילך למלחמה:
Matot:37	מלמד שהיו שקולים כפינחס וכו׳‬ דורש אותם השני מיותר הוא דכתיב וישלח אותם משה כו׳‬ אותם ואת פינחס. (מזרחי) ודע כי הלשון שהיו שקולים כפינחס לאו דוקא אלא שהיו צדיקים כי אח״כ אמר ופינחס שקול כנגד כולם.
Matot:38	ומפני מה הלך פנחס וכו׳‬. (סוטה מ״ג). ע״ש כי דברי המחבר בסופו מעורבבים קצת.
Matot:39	בידו ברשותו כצ״ל. וכה״א וכל טוב אדוניו בידו פי׳‬ ברשותו:
Matot:40	הקיפוה מג׳‬ רוחותיה. בספרי הג׳‬ מד׳‬ רוחותיה. וגרסא דהכא נכונה כי כן דעת הרמב״ם בהלכות מלכים כשצרין על עיר לתפסה אין מקיפין אותה אלא מג׳‬ רוחותיה ומניחין מקום לברוח למי שירצה:
Matot:41	ומשלו חכמים. (סנהדרין ק״ו):
Matot:42	בב״ד הרגוהו. הגר״א הגיה בספרי בד׳‬ מיתות בית דין הרגוהו וכמו שהוא (סנהדרין ק״ו.) א״ר שקיימו בו ד׳‬ מיתות בי״ד:
Matot:43	אדונינו כשם וכו׳‬. פי׳‬ פינחס אמר למשה אתה אמרת נקום נקמת בני ישראל מאת המדינים ע״כ הרגנו רק הזכרים וע״ז אמר לו משה הן הנה היו לבני ישראל בדבר בלעם וכו׳‬ כמו שמסיים הכא ע״כ גם הנקבות חייבין מיתה:
Matot:44	שינה עליהם. הכתוב היינו תהרגו השני לעכב שכל אשה יודעת איש ג״כ להריגה:
Matot:45	אמרו רבותינו. העבירן לפני הארון. (יבמות ס.) ושם הג׳‬ כל שפניה מוריקות בידוע שהיא ראויה להבעל:
Matot:46	מפורש בברייתא. ספרי חוקת פיסקא קכ״ז ע״ש:
Matot:47	הא למדנו לארבעה כלים כצ״ל וכ״ה בספרי שם בגד וכלי עור ומעשה עזים וכלי עץ:
Matot:48	מה אתם בני ברית אף שביכם בני ברית. כי הא״י אינם מקבלים טומאה רק אחר שיתגיירו יקבלו טומאה.
Matot:49	מה המת חמור. היינו הכא כתיב בהדיא וכל מעשה עזים תתחטאו. ועיין בספרי שפריך ע״ז האיך הוא ק״ו ממת החמור על שרץ הקל וע״ש שמסיים דרשא אחרת ובכאן חסר.
Matot:50	שמעו נא המורים. מה הוא אומר ויך והיינו שטעה וזה חטא דמי מריבה:
Matot:51	או אינו אלא גלמים. הואיל ומתי ישראל מטמאין והרוגי מדין מטמאין מה מתי ישראל מטמאין כלים ולא גולמים (דכתיב והזה על האוהל ועל הכלים) אף מתי מדין מטמאין כלים ולא גולמים כצ״ל:
Matot:52	ומה מי שאין טעון טבילה. חסר ג״כ ומה מי שאין טעון הזיה (דהיינו דבר שלאיבוא באש שלא הוזכרה בו הזיה) צריך טבילה. דבר שצריך הזייה (היינו דבר אשר יבוא באש) אינו דין שצריך טבילה פ׳‬ החכם הכפרדי ולמדנו ששניהם צריך טבילה והזיה. ועיין בספרי ועיין ברש״י והרמב״ן:
Matot:53	בא הכתוב ללמד. על החרב שהוא טמא ז׳‬ ועל הנוגע בו שהוא טמא ז׳‬ כצ״ל כי חרב הרי הוא כחלל. ולומד זה מקרא כל הורג נפש הרי הרגו בכלי זיין ולא יגע במת עצמו. ודע לפי הכלל שסתם ספרי ר׳‬ שמעון ב״י מכאן ראיה לדברי רבינא (יבמות ס) שתירץ לרשב״י אף שסובר שקברי א״י אין מטמאין אבל במגע ובמשא מטמאין. כי כאן ראינו שהחרב נטמא מחלל מדין לא כסתמא דגמרא דמתרץ לקרא כל הורג נפש דילמא איקטל חד מישראל ע״ש.
Matot:54	שלא יעשה אדם עצמות אביו וכו׳‬. ידים פ״ד כה״ע ע״ש:
Matot:55	ואחר תבואו אל המחנה אחרי כן. פי׳‬ אחר הוא אחר כן:
Matot:56	זה א׳‬ מעיטור סופרים. קאי ג״כ על קרא ואחר תבואו כי מלת אחר מיותר הוא דה״ל למכתב ותבואו ועיין כ״ז (נדרים ל״ז:) בפרש״י ור״ן:
Matot:57	אדם אלו הנשים. כי הזכרים נהרגו כולם:
Matot:58	שנאמר ברה היא ליולדתה. פי׳‬ מי שמוציא הדין מתוך משנתו.
Matot:59	מלמר שהכהנים כו׳‬. מדכתיב מכס לה׳‬
Matot:60	מנה הכתוב. (שבת ס״ב).<br>ס. וכל שעסקו עם הנשים סורו רע כצ״ל:
Matot:61	מכאן אמרו לשכת חשאים היו שם כצ״ל:
Matot:62	לא כשאתם אומרים כו׳‬. כי הם החשיבו המקנה יותר מן הבנים שאמרו גדרות צאן למקננו וערים לטפנו.
Matot:63	מכאן אמרו כל תנאי וכו׳‬. (קדושין סא.):
Matot:64	ושמעון. פי׳‬ אף שהיה גם כן בדגל ראובן:<br>סד. מוסבות שם. מקום הוא פי׳‬ המחבר מפרש מוסבות שם הוא שם מקום שעמדו שם הערים נבו ובעל מעון לא כפרש״י ושארי מפרשים שפי׳‬ שנשתנה שמם מחמת שם עובדי כוכבים:
Matot:65	ויקרא לה נובח בשמו לה לא מפיק ה׳‬ כצ״ל ובכאן ט״ס ועיין במנחת שי:
Masei:1	שהיו מדיינים אותם. קאי על המצרים מה ששעבדו את ישראל:
Masei:2	ואעפ״כ לא הוזכרו שמות הערים וכו׳‬ כצ״ל:
Masei:3	בארץ פתרוס. הוא ארץ מצרים:
Masei:4	נחית סימן וכו׳‬. עיין כ״ז בתנחומא וכן ברבה בפרשה זו. וע ש בה״ג הרד״ל:
Masei:5	איקונות של אבן. צורות של אבן שחקוק עליהם עכמו״ז:
Masei:6	שלא יוציאו לעז על הגורלות. עיין (סנהדרין מ״ג):
Masei:7	והיה לכם פאת נגב. חסר הדרשה ועיין בפרש״י שהאריך בזה:
Masei:8	כתיב מקיר העיר וכו׳‬. עיין עירובין כל הדרשה שם וע״ז קאי דברי המחבר והציור:
Masei:9	ת״ר ג׳‬ ערים. (מכות ט:) ע״ש:
Masei:10	תניא ראב״י אומר מקלט. (מכות י).
Masei:11	עד שיהיו ששה דכתיב שש ערי מקלט תהיינה עד שיהיו ששתן קולטות כאחת (מכות שם):
Masei:12	בין לדעת. היינו שהרוצח נכנס שמה לדעת שיקלוט אותו:
Masei:13	ת״ל והקריתם לכם. ומקודם כתיב כי אתם עוברים את הירדן והיינו בימי יהושע:
Masei:14	כי אתם עוברים את הירדן ארצה כנען ר״י אומר אין הירדן מארץ כנען דמשמע דווקא אחר העברת הירדן מתחיל ארץ כנען רשב״י אומר וכו׳‬ כצ״ל וכ״ה בספרי:
Masei:15	אין והקריתם אלא הזמנה. וכה״א כי הקרה ה׳‬ לפני כ״ה ברש״י בחומש.
Masei:16	לא גדולים. שהכל נקבצים שם תדיר ויהיה רגל גואל הדם מצויה שם. ויארב לו (רש״י מכות שם):
Masei:17	ואין קטנים. שאין מזונות מצויים שם:
Masei:18	יכול כל רוצח. אף מזיד במשמע שיגלה:
Masei:19	יצא האב המכה. (מכות ח׳‬) ודורש שם ואשר יבוא את רעהו ביער לחטוב עצים וכו׳‬. מה חטבת עצים רשות כו׳‬ יצא האב המכה את בנו והרב הרודה את תלמידו ושליח ב״ד שמצוה קעבדי ע״ש:
Masei:20	שלא יהרגנו בינו לבין עצמו. (מכות י״ב) כדברי ר׳‬ אלעזר:
Masei:21	ולמה בא״י שלש. הלא שם רוב ישראל ט׳‬ שבטים ומחצה:
Masei:22	בין מזיד בין שוגג. לא היה נהרג כצ״ל:
Masei:23	ומה ת״ל ולגר וכו׳‬. בכאן ט״ס ועיין בספרי וכצ״ל ולגר ולתושב תהיינה שש הערים האלה למקלט למה נאמר לפי שהוא אומר את שלוש הערים תתנו מעבר לירדן שומע אני הראשונות שמפרישין תהיינה קולטות. ת״ל תהיינה שש הערים האלה למקלט מלמד שלא היו קולטות עד שהפרישו כולם
Masei:24	מפני מה לא נאמר יד בברזל. (סנהדרין ע״ו) כמו שנאמר באבן ואם באבן יד:
Masei:25	שהברזל ממית בכ״ש. ע״י תחיבה שיתחוב לו מחט בוושט או בלבו (רש״י שם):
Masei:26	שאם השליך עליו. עשת ברזל שאינו כלי דה״א בכלי ברזל דווקא:
Masei:27	שאם גלגל עליו סלעים. אף שלא נטלם בידו כלל:
Masei:28	בברזל לא כ״ש. שהברזל ממית בכ״ש:
Masei:29	שתהא מתכוין לו. כי גם גבי מזיד נתכוין להרוג את זה והרג זה פטור גבי שוגג לענין גלות גם כן צריך שיכוין לו:
Masei:30	אין לו גואל הדם. כגון גר שנתגייר:
Masei:31	בפגעו בו. להביא כל האדם (סנהדרין מה.) בפגעו בו בכל מקום שב״ד מעמידין לו גואל הדם.
Masei:32	להוציא השוגג. ופלא הוא הלא עיקר גלות על השוגג והנכון כפי מה שהובא בשם חכם הספרדי. ואם בפתע בלא איבה להוציא את השונא וכן הוא (מכות ז:):
Masei:33	להביא את הסומא. הוא דברי ר׳‬ מאיר (מכות ט:):
Masei:34	ר״י אומר כדאמרינן (סנהדרין כט.) ע״ש.
Masei:35	מכאן אמרו בראשונה. (מכות ט:) כדי שיתפללו (מכות יא) הגירסא בכדי שלא יתפללו על בניהם שימותו וגירסא זו יותר נכונה.
Masei:36	וכה״ג מאריך ימיו של אדם. כי אין מיתה בלא חטא וכה״ג מכפר עונות ביוה״כ.
Masei:37	מכאן אמרו (מכות יב) ע״ש הרג באותה העיר גולה משכונה לשכונה אחרי כי אין יכול לצאת משם מחמת הרציחה הראשונה שלא יהרגנו גואל הדם הראשון.
Masei:38	ובן לוי גולה מעיר לעיר. אחרי כי יכול לצאת מעירו כי הרציחה אצלו פעם ראשונה:
Masei:39	כל מכה נפש. חסר בכאן וכצ״ל לפי שנאמר גואל הדם הוא ימית את הרוצח בפגעו בו ימיתנו יכול בעדים ושלא בעדים ת״ל לפי עדים ירצח את הרוצח שלא יהרגנו אלא בעדים כצ״ל וכן הגיה הגר״א בספרי:
Masei:40	אם כופר גבי שור הנסקל. ושם כתיב וגם בעליו יומת והוא מיתה בידי שמים עיין (כתובות ל״ז עירובין ו):
Masei:41	משנגמר דינו פטורים כי גברא קטילא קטל. ובסופו יתן ממון ולא יגלה כצ״ל לפי גרסת הגר״א:
Masei:42	הרי שהרג נפש בשוגג כצ״ל וכ״ג הגר״א. ועיין בפרש״י למי שנס אל עיר מקלט שהרג בשוגג אינו נפטר מגלות בממון ליתן כופר לשוב טרם מות הכהן הגדול. ועיין כתובות שם:
Masei:43	יתכפר להם. ולא יהרגו את הרוצח:
Masei:44	אם בקשתוני. הגר״א הגיה מה תבקשני הריני אצל בני כל זמן שתבקשני הריני שם:
Masei:45	ומאי דרוש. (תענית ל:)
Masei:46	זו סיבת הבן. כי ירושת בן מאב הוא תמיד בשבט אחד:
Masei:47	היאך בת יורשת שני מטות. (ב״ב קי״א) קאי על הקרא וכל בת יורשת נחלה ממטות בני ישראל הרי שירשה ב׳‬ מטות:
Masei:48	פי׳‬ שכבר הוסבה. (ב״ב קי״ב) אא״ב שכבר הוסבה. וע״ש ברשב״ם גרסות שונות וכן בתוס׳‬ שם ודברי המחבר מבוארין כי הקרא אסר באותו הדור לבנות צלפחד להנשא לשבט אחר זולת שבט מנשה שלא תסוב הנחלה ממטה למטה. אבל זו שאביה היו משבט ראובן ואמה משבט שמעון ומתו והיא יורשת שני חלקים חלק אביה משבט ראובן וחלק אמה משבט שמעון כבר הוסבה לידה ירושת אמה משבט שמעון ע״י נשואי אביה ואם תנשא אח״כ לשבט אביה ראובן אין זה הסבת נחלה משבט שמעון ע״ש בגמ׳‬ כל הסוגיא.
Masei:49	זו מצות עשה (ב״ב קי״ב) שיש כאן לאו ועשה. לאו ולא תסוב נחלה עשה כי איש בנחלתו ידבקו:
Masei:50	לפיכך נפלו חבלי מטה בני מנשה. וסיפא דקרא כי בנות מנשה (היינו בנות צלפחד) נחלו נחלה בתוך בניו.
Masei:51	דאמר רשב״י אותה שעה וכו׳‬. (ב״ב קי״ט:):
Masei:52	המחלק נכסיו. (שם קכ״ו:):
Masei:53	המזכה לעובר. (שם קמי״ב):
Masei:54	שלח רב אחא בריה דרב עויא כצ״ל:
Masei:55	הכותב כל נכסיו לאשתו. (שם קל״א:):
