Kessef Mishneh on Mishneh Torah, Forbidden Intercourse 1:15:1	בס״פ הערל (דף פ״א	בס״פ הערל (יבמות דף פ״א
Kessef Mishneh on Mishneh Torah, Forbidden Intercourse 4:15:1	בפרק כל היד (דף י״ז	בפרק כל היד (נדה דף י״ז
Kessef Mishneh on Mishneh Torah, Forbidden Intercourse 8:14:1	בפרק כל היד (דף י״ו	בפרק כל היד (נדה דף י״ו
Kessef Mishneh on Mishneh Torah, Forbidden Intercourse 10:1:1	בר״פ המפלת (דף כ״א	בר״פ המפלת (נדה דף כ״א
Kessef Mishneh on Mishneh Torah, Forbidden Intercourse 10:11:1	בפרק המפלת (דף כ״ג ע״ב	בפרק המפלת (נדה דף כ״ג ע״ב
Kessef Mishneh on Mishneh Torah, Forbidden Intercourse 16:4:1	בפרק הערל (דף ע״ה	בפרק הערל (יבמות דף ע״ה
Siftei Kohen on Shulchan Arukh, Yoreh De'ah 4:3:1	פרק השוחט (דף ל"ט ע"ב	פרק השוחט (חולין דף ל"ט ע"ב
Siftei Kohen on Shulchan Arukh, Yoreh De'ah 17:3:1	פ' השוחט (דף ל"ח ע"א	פ' השוחט (חולין דף ל"ח ע"א
Siftei Kohen on Shulchan Arukh, Yoreh De'ah 19:3:1	פ' לולב הגזול (דף ל"ט ע"א	פ' לולב הגזול (סוכה דף ל"ט ע"א
Siftei Kohen on Shulchan Arukh, Yoreh De'ah 20:1:1	בפ' הגוזל (דף צ"ט ע"ב	בפ' הגוזל (בבא קמא דף צ"ט ע"ב
Siftei Kohen on Shulchan Arukh, Yoreh De'ah 22:2:1	פ' השוחט דף ל'	פ' השוחט (חולין דף ל')
Siftei Kohen on Shulchan Arukh, Yoreh De'ah 24:2:1	פרק השוחט (דף כ"ט ע"א	פרק השוחט (חולין דף כ"ט ע"א
Siftei Kohen on Shulchan Arukh, Yoreh De'ah 24:13:1	פ' השוחט [דף כ"ח ע"א	פ' השוחט (חולין דף כ"ח ע"א)
Siftei Kohen on Shulchan Arukh, Yoreh De'ah 24:13:1	בפ' השוחט (דף ל"ב ע"ב	פ' השוחט (חולין דף ל"ב ע"ב
Siftei Kohen on Shulchan Arukh, Yoreh De'ah 27:2:1	פ' העור והרוטב (דף קכ"א ע"ב	פ' העור והרוטב (חולין דף קכ"א ע"ב
Siftei Kohen on Shulchan Arukh, Yoreh De'ah 28:5:1	פ' לולב וערבה (דף מ"ו ע"א	פ' לולב וערבה (סוכה דף מ"ו ע"א
Siftei Kohen on Shulchan Arukh, Yoreh De'ah 28:12:1	פ' השוחט (דף ל"א	פ' השוחט (חולין דף ל"א
Siftei Kohen on Shulchan Arukh, Yoreh De'ah 28:29:1	בפרק החובל (סוף דף צ"א	בפרק החובל (סוף בבא קמא דף צ"א
Siftei Kohen on Shulchan Arukh, Yoreh De'ah 28:30:1	פרק השוחט (דף ל"ג ע"א	פרק השוחט (חולין דף ל"ג ע"א
Siftei Kohen on Shulchan Arukh, Yoreh De'ah 28:36:1	פרק אלו עוברין (דף מ"ז	פרק אלו עוברין (פסחים דף מ"ז
Siftei Kohen on Shulchan Arukh, Yoreh De'ah 33:4:1	בפ' השוחט (דף ל"ב ע"ב	בפ' השוחט (חולין דף ל"ב ע"ב
Siftei Kohen on Shulchan Arukh, Yoreh De'ah 45:4:1	פ' אחד דיני ממונות (דף ל"ג ע"א	פ' אחד דיני ממונות (סנהדרין דף ל"ג ע"א
Siftei Kohen on Shulchan Arukh, Yoreh De'ah 50:3:1	פ' ד' אחין (דף ל"א	פ' ד' אחין (יבמות דף ל"א
Siftei Kohen on Shulchan Arukh, Yoreh De'ah 60:5:1	פרק כל הצלמים (דף מ"ט ע"א	פרק כל הצלמים (עבודה זרה דף מ"ט ע"א
Siftei Kohen on Shulchan Arukh, Yoreh De'ah 62:3:1	בפ' העור והרוטב (דף קכ"א ע"ב	בפ' העור והרוטב (חולין דף קכ"א ע"ב
Siftei Kohen on Shulchan Arukh, Yoreh De'ah 62:3:1	פ' השוחט (דף ל"ג ע"ב	' השוחט (חולין דף ל"ג ע"ב
Siftei Kohen on Shulchan Arukh, Yoreh De'ah 67:8:1	פ' השוחט ריש דף ל"ג	פ' השוחט ריש (חולין דף ל"ג)
Siftei Kohen on Shulchan Arukh, Yoreh De'ah 68:33:1	פ' דם חטאת (דף צ"ה ע"ב	פ' דם חטאת (זבחים דף צ"ה ע"ב
Siftei Kohen on Shulchan Arukh, Yoreh De'ah 69:30:1	בפרק השוחט (דף ל"ג ע"א	בפרק השוחט (חולין דף ל"ג ע"א
Siftei Kohen on Shulchan Arukh, Yoreh De'ah 86:2:1	פ' כל הבשר (דף קי"ו	פ' כל הבשר (חולין דף קי"ו
Siftei Kohen on Shulchan Arukh, Yoreh De'ah 87:6:1	פרק במה בהמה (דף נ"ד	פרק במה בהמה (שבת דף נ"ד
Siftei Kohen on Shulchan Arukh, Yoreh De'ah 87:6:1	בפ' במה אשה (סוף דף ס"ד	פ' במה אשה (סוף שבת דף ס"ד
Siftei Kohen on Shulchan Arukh, Yoreh De'ah 91:10:1	פ' כיצד צולין (דף ע"ו ע"א	פ' כיצד צולין (פסחים דף ע"ו ע"א
Siftei Kohen on Shulchan Arukh, Yoreh De'ah 91:21:1	בפ' כיצד צולין דף ע"ו	בפ' כיצד צולין (פסחים דף ע"ו)
Siftei Kohen on Shulchan Arukh, Yoreh De'ah 98:2:1	בפ' הגוזל בתרא (דף קי"ד	בפ' הגוזל בתרא (בבא קמא דף קי"ד
Siftei Kohen on Shulchan Arukh, Yoreh De'ah 101:6:1	פרק גיד הנשה ריש דף צ"ו	פרק גיד הנשה ריש (חולין דף צ"ו)
Siftei Kohen on Shulchan Arukh, Yoreh De'ah 102:8:1	בפרק הזהב (דף נ"ג	בפרק הזהב (בבא מציעא דף נ"ג
Siftei Kohen on Shulchan Arukh, Yoreh De'ah 105:5:1	פ' דם חטאת (דף צ"ה ע"א	פ' דם חטאת (זבחים דף צ"ה ע"א
Siftei Kohen on Shulchan Arukh, Yoreh De'ah 105:5:1	פ' כירה (דף מ"ב ע"ב	' כירה (שבת דף מ"ב ע"ב
Siftei Kohen on Shulchan Arukh, Yoreh De'ah 108:1:1	פרק כיצד צולין (דף ע"ו	פרק כיצד צולין (פסחים דף ע"ו
Siftei Kohen on Shulchan Arukh, Yoreh De'ah 108:27:1	פ' לולב הגזול (דף ל"ז ע"ב	פ' לולב הגזול (סוכה דף ל"ז ע"ב
Siftei Kohen on Shulchan Arukh, Yoreh De'ah 109:3:1	פ' הערל ריש דף פ"ב	פ' הערל ריש (יבמות דף פ"ב)
Siftei Kohen on Shulchan Arukh, Yoreh De'ah 110:2:1	פ' הערל (דף פ"א	פ' הערל (יבמות דף פ"א
Siftei Kohen on Shulchan Arukh, Yoreh De'ah 110:63:17	פרק גיד הנשה דף צ"ה ע"א	פרק גיד הנשה (חולין דף צ"ה ע"א)
Siftei Kohen on Shulchan Arukh, Yoreh De'ah 110:63:20	בפרק בכל מערבין דף ל"ה	בפרק בכל מערבין (עירובין דף ל"ה)
Siftei Kohen on Shulchan Arukh, Yoreh De'ah 111:19:1	ס"פ האשה שנתארמלה (דף כ"ו	ס"פ האשה שנתארמלה (כתובות דף כ"ו
Siftei Kohen on Shulchan Arukh, Yoreh De'ah 119:18:1	פ' זה בורר (דף כ"ו ע"ב	פ' זה בורר (סנהדרין דף כ"ו ע"ב
Siftei Kohen on Shulchan Arukh, Yoreh De'ah 123:12:1	בפ' המוכר פירות (דף צ"ה	בפ' המוכר פירות (בבא בתרא דף צ"ה
Siftei Kohen on Shulchan Arukh, Yoreh De'ah 124:6:1	פרק החולץ דף מ"ח	פרק החולץ (יבמות דף מ"ח)
Siftei Kohen on Shulchan Arukh, Yoreh De'ah 124:6:1	פ' ר"י (דף נ"ז ע"ב	פ' ר"י (עבודה זרה דף נ"ז ע"ב
Siftei Kohen on Shulchan Arukh, Yoreh De'ah 124:8:1	פ' ר"י דף נ"ז ע"א	פ' ר"י (עבודה זרה דף נ"ז ע"א)
Siftei Kohen on Shulchan Arukh, Yoreh De'ah 125:3:1	פ' ר"י דף ס' ע"א	פ' ר"י (עבודה זרה דף ס' ע"א)
Siftei Kohen on Shulchan Arukh, Yoreh De'ah 127:14:2	בפרק האשה שלום (דף קי"ז	בפרק האשה שלום (יבמות דף קי"ז
Siftei Kohen on Shulchan Arukh, Yoreh De'ah 128:6:1	פרק ר"י (דף ס' ע"ב	פרק ר"י (עבודה זרה דף ס' ע"ב
Siftei Kohen on Shulchan Arukh, Yoreh De'ah 137:19:1	פ' הגוזל בתרא (דף קי"ד	פ' הגוזל בתרא (בבא קמא דף קי"ד
Siftei Kohen on Shulchan Arukh, Yoreh De'ah 139:1:1	פרק ר"י (דף נ"ג ע"ב	פרק ר"י (עבודה זרה דף נ"ג ע"ב
Siftei Kohen on Shulchan Arukh, Yoreh De'ah 139:1:1	פ' כל הצלמים (דף מ"ו	' כל הצלמים (עבודה זרה דף מ"ו
Siftei Kohen on Shulchan Arukh, Yoreh De'ah 142:2:1	בפ' כל שעה (דף כ"ז ע"ב	בפ' כל שעה (פסחים דף כ"ז ע"ב
Siftei Kohen on Shulchan Arukh, Yoreh De'ah 142:2:1	פרק כל הצלמים (דף מ"ב ע"א	רק כל הצלמים (עבודה זרה דף מ"ב ע"א
Siftei Kohen on Shulchan Arukh, Yoreh De'ah 142:10:2	בפ' כל שעה (דף כ"ו ע"ב	בפ' כל שעה (פסחים דף כ"ו ע"ב
Siftei Kohen on Shulchan Arukh, Yoreh De'ah 142:10:4	בפרק כיצד צולין (דף ע"ה ע"א	בפרק כיצד צולין (פסחים דף ע"ה ע"א
Siftei Kohen on Shulchan Arukh, Yoreh De'ah 142:32:1	בפ' כל שעה (דף כ"ה ע"ב	בפ' כל שעה (פסחים דף כ"ה ע"ב
Siftei Kohen on Shulchan Arukh, Yoreh De'ah 142:34:1	בפ' כל שעה (דף כ"ה ע"ב	בפ' כל שעה (פסחים דף כ"ה ע"ב
Siftei Kohen on Shulchan Arukh, Yoreh De'ah 151:9:1	פרק מקום שנהגו (דף נ"ג ע"א	פרק מקום שנהגו (פסחים דף נ"ג ע"א
Siftei Kohen on Shulchan Arukh, Yoreh De'ah 153:1:1	פ' מפנין (דף קכ"ז ע"ב	פ' מפנין (שבת דף קכ"ז ע"ב
Siftei Kohen on Shulchan Arukh, Yoreh De'ah 178:4:1	פרק כל הבשר (דף ק"ז	פרק כל הבשר (חולין דף ק"ז
Siftei Kohen on Shulchan Arukh, Yoreh De'ah 179:22:1	בפרק ד' מיתות (דף ס"ה ע"א	בפרק ד' מיתות (סנהדרין דף ס"ה ע"א
Siftei Kohen on Shulchan Arukh, Yoreh De'ah 182:6:1	פרק שני נזירים (דף נ"ט ע"א	פרק שני נזירים (נזיר דף נ"ט ע"א
Siftei Kohen on Shulchan Arukh, Yoreh De'ah 184:7:1	פרק תינוקת (דף ס"ה ע"ב	פרק תינוקת (נדה דף ס"ה ע"ב
Siftei Kohen on Shulchan Arukh, Yoreh De'ah 187:4:1	בפ' כל היד (דף י"ד ע"א	בפ' כל היד (נדה דף י"ד ע"א
Siftei Kohen on Shulchan Arukh, Yoreh De'ah 187:24:1	פרק כל היד (דף ט"ז ע"א	פרק כל היד (נדה דף ט"ז ע"א
Siftei Kohen on Shulchan Arukh, Yoreh De'ah 187:26:1	פרק כל היד (דף ט"ו ע"א	פרק כל היד (נדה דף ט"ו ע"א
Siftei Kohen on Shulchan Arukh, Yoreh De'ah 189:13:1	בס"פ בנות כותים דף ל"ח ע"א	בס"פ בנות כותים (נדה דף ל"ח ע"א)
Siftei Kohen on Shulchan Arukh, Yoreh De'ah 191:3:1	פרק כל היד דף י"ד ע"ב	פרק כל היד (נדה דף י"ד ע"ב)
Siftei Kohen on Shulchan Arukh, Yoreh De'ah 195:11:1	פרק הדר דף ס"ג ע"ב	פרק הדר (עירובין דף ס"ג ע"ב)
Siftei Kohen on Shulchan Arukh, Yoreh De'ah 198:61:2	בפרק ערבי פסחים (דף קי"א ע"א	בפרק ערבי פסחים (פסחים דף קי"א ע"א
Siftei Kohen on Shulchan Arukh, Yoreh De'ah 199:16:1	פ' תינוקת (דף ס"ו ע"ב	פ' תינוקת (נדה דף ס"ו ע"ב
Siftei Kohen on Shulchan Arukh, Yoreh De'ah 200:1:1	פ' מי שמתו (דף כ"ד ע"א	פ' מי שמתו (ברכות דף כ"ד ע"א
Siftei Kohen on Shulchan Arukh, Yoreh De'ah 201:144:1	פרק המוכר את הבית (דף ס"ה ע"ב	פרק המוכר את הבית (בבא בתרא דף ס"ה ע"ב
Siftei Kohen on Shulchan Arukh, Yoreh De'ah 216:1:1	פרק השותפין דף מ"ז	פרק השותפין (נדרים דף מ"ז)
Siftei Kohen on Shulchan Arukh, Yoreh De'ah 216:3:1	פרק הנודר מן הירק דף נ"ט ע"א	פרק הנודר מן הירק (נדרים דף נ"ט ע"א)
Siftei Kohen on Shulchan Arukh, Yoreh De'ah 228:9:1	פ' הדר (דף ס"ד ע"ב	פ' הדר (עירובין דף ס"ד ע"ב
Siftei Kohen on Shulchan Arukh, Yoreh De'ah 228:48:1	פ' השולח (דף ל"ה ע"ב	פ' השולח (גיטין דף ל"ה ע"ב
Siftei Kohen on Shulchan Arukh, Yoreh De'ah 228:65:1	פ' השולח ריש דף ל"ו	פ' השולח ריש (גיטין דף ל"ו)
Siftei Kohen on Shulchan Arukh, Yoreh De'ah 228:98:1	פרק נערה המאורסה סוף דף ע"ג	פרק נערה המאורסה סוף (נדרים דף ע"ג)
Siftei Kohen on Shulchan Arukh, Yoreh De'ah 232:10:1	פרק המדיר ריש דף ע"א	פרק המדיר ריש (כתובות דף ע"א)
Siftei Kohen on Shulchan Arukh, Yoreh De'ah 234:25:1	פרק נערה שנתפתתה (דף מ"ט ע"א	פרק נערה שנתפתתה (כתובות דף מ"ט ע"א
Siftei Kohen on Shulchan Arukh, Yoreh De'ah 234:48:1	בפרק השולח (דף ל"ה ע"ב	בפרק השולח (גיטין דף ל"ה ע"ב
Siftei Kohen on Shulchan Arukh, Yoreh De'ah 239:33:1	בפרק שבועות שתים (דף כ"ו	בפרק שבועות שתים (שבועות דף כ"ו
Siftei Kohen on Shulchan Arukh, Yoreh De'ah 242:10:1	בפרק הדר (ריש דף ס"ג	בפרק הדר (ריש עירובין דף ס"ג
Siftei Kohen on Shulchan Arukh, Yoreh De'ah 242:16:1	פרק הדר (דף ס"ב ע"ב	פרק הדר (עירובין דף ס"ב ע"ב
Siftei Kohen on Shulchan Arukh, Yoreh De'ah 242:17:1	ס"פ כל היד דף כ'	ס"פ כל היד (נדה דף כ')
Siftei Kohen on Shulchan Arukh, Yoreh De'ah 242:19:1	פרק הדר (דף ס"ב ע"ב	פרק הדר (עירובין דף ס"ב ע"ב
Siftei Kohen on Shulchan Arukh, Yoreh De'ah 242:42:1	בפרק הדר (סוף דף ס"ז	בפרק הדר (סוף עירובין דף ס"ז
Siftei Kohen on Shulchan Arukh, Yoreh De'ah 242:55:1	פ' אלו טריפות דף מ"ד ע"ב	פ' אלו טריפות (חולין דף מ"ד ע"ב)
Siftei Kohen on Shulchan Arukh, Yoreh De'ah 242:55:1	פ' אלו טריפות (דף מ"ט	דפ' אלו טריפות (חולין דף מ"ט
Siftei Kohen on Shulchan Arukh, Yoreh De'ah 242:58:1	פרק אחד דיני ממונות (דף ל"ג	פרק אחד דיני ממונות (סנהדרין דף ל"ג
Siftei Kohen on Shulchan Arukh, Yoreh De'ah 242:68:1	בפרק החולץ (דף ל"ו	בפרק החולץ (יבמות דף ל"ו
Siftei Kohen on Shulchan Arukh, Yoreh De'ah 242:68:1	בס"פ הערל (דף פ"א	ס"פ הערל (יבמות דף פ"א
Siftei Kohen on Shulchan Arukh, Yoreh De'ah 242:68:1	פ' אחד דיני ממונות דף ל"ו	אחד דיני ממונות (סנהדרין דף ל"ו)
Siftei Kohen on Shulchan Arukh, Yoreh De'ah 246:8:1	פרק אלו מגלחין (דף י"ז ע"א	פרק אלו מגלחין (מועד קטן דף י"ז ע"א
Siftei Kohen on Shulchan Arukh, Yoreh De'ah 246:23:1	פרק בני העיר (דף כ"ח ע"ב	פרק בני העיר (מגילה דף כ"ח ע"ב
Siftei Kohen on Shulchan Arukh, Yoreh De'ah 250:1:1	בפרק מציאת האשה (דף ס"ז	בפרק מציאת האשה (כתובות דף ס"ז
Siftei Kohen on Shulchan Arukh, Yoreh De'ah 252:6:1	פ' השולח ריש דף מ"ז	פ' השולח ריש (גיטין דף מ"ז)
Siftei Kohen on Shulchan Arukh, Yoreh De'ah 257:13:1	ס"פ כל הגט (דף ל'	ס"פ כל הגט (גיטין דף ל'
Siftei Kohen on Shulchan Arukh, Yoreh De'ah 259:14:1	בפ' אותו ואת בנו (דף עט	בפ' אותו ואת בנו (חולין דף עט
Siftei Kohen on Shulchan Arukh, Yoreh De'ah 259:14:1	בפ' מי שמת (דף קמ"ח ע"ב	פ' מי שמת (בבא בתרא דף קמ"ח ע"ב
Siftei Kohen on Shulchan Arukh, Yoreh De'ah 259:14:1	פ' הזרוע והלחיים (דף קל"ד ע"א	הזרוע והלחיים (חולין דף קל"ד ע"א
Siftei Kohen on Shulchan Arukh, Yoreh De'ah 262:2:1	ס"פ רבי ישמעאל (דף ע"ב ע"א	ס"פ רבי ישמעאל (מנחות דף ע"ב ע"א
Siftei Kohen on Shulchan Arukh, Yoreh De'ah 262:2:1	פרק רבי אליעזר דמילה (דף קל"ז ע"א	רק רבי אליעזר דמילה (שבת דף קל"ז ע"א
Siftei Kohen on Shulchan Arukh, Yoreh De'ah 266:12:1	בפ' במה מדליקין דף ל"ד ע"א	בפ' במה מדליקין (שבת דף ל"ד ע"א)
Siftei Kohen on Shulchan Arukh, Yoreh De'ah 267:37:1	פרק החובל (דף פ"ז ע"א	פרק החובל (בבא קמא דף פ"ז ע"א
Siftei Kohen on Shulchan Arukh, Yoreh De'ah 267:52:1	פ' מרובה ריש דף ע"ה	פ' מרובה ריש (בבא קמא דף ע"ה)
Siftei Kohen on Shulchan Arukh, Yoreh De'ah 267:100:1	פרק השולח (דף מ"ג ע"ב	פרק השולח (גיטין דף מ"ג ע"ב
Siftei Kohen on Shulchan Arukh, Yoreh De'ah 271:10:2	פרק המוציא יין סוף דף ע"ט	פרק המוציא יין סוף (שבת דף ע"ט)
Siftei Kohen on Shulchan Arukh, Yoreh De'ah 276:7:2	בפרק בהמה המקשה (ד' ע"ה ע"ב	בפרק בהמה המקשה (חולין ד' ע"ה ע"ב
Siftei Kohen on Shulchan Arukh, Yoreh De'ah 292:9:1	פרק אלו מציאות (דף ל"א ע"א	פרק אלו מציאות (בבא מציעא דף ל"א ע"א
Siftei Kohen on Shulchan Arukh, Yoreh De'ah 294:5:1	בפ' כיצד מברכין (דף מ'	בפ' כיצד מברכין (ברכות דף מ'
Siftei Kohen on Shulchan Arukh, Yoreh De'ah 305:19:1	פרק מרובה דף ע'	פרק מרובה (בבא קמא דף ע')
Siftei Kohen on Shulchan Arukh, Yoreh De'ah 306:15:1	פרק עד כמה (דף כ"ח ע"א	פרק עד כמה (בכורות דף כ"ח ע"א
Siftei Kohen on Shulchan Arukh, Yoreh De'ah 334:30:1	פרק אלו מגלחין ריש דף י"ז	פרק אלו מגלחין ריש (מועד קטן דף י"ז)
Siftei Kohen on Shulchan Arukh, Yoreh De'ah 340:9:1	פרק נגמר הדין [דף מ"ז ע"א	פרק נגמר הדין [סנהדרין דף מ"ז ע"א
Siftei Kohen on Shulchan Arukh, Yoreh De'ah 373:11:1	בפרק שואל ד' קנ"ב ע"ב	בפרק שואל (שבת ד' קנ"ב ע"ב)
Siftei Kohen on Shulchan Arukh, Yoreh De'ah 374:8:1	בפרק יש בכור ריש ד' מ"ט	בפרק יש בכור ריש (בכורות ד' מ"ט)
Siftei Kohen on Shulchan Arukh, Yoreh De'ah 375:2:1	פרק אלו מגלחין דף כ"ב	פרק אלו מגלחין (מועד קטן דף כ"ב)
Siftei Kohen on Shulchan Arukh, Yoreh De'ah 379:4:1	פרק שלשה שאכלו (דף מ"ט ע"א	פרק שלשה שאכלו (ברכות דף מ"ט ע"א
Beur HaGra on Shulchan Arukh, Yoreh De'ah 39:6	בפ' א"צ (כ"ה א	בפ' א"צ (ביצה כ"ה א
Beur HaGra on Shulchan Arukh, Yoreh De'ah 102:15	פ' הערל פ"ב א	פ' הערל (יבמות פ"ב א)
Beur HaGra on Shulchan Arukh, Yoreh De'ah 105:50	בפ' כיצד צולין (ע"ו א	בפ' כיצד צולין (פסחים ע"ו א
Beur HaGra on Shulchan Arukh, Yoreh De'ah 110:3	בפ' הערל פ"א א	בפ' הערל (יבמות פ"א א)
Beur HaGra on Shulchan Arukh, Yoreh De'ah 119:19	בפ' זה בורר (כ"ו ב	בפ' זה בורר (סנהדרין כ"ו ב
Beur HaGra on Shulchan Arukh, Yoreh De'ah 119:23	בפ' השולח מ"ה ב	בפ' השולח (גיטין מ"ה ב)
Beur HaGra on Shulchan Arukh, Yoreh De'ah 124:17	בפ' החולץ (מ"ז א	בפ' החולץ (יבמות מ"ז א
Beur HaGra on Shulchan Arukh, Yoreh De'ah 177:17	בפ' המקבל ק"ד ב	בפ' המקבל (בבא מציעא ק"ד ב)
Beur HaGra on Shulchan Arukh, Yoreh De'ah 179:26	פ' חלק (ק"א א	פ' חלק (סנהדרין ק"א א
Beur HaGra on Shulchan Arukh, Yoreh De'ah 230:5	בפרק האשה שנפלו (פ"א ב	בפרק האשה שנפלו (כתובות פ"א ב
Beur HaGra on Shulchan Arukh, Yoreh De'ah 263:10	בפ' חלק ק"י ב	בפ' חלק (סנהדרין ק"י ב)
Beur HaGra on Shulchan Arukh, Yoreh De'ah 267:68	בפ' הכותב (פ"ד ב	בפ' הכותב (כתובות פ"ד ב
Turei Zahav on Shulchan Arukh, Yoreh De'ah 1:1	פרק כל הפסולין (דף לא	פרק כל הפסולין (זבחים דף לא
Turei Zahav on Shulchan Arukh, Yoreh De'ah 2:14	בפרק השוחט (דף מ'	בפרק השוחט (חולין דף מ'
Turei Zahav on Shulchan Arukh, Yoreh De'ah 14:6	בפרק בהמה המקשה (דף ס"ט	בפרק בהמה המקשה (חולין דף ס"ט
Turei Zahav on Shulchan Arukh, Yoreh De'ah 15:2	פרק ר"א דמילה (דף קל"ו	פרק ר"א דמילה (שבת דף קל"ו
Turei Zahav on Shulchan Arukh, Yoreh De'ah 24:4	בפרק בהמה המקשה (דף עד	בפרק בהמה המקשה (חולין דף עד
Turei Zahav on Shulchan Arukh, Yoreh De'ah 24:10	פרק בהמה המקשה (דף ס"ט	פרק בהמה המקשה (חולין דף ס"ט
Turei Zahav on Shulchan Arukh, Yoreh De'ah 27:1	פרק השוחט (דף כ"ח	פרק השוחט (חולין דף כ"ח
Turei Zahav on Shulchan Arukh, Yoreh De'ah 27:1	בפרק השוחט (דף ל"ב	פרק השוחט (חולין דף ל"ב
Turei Zahav on Shulchan Arukh, Yoreh De'ah 33:12	פרק השוחט (ד' כ"ח	פרק השוחט (חולין ד' כ"ח
Turei Zahav on Shulchan Arukh, Yoreh De'ah 55:6	פרק בהמה המקשה (דף ע"ד	פרק בהמה המקשה (חולין דף ע"ד
Turei Zahav on Shulchan Arukh, Yoreh De'ah 61:22	בפ' הזרוע (דף קל"ב	בפ' הזרוע (חולין דף קל"ב
Turei Zahav on Shulchan Arukh, Yoreh De'ah 63:3	בפרק אין מעמידין (דף ל"ט	בפרק אין מעמידין (עבודה זרה דף ל"ט
Turei Zahav on Shulchan Arukh, Yoreh De'ah 69:17	פרק השוחט (דף ל"ג	פרק השוחט (חולין דף ל"ג
Turei Zahav on Shulchan Arukh, Yoreh De'ah 69:17	פרק השוחט (דף ל"ו	רק השוחט (חולין דף ל"ו
Turei Zahav on Shulchan Arukh, Yoreh De'ah 82:7	בפ' שילוח הקן (דף קל"ט	בפ' שילוח הקן (חולין דף קל"ט
Turei Zahav on Shulchan Arukh, Yoreh De'ah 87:13	בפרק כל הצלמים (דף מ"ט	בפרק כל הצלמים (עבודה זרה דף מ"ט
Turei Zahav on Shulchan Arukh, Yoreh De'ah 93:1	פרק כל שעה דף ל'	פרק כל שעה (פסחים דף ל')
Turei Zahav on Shulchan Arukh, Yoreh De'ah 93:2	פרק אין מעמידין דף ל"ג	פרק אין מעמידין (עבודה זרה דף ל"ג)
Turei Zahav on Shulchan Arukh, Yoreh De'ah 93:2	פרק המפקיד (דף מ'	מפרק המפקיד (בבא מציעא דף מ'
Turei Zahav on Shulchan Arukh, Yoreh De'ah 94:13	פרק כיצד צולין (דף ע"ו	פרק כיצד צולין (פסחים דף ע"ו
Turei Zahav on Shulchan Arukh, Yoreh De'ah 99:9	בפרק הניזקין (דף נ"ג	בפרק הניזקין (גיטין דף נ"ג
Turei Zahav on Shulchan Arukh, Yoreh De'ah 102:5	פרק הנודר מן המבושל (דף נ"ב	פרק הנודר מן המבושל (נדרים דף נ"ב
Turei Zahav on Shulchan Arukh, Yoreh De'ah 110:5	בפרק חבית (דף קמ"ז	בפרק חבית (שבת דף קמ"ז
Turei Zahav on Shulchan Arukh, Yoreh De'ah 110:9	פ' גיד הנשה (דף ק'	פ' גיד הנשה (חולין דף ק'
Turei Zahav on Shulchan Arukh, Yoreh De'ah 110:15	פרק ד' אחין דף ל'	פרק ד' אחין (יבמות דף ל')
Turei Zahav on Shulchan Arukh, Yoreh De'ah 111:1	בפרק הערל (דף פ"ב	בפרק הערל (יבמות דף פ"ב
Turei Zahav on Shulchan Arukh, Yoreh De'ah 111:7	פרק הערל דף פ"ב	פרק הערל (יבמות דף פ"ב)
Turei Zahav on Shulchan Arukh, Yoreh De'ah 112:9	בפ' אין מעמידין (דף ל"ה	בפ' אין מעמידין (עבודה זרה דף ל"ה
Turei Zahav on Shulchan Arukh, Yoreh De'ah 116:1	בפרק הגוזל בתרא דף קט"ו	בפרק הגוזל בתרא (בבא קמא דף קט"ו)
Turei Zahav on Shulchan Arukh, Yoreh De'ah 117:1	בפרק כל שעה (דף כ"ג	בפרק כל שעה (פסחים דף כ"ג
Turei Zahav on Shulchan Arukh, Yoreh De'ah 117:1	בפרק לולב הגזול (דף ל"ט	פרק לולב הגזול (סוכה דף ל"ט
Turei Zahav on Shulchan Arukh, Yoreh De'ah 117:2	בפרק לולב הגזול (דף ל"ט	בפרק לולב הגזול (סוכה דף ל"ט
Turei Zahav on Shulchan Arukh, Yoreh De'ah 117:4	פ' השוחט (דף כ"ח	פ' השוחט (חולין דף כ"ח
Turei Zahav on Shulchan Arukh, Yoreh De'ah 117:4	בפ' היה קורא (דף י"ד	פ' היה קורא (ברכות דף י"ד
Turei Zahav on Shulchan Arukh, Yoreh De'ah 119:7	בפרק עד כמה [דף ל'	בפרק עד כמה (בכורות דף ל')
Turei Zahav on Shulchan Arukh, Yoreh De'ah 119:17	בפרק עד כמה (דף ל'	בפרק עד כמה (בכורות דף ל'
Turei Zahav on Shulchan Arukh, Yoreh De'ah 119:18	בפרק הניזקין (דף ס"א	בפרק הניזקין (גיטין דף ס"א
Turei Zahav on Shulchan Arukh, Yoreh De'ah 120:11	בפ' הגוזל בתרא (דף קי"ג	בפ' הגוזל בתרא (בבא קמא דף קי"ג
Turei Zahav on Shulchan Arukh, Yoreh De'ah 120:14	פ' כל שעה (דף ל"א	פ' כל שעה (פסחים דף ל"א
Turei Zahav on Shulchan Arukh, Yoreh De'ah 121:7	פ' דם חטאת (דף צ"ו	פ' דם חטאת (זבחים דף צ"ו
Turei Zahav on Shulchan Arukh, Yoreh De'ah 123:8	בפרק כל הבשר (דף ק"י	בפרק כל הבשר (חולין דף ק"י
Turei Zahav on Shulchan Arukh, Yoreh De'ah 124:2	פ' ר"י ד' נ"ז	פ' ר"י (עבודה זרה ד' נ"ז)
Turei Zahav on Shulchan Arukh, Yoreh De'ah 124:9	בפרק ר"י דף נ"ט	בפרק ר"י (עבודה זרה דף נ"ט)
Turei Zahav on Shulchan Arukh, Yoreh De'ah 124:32	פרק ר"י (דף נ"ח	פרק ר"י (עבודה זרה דף נ"ח
Turei Zahav on Shulchan Arukh, Yoreh De'ah 125:1	בפ' ר' ישמעאל (דף ס'	בפ' ר' ישמעאל (עבודה זרה דף ס'
Turei Zahav on Shulchan Arukh, Yoreh De'ah 125:1	פ' רבי ישמעאל (דף ס'	' רבי ישמעאל (עבודה זרה דף ס'
Turei Zahav on Shulchan Arukh, Yoreh De'ah 125:1	בפרק ר"י דף ס'	רק ר"י (עבודה זרה דף ס')
Turei Zahav on Shulchan Arukh, Yoreh De'ah 127:7	פרק החולץ (דף מ"ו	פרק החולץ (יבמות דף מ"ו
Turei Zahav on Shulchan Arukh, Yoreh De'ah 141:5	פ' כל הצלמים דף מ"ב	פ' כל הצלמים (עבודה זרה דף מ"ב)
Turei Zahav on Shulchan Arukh, Yoreh De'ah 141:5	פרק כל הצלמים (דף מ"ב	פרק כל הצלמים (עבודה זרה דף מ"ב
Turei Zahav on Shulchan Arukh, Yoreh De'ah 142:3	בפרק כל שעה (דף כ"ז	בפרק כל שעה (פסחים דף כ"ז
Turei Zahav on Shulchan Arukh, Yoreh De'ah 142:4	בפרק כל שעה (דף ל"ט	בפרק כל שעה (פסחים דף ל"ט
Turei Zahav on Shulchan Arukh, Yoreh De'ah 145:3	בפרק ר' ישמעאל (דף נ"ט	בפרק ר' ישמעאל (עבודה זרה דף נ"ט
Turei Zahav on Shulchan Arukh, Yoreh De'ah 145:3	בפרק כל הצלמים (דף מ"ז	פרק כל הצלמים (עבודה זרה דף מ"ז
Turei Zahav on Shulchan Arukh, Yoreh De'ah 145:5	פ' ר' ישמעאל (דף נ"ב	פ' ר' ישמעאל (עבודה זרה דף נ"ב
Turei Zahav on Shulchan Arukh, Yoreh De'ah 148:3	פרק ארבע מיתות (דף ס'	פרק ארבע מיתות (סנהדרין דף ס'
Turei Zahav on Shulchan Arukh, Yoreh De'ah 151:9	פרק הניזקין (דף ס"א	פרק הניזקין (גיטין דף ס"א
Turei Zahav on Shulchan Arukh, Yoreh De'ah 152:3	בפ' איזהו נשך (דף ע"ג	בפ' איזהו נשך (בבא מציעא דף ע"ג
Turei Zahav on Shulchan Arukh, Yoreh De'ah 153:1	בפרק הגוזל (דף צ"ו	בפרק הגוזל (בבא קמא דף צ"ו
Turei Zahav on Shulchan Arukh, Yoreh De'ah 153:3	פרק מקום שנהגו (דף נ"א	פרק מקום שנהגו (פסחים דף נ"א
Turei Zahav on Shulchan Arukh, Yoreh De'ah 158:1	פרק ארבע מיתות (דף נ"ו	פרק ארבע מיתות (סנהדרין דף נ"ו
Turei Zahav on Shulchan Arukh, Yoreh De'ah 158:1	בפרק אין מעמידין (דף כ"ו	פרק אין מעמידין (עבודה זרה דף כ"ו
Turei Zahav on Shulchan Arukh, Yoreh De'ah 160:11	בפ' איזהו נשך (דף ע'	בפ' איזהו נשך (בבא מציעא דף ע'
Turei Zahav on Shulchan Arukh, Yoreh De'ah 172:2	בפרק לא יחפור (דף כ'	בפרק לא יחפור (בבא בתרא דף כ'
Turei Zahav on Shulchan Arukh, Yoreh De'ah 175:6	בפרק המפקיד (דף מ'	בפרק המפקיד (בבא מציעא דף מ'
Turei Zahav on Shulchan Arukh, Yoreh De'ah 177:9	בפרק המקבל (דף ק"ד	בפרק המקבל (בבא מציעא דף ק"ד
Turei Zahav on Shulchan Arukh, Yoreh De'ah 184:2	פרק תינוקת (דף ס"ה	פרק תינוקת (נדה דף ס"ה
Turei Zahav on Shulchan Arukh, Yoreh De'ah 190:17	פרק הרואה (דף נ"ח	פרק הרואה (ברכות דף נ"ח
Turei Zahav on Shulchan Arukh, Yoreh De'ah 220:15	פרק אלו נאמרין (דף מ"א	פרק אלו נאמרין (סוטה דף מ"א
Turei Zahav on Shulchan Arukh, Yoreh De'ah 221:36	פרק המדיר דף ע'	פרק המדיר (כתובות דף ע')
Turei Zahav on Shulchan Arukh, Yoreh De'ah 221:42	פרק האורג (דף ק"ו	פרק האורג (שבת דף ק"ו
Turei Zahav on Shulchan Arukh, Yoreh De'ah 228:19	בפרק שום היתומים (דף כ"ג	בפרק שום היתומים (ערכין דף כ"ג
Turei Zahav on Shulchan Arukh, Yoreh De'ah 234:14	בפרק נערה שנתפתתה (דף מ"ט	בפרק נערה שנתפתתה (כתובות דף מ"ט
Turei Zahav on Shulchan Arukh, Yoreh De'ah 234:14	פ' נערה שנתפתתה (דף מ"ח	' נערה שנתפתתה (כתובות דף מ"ח
Turei Zahav on Shulchan Arukh, Yoreh De'ah 234:63	פרק השולח (דף מ'	פרק השולח (גיטין דף מ'
Turei Zahav on Shulchan Arukh, Yoreh De'ah 235:7	פ' המדיר (דף ע"א	פ' המדיר (כתובות דף ע"א
Turei Zahav on Shulchan Arukh, Yoreh De'ah 244:7	פ' מצות חליצה (דף ק"ה	פ' מצות חליצה (יבמות דף ק"ה
Turei Zahav on Shulchan Arukh, Yoreh De'ah 246:7	בפ' אלו נאמרים דף מ'	בפ' אלו נאמרים (סוטה דף מ')
Turei Zahav on Shulchan Arukh, Yoreh De'ah 251:1	בפ' הכותב (דף פ"ה	בפ' הכותב (כתובות דף פ"ה
Turei Zahav on Shulchan Arukh, Yoreh De'ah 266:1	פרק אין צדין (דף כ"ח	פרק אין צדין (ביצה דף כ"ח
Turei Zahav on Shulchan Arukh, Yoreh De'ah 266:1	בפרק אין צדין (דף כ"ו	פרק אין צדין (ביצה דף כ"ו
Turei Zahav on Shulchan Arukh, Yoreh De'ah 266:7	בפ' הערל דף פ'	בפ' הערל (יבמות דף פ')
Turei Zahav on Shulchan Arukh, Yoreh De'ah 266:7	בפ' רבי אליעזר דמילה דף קל"ה	בפ' רבי אליעזר דמילה (שבת דף קל"ה)
Turei Zahav on Shulchan Arukh, Yoreh De'ah 267:14	בפ' השולח (דף מ"ב	בפ' השולח (גיטין דף מ"ב
Turei Zahav on Shulchan Arukh, Yoreh De'ah 267:18	בפ' השולח (דף מ"א	בפ' השולח (גיטין דף מ"א
Turei Zahav on Shulchan Arukh, Yoreh De'ah 271:8	פרק עגלה ערופה דף מ"ח	פרק עגלה ערופה (סוטה דף מ"ח)
Turei Zahav on Shulchan Arukh, Yoreh De'ah 276:9	פ' שבועת העדות (דף ל"ה	פ' שבועת העדות (שבועות דף ל"ה
Turei Zahav on Shulchan Arukh, Yoreh De'ah 278:2	בפרק העור והרוטב (ד' קכ"ג	בפרק העור והרוטב (חולין ד' קכ"ג
Turei Zahav on Shulchan Arukh, Yoreh De'ah 282:4	בפרק בכל מערבין (דף ל'	בפרק בכל מערבין (עירובין דף ל'
Turei Zahav on Shulchan Arukh, Yoreh De'ah 301:6	בפרק כל שעה (דף כ"ו	בפרק כל שעה (פסחים דף כ"ו
Turei Zahav on Shulchan Arukh, Yoreh De'ah 305:7	בפ' מי שאחזו (דף ע"ב	בפ' מי שאחזו (גיטין דף ע"ב
Turei Zahav on Shulchan Arukh, Yoreh De'ah 305:11	פ' אין בין המודר (דף ל"ו	פ' אין בין המודר (נדרים דף ל"ו
Turei Zahav on Shulchan Arukh, Yoreh De'ah 305:14	בפרק יש בכור (דף מ"ט	בפרק יש בכור (בכורות דף מ"ט
Turei Zahav on Shulchan Arukh, Yoreh De'ah 305:19	בפרק המפלת (דף כ"ג	בפרק המפלת (נדה דף כ"ג
Turei Zahav on Shulchan Arukh, Yoreh De'ah 305:20	בפרק יש בכור דף מ"ז:	בפרק יש בכור (בכורות דף מ"ז:)
Turei Zahav on Shulchan Arukh, Yoreh De'ah 310:3	פ' החובל (דף צ"א	פ' החובל (בבא קמא דף צ"א
Turei Zahav on Shulchan Arukh, Yoreh De'ah 316:4	פרק הניזקין דף נ"ז	פרק הניזקין (גיטין דף נ"ז)
Turei Zahav on Shulchan Arukh, Yoreh De'ah 323:2	בפרק הנודר מן הירק (דף נ"ט	בפרק הנודר מן הירק (נדרים דף נ"ט
Turei Zahav on Shulchan Arukh, Yoreh De'ah 323:2	בפרק יש נוחלין דף ק"ך ע"ב	פרק יש נוחלין (בבא בתרא דף ק"ך ע"ב)
Turei Zahav on Shulchan Arukh, Yoreh De'ah 324:15	בפ' גיד הנשה (דף צ"ח	בפ' גיד הנשה (חולין דף צ"ח
Turei Zahav on Shulchan Arukh, Yoreh De'ah 326:2	פרק כל הגט (דף ל'	פרק כל הגט (גיטין דף ל'
Turei Zahav on Shulchan Arukh, Yoreh De'ah 327:1	פ' האיש מקדש (דף מ"ו	פ' האיש מקדש (קידושין דף מ"ו
Turei Zahav on Shulchan Arukh, Yoreh De'ah 329:5	בפרק במה מדליקין (דף כ"ג	בפרק במה מדליקין (שבת דף כ"ג
Turei Zahav on Shulchan Arukh, Yoreh De'ah 331:32	בפרק הזרוע דף קל"א	בפרק הזרוע (חולין דף קל"א)
Turei Zahav on Shulchan Arukh, Yoreh De'ah 334:1	בפרק עשרה יוחסין (דף ע"ב	בפרק עשרה יוחסין (קידושין דף ע"ב
Turei Zahav on Shulchan Arukh, Yoreh De'ah 334:1	פ' השולח (ד' ל"ח	' השולח (גיטין ד' ל"ח
Turei Zahav on Shulchan Arukh, Yoreh De'ah 336:1	פרק הרואה (דף ס"ב	פרק הרואה (ברכות דף ס"ב
Turei Zahav on Shulchan Arukh, Yoreh De'ah 342:1	בפרק טבול יום דף ק'	בפרק טבול יום (זבחים דף ק')
Turei Zahav on Shulchan Arukh, Yoreh De'ah 371:3	בפרק לא יחפור סוף דף י"ט	בפרק לא יחפור סוף (בבא בתרא דף י"ט)
Turei Zahav on Shulchan Arukh, Yoreh De'ah 371:3	בפרק לא יחפור דף י"ט	בפרק לא יחפור (בבא בתרא דף י"ט)
Turei Zahav on Shulchan Arukh, Yoreh De'ah 371:3	בפרק במה בהמה דף נ"ב	א בפרק במה בהמה (שבת דף נ"ב)
Turei Zahav on Shulchan Arukh, Yoreh De'ah 371:3	פרק לא יחפור דף י"ט	ס' פרק לא יחפור (בבא בתרא דף י"ט)
Turei Zahav on Shulchan Arukh, Yoreh De'ah 371:5	בפרק הישן דף כ"ב	בפרק הישן (סוכה דף כ"ב)
Turei Zahav on Shulchan Arukh, Yoreh De'ah 376:6	בפרק נגמר הדין דף מ"ז:	בפרק נגמר הדין (סנהדרין דף מ"ז:)
Turei Zahav on Shulchan Arukh, Yoreh De'ah 381:1	בפרק חבית (דף קמ"ו	בפרק חבית (שבת דף קמ"ו
Turei Zahav on Shulchan Arukh, Yoreh De'ah 396:2	בפרק נגמר הדין (דף מ"ז	בפרק נגמר הדין (סנהדרין דף מ"ז
Turei Zahav on Shulchan Arukh, Yoreh De'ah 396:2	פרק הישן (דף כ"ז	רק הישן (סוכה דף כ"ז
Turei Zahav on Shulchan Arukh, Yoreh De'ah 397:2	פרק המדיר (דף ע"ז	פרק המדיר (כתובות דף ע"ז
Turei Zahav on Shulchan Arukh, Yoreh De'ah 398:2	בפרק טבול יום (דף ק'	בפרק טבול יום (זבחים דף ק'
Turei Zahav on Shulchan Arukh, Yoreh De'ah 399:4	בפ' אלו מגלחין (דף כ"ד	בפ' אלו מגלחין (מועד קטן דף כ"ד
Pithei Teshuva on Shulchan Arukh, Yoreh De'ah 155:8	פרק המצניע דף צ"ה	פרק המצניע (שבת דף צ"ה)
Pithei Teshuva on Shulchan Arukh, Yoreh De'ah 179:6	פ' חלק ד' ק"ח	פ' חלק (סנהדרין ד' ק"ח)
Pithei Teshuva on Shulchan Arukh, Yoreh De'ah 232:1	בפ' ארבעה נדרים דף כ"ג ע"א	בפ' ארבעה נדרים (נדרים דף כ"ג ע"א)
Pithei Teshuva on Shulchan Arukh, Yoreh De'ah 308:2	בפ' ראשית הגז דף קל"ז ע"ב	בפ' ראשית הגז (חולין דף קל"ז ע"ב)
Pithei Teshuva on Shulchan Arukh, Yoreh De'ah 339:1	פ' אין מעמידין כ"ז ע"ב	פ' אין מעמידין (עבודה זרה כ"ז ע"ב)
Pithei Teshuva on Shulchan Arukh, Yoreh De'ah 340:3	פרק האורג דף ק"ה ע"ב	פרק האורג (שבת דף ק"ה ע"ב)
Pithei Teshuva on Shulchan Arukh, Yoreh De'ah 372:2	בפ' המקבל דף קי"א	בפ' המקבל (בבא מציעא דף קי"א)
Pithei Teshuva on Shulchan Arukh, Yoreh De'ah 374:8	פ' ר"א דמילה קל"ו ע"א	פ' ר"א דמילה (שבת קל"ו ע"א)
Torat HaShlamim on Shulchan Arukh, Yoreh De'ah 192:6	פ' ד' אחין דף ל"ג	פ' ד' אחין (יבמות דף ל"ג)
Nekudat HaKesef on Shulchan Arukh, Yoreh De'ah 33:1	פרק העור והרוטב דף קכ"א ע"ב	פרק העור והרוטב (חולין דף קכ"א ע"ב)
Nekudat HaKesef on Shulchan Arukh, Yoreh De'ah 63:1	פ' גיד הנשה ריש דף צ"ו	פ' גיד הנשה ריש (חולין דף צ"ו)
Nekudat HaKesef on Shulchan Arukh, Yoreh De'ah 63:1	פ' כל הגט דף כ"ז ע"ב	ופ' כל הגט (גיטין דף כ"ז ע"ב)
Nekudat HaKesef on Shulchan Arukh, Yoreh De'ah 82:1	בפ' הניזקין סוף דף נ"ו	בפ' הניזקין סוף (גיטין דף נ"ו)
Nekudat HaKesef on Shulchan Arukh, Yoreh De'ah 87:5	בפ' כל הבשר דף ק"ט ע"א	בפ' כל הבשר (חולין דף ק"ט ע"א)
Nekudat HaKesef on Shulchan Arukh, Yoreh De'ah 93:3	בפ' אין מעמידין דף ל"ג ע"ב	בפ' אין מעמידין (עבודה זרה דף ל"ג ע"ב)
Nekudat HaKesef on Shulchan Arukh, Yoreh De'ah 105:2	פרק דם חטאת דף צ"ה ע"ב	פרק דם חטאת (זבחים דף צ"ה ע"ב)
Nekudat HaKesef on Shulchan Arukh, Yoreh De'ah 117:2	ס"פ בנות כותים דף ל"ב ע"א	ס"פ בנות כותים (נדה דף ל"ב ע"א)
Nekudat HaKesef on Shulchan Arukh, Yoreh De'ah 124:16	פרק גיד הנשה דף צ"ו	פרק גיד הנשה (חולין דף צ"ו)
Nekudat HaKesef on Shulchan Arukh, Yoreh De'ah 142:1	פרק כל הצלמים דף מ"ט ע"א	פרק כל הצלמים (עבודה זרה דף מ"ט ע"א)
Nekudat HaKesef on Shulchan Arukh, Yoreh De'ah 142:1	בפרק כל שעה דף כ"ז	בפרק כל שעה (פסחים דף כ"ז)
Nekudat HaKesef on Shulchan Arukh, Yoreh De'ah 145:1	בפרק כל הצלמים דף מ"ז	בפרק כל הצלמים (עבודה זרה דף מ"ז)
Nekudat HaKesef on Shulchan Arukh, Yoreh De'ah 162:4	בפרק האיש מקדש דף מ"ב ע"א	בפרק האיש מקדש (קידושין דף מ"ב ע"א)
Nekudat HaKesef on Shulchan Arukh, Yoreh De'ah 197:1	פרק המפלת דף ל'	פרק המפלת (נדה דף ל')
Nekudat HaKesef on Shulchan Arukh, Yoreh De'ah 197:1	בפרק כל כתבי דף קכ"א	דבפרק כל כתבי (שבת דף קכ"א)
Nekudat HaKesef on Shulchan Arukh, Yoreh De'ah 197:1	פרק שמנה שרצים דף קי"א ע"א	ופרק שמנה שרצים (שבת דף קי"א ע"א)
Nekudat HaKesef on Shulchan Arukh, Yoreh De'ah 198:1	בפ' המצניע דף צ"ג	בפ' המצניע (שבת דף צ"ג)
Nekudat HaKesef on Shulchan Arukh, Yoreh De'ah 216:1	פרק השותפין דף מ"ו ע"ב	פרק השותפין (נדרים דף מ"ו ע"ב)
Nekudat HaKesef on Shulchan Arukh, Yoreh De'ah 234:4	בפ' השותפין דף מ"ז	בפ' השותפין (נדרים דף מ"ז)
Nekudat HaKesef on Shulchan Arukh, Yoreh De'ah 282:1	פ' הקומץ דף ל"ב ע"ב	פ' הקומץ (מנחות דף ל"ב ע"ב)
Nekudat HaKesef on Shulchan Arukh, Yoreh De'ah 293:1	פרק הערל דף פ"ג ע"א	פרק הערל (יבמות דף פ"ג ע"א)
Nekudat HaKesef on Shulchan Arukh, Yoreh De'ah 293:2	פרק רבי ישמעאל דף ס"ד ע"ב	פרק רבי ישמעאל (מנחות דף ס"ד ע"ב)
Nekudat HaKesef on Shulchan Arukh, Yoreh De'ah 305:1	פרק האיש מקדש דף מ"ב	פרק האיש מקדש (קידושין דף מ"ב)
Nekudat HaKesef on Shulchan Arukh, Yoreh De'ah 305:1	פרק התקבל סוף ד' ס"ד	פרק התקבל סוף (גיטין ד' ס"ד)
Nekudat HaKesef on Shulchan Arukh, Yoreh De'ah 326:1	פרק אלו עוברין דף מ"ו ע"ב	פרק אלו עוברין (פסחים דף מ"ו ע"ב)
Tosafot Rid on Ketubot 11a:1	פרק החולץ [דף מו	פרק החולץ (יבמות דף מו)
Tosafot Rid on Ketubot 52b:1	פרק השולח [דף מה	פרק השולח (גיטין דף מה)
Tosafot Rid on Ketubot 87a:1	בפ' כל הנשבעין (דף מח	בפ' כל הנשבעין (שבועות דף מח
Torat HaOlah, Part One 12:1	פרק כיצד צולין (פו א	פרק כיצד צולין (פסחים פו א
Torat HaOlah, Part One 13:10	פרק איזהו מקומן (נג ב	פרק איזהו מקומן (זבחים נג ב
Torat HaOlah, Part One 15:1	פרק הקומץ (כח ב	פרק הקומץ (מנחות כח ב
Torat HaOlah, Part One 16:2	פרק הקומץ (כט א	פרק הקומץ (מנחות כט א
Torat HaOlah, Part One 16:4	פרק זה בורר (כד א	פרק זה בורר (סנהדרין כד א
Torat HaOlah, Part One 16:5	פרק חבית (קמה ב	פרק חבית (שבת קמה ב
Torat HaOlah, Part One 22:9	פרק השוכר את הפועלים (פו א	פרק השוכר את הפועלים (בבא מציעא פו א
Torat HaOlah, Part Two 2:6	פרק חלק (צב ב	פרק חלק (סנהדרין צב ב
Torat HaOlah, Part Two 25:4	פרק אלו נאמרים (לב ב	פרק אלו נאמרים (סוטה לב ב
Torat HaOlah, Part Two 40:1	פרק המזבח מקדש (פח ב	פרק המזבח מקדש (זבחים פח ב
Torat HaOlah, Part Two 40:1	פרק יש בערכין (טז א	רק יש בערכין (ערכין טז א
Torat HaOlah, Part Two 48:4	פרק המקבל (קו ב	פרק המקבל (בבא מציעא קו ב
Torat HaOlah, Part Three 5:1	פרק גיד הנשה (צ ב	פרק גיד הנשה (חולין צ ב
Torat HaOlah, Part Three 27:6	פרק מי שהיה טמא (צד א	פרק מי שהיה טמא (פסחים צד א
Torat HaOlah, Part Three 27:7	פרק אין דורשין (טו א	פרק אין דורשין (חגיגה טו א
Torat HaOlah, Part Three 28:1	פרק מי שהוציאוהו (מה ב	פרק מי שהוציאוהו (עירובין מה ב
Torat HaOlah, Part Three 39:7	פרק חומר בקודש (כו א	פרק חומר בקודש (חגיגה כו א
Torat HaOlah, Part Three 47:2	פרק מקום שנהגו (נד א	פרק מקום שנהגו (פסחים נד א
Torat HaOlah, Part Three 47:18	פרק במה בהמה (נו ב	פרק במה בהמה (שבת נו ב
Beur Reuven on Bava Kamma 2a:57	פרק הכונס (נה:	פרק הכונס (בבא קמא נה:
Beur Reuven on Bava Kamma 35a:13	בפרק הנשרפין (עט:	בפרק הנשרפין (סנהדרין עט:
Petach Einayim on Sanhedrin 20a:2	פרק בא לו דף ע"א	פרק בא לו (יומא דף ע"א)
Petach Einayim on Sanhedrin 26a:4	בפרק חלק דף ק"ז.	בפרק חלק (סנהדרין דף ק"ז.)
Petach Einayim on Sanhedrin 59a:2	פרק חזקת דף נ"ח	פרק חזקת (בבא בתרא דף נ"ח)
Petach Einayim on Sanhedrin 59b:2	פרק אחד דיני ממונות דף ל"ח	פרק אחד דיני ממונות (סנהדרין דף ל"ח)
Petach Einayim on Sanhedrin 69b:1	פרק ערבי פסחים דף קי"ב	פרק ערבי פסחים (פסחים דף קי"ב)
Petach Einayim on Sanhedrin 98b:1	פרק מצות חליצה דף ק"ה.	פרק מצות חליצה (יבמות דף ק"ה.)
Petach Einayim on Sanhedrin 107a:4	בפרק הזהב דף נ"ט	בפרק הזהב (בבא מציעא דף נ"ט)
Petach Einayim on Bava Metzia 23b:1	ס"פ המדיר דף ע"ז	ס"פ המדיר (כתובות דף ע"ז)
Petach Einayim on Avodah Zarah 18b:1	פרק חלק דף ק"א ע"ב	פרק חלק (סנהדרין דף ק"א ע"ב)
Petach Einayim on Avodah Zarah 22b:2	פרק חלק דף ק"ח	פרק חלק (סנהדרין דף ק"ח)
Petach Einayim on Shevuot 15b:2	פרק חלק דף ק"א	פרק חלק (סנהדרין דף ק"א)
Petach Einayim on Bava Batra 10b:3	בפרק חזקת דף מ"ח	בפרק חזקת (בבא בתרא דף מ"ח)
Petach Einayim on Bava Batra 93b:1	פרק חזקת דף ל"ו	פרק חזקת (בבא בתרא דף ל"ו)
Petach Einayim on Bava Batra 119a:1	פרק לולב הגזול דף ל"ג	פרק לולב הגזול (סוכה דף ל"ג)
Petach Einayim on Niddah 8b:1	פרק בן סורר דף ס"ט	פרק בן סורר (סנהדרין דף ס"ט)
Petach Einayim on Niddah 16b:2	פרק חלק דף צ"ו	פרק חלק (סנהדרין דף צ"ו)
Petach Einayim on Meilah 17b:2	פרק חלק דף צ"ד	פרק חלק (סנהדרין דף צ"ד)
Petach Einayim on Arakhin 18a:3	פרק השג יד דף י"ח.	פרק השג יד (ערכין דף י"ח.)
Petach Einayim on Arakhin 18a:3	פרק המקבל דף קי"ד	פרק המקבל (בבא מציעא דף קי"ד)
Petach Einayim on Chullin 44b:2	פרק כיצד מברכין (דף מ"ד	פרק כיצד מברכין (ברכות דף מ"ד
Petach Einayim on Chullin 87a:1	פרק החובל דף צ"א	פרק החובל (בבא קמא דף צ"א)
Petach Einayim on Keritot 7b:2	פרק כל היד דף ט"ו	פרק כל היד (נדה דף ט"ו)
Petach Einayim on Menachot 29b:5	פרק הבונה דף ק"ד	פרק הבונה (שבת דף ק"ד)
Petach Einayim on Menachot 99b:1	פרק כיצד מברכין דף ל"ה	פרק כיצד מברכין (ברכות דף ל"ה)
Petach Einayim on Bava Kamma 3b:1	פרק כל כתבי דף קט"ו ע"א	פרק כל כתבי (שבת דף קט"ו ע"א)
Petach Einayim on Bava Kamma 70b:1	פרק חזקת דף נ"ו	פרק חזקת (בבא בתרא דף נ"ו)
Petach Einayim on Bava Kamma 105b:1	פרק שבועת הפקדון דף ל"ז	פרק שבועת הפקדון (שבועות דף ל"ז)
Petach Einayim on Bava Kamma 116a:1	פרק אלו מציאות דף ל'	פרק אלו מציאות (בבא מציעא דף ל')
Petach Einayim on Makkot 10a:3	פרק במה מדליקין דף כ"ג	פרק במה מדליקין (שבת דף כ"ג)
Petach Einayim on Makkot 24a:1	פרק איזהו נשך ריש דף ע"א	פרק איזהו נשך ריש (בבא מציעא דף ע"א)
Petach Einayim on Makkot 24a:1	פרק איזהו נשך ריש דף ע"א	פרק איזהו נשך ריש (בבא מציעא דף ע"א)
Petach Einayim on Yevamot 60b:1	פ' חלק דף ק"ו ע"ב	פ' חלק (סנהדרין דף ק"ו ע"ב)
Petach Einayim on Rosh Hashanah 21a:1	פרק אלו מציאות דף כ"ח	פרק אלו מציאות (בבא מציעא דף כ"ח)
Petach Einayim on Rosh Hashanah 22a:2	פרק חבית דף קמ"ה	פרק חבית (שבת דף קמ"ה)
Petach Einayim on Rosh Hashanah 22b:1	פרק כל הצלמים דף מ"ד ע"א	פרק כל הצלמים (עבודה זרה דף מ"ד ע"א)
Petach Einayim on Pesachim 113a:1	פ' הזהב דף מ"ט	פ' הזהב (בבא מציעא דף מ"ט)
Petach Einayim on Pesachim 119a:1	בפ' חלק דף ק"ז	בפ' חלק (סנהדרין דף ק"ז)
Petach Einayim on Eruvin 3a:3	פ' הבא על יבמתו דף נ"ו	פ' הבא על יבמתו (יבמות דף נ"ו)
Petach Einayim on Eruvin 3b:2	פ' אלו טריפות דף מ"ז ע"ב	פ' אלו טריפות (חולין דף מ"ז ע"ב)
Petach Einayim on Eruvin 63a:2	פ' יש נוחלין דף ק"ל	פ' יש נוחלין (בבא בתרא דף ק"ל)
Petach Einayim on Nedarim 20a:2	פ' יש נוחלין דף קכ"ג	פ' יש נוחלין (בבא בתרא דף קכ"ג)
Petach Einayim on Gittin 38b:1	פ' כיצד מברכין דף ל"ו	פ' כיצד מברכין (ברכות דף ל"ו)
Petach Einayim on Gittin 48a:1	פ' יש נוחלין דף קל"ו	פ' יש נוחלין (בבא בתרא דף קל"ו)
Petach Einayim on Gittin 57b:1	בפרק חלק דף צ"ו	בפרק חלק (סנהדרין דף צ"ו)
Petach Einayim on Gittin 74b:1	פ' מי שהוציאוהו סוף דף מ"ו	פ' מי שהוציאוהו סוף (עירובין דף מ"ו)
Petach Einayim on Ketubot 65a:1	פ' במה מדליקין דף ל"ג	פ' במה מדליקין (שבת דף ל"ג)
Petach Einayim on Kiddushin 49b:1	פ' הגוזל דף צ"ד	פ' הגוזל (בבא קמא דף צ"ד)
Petach Einayim on Berakhot 4a:2	פ' הערל דף ע"ט	פ' הערל (יבמות דף ע"ט)
Petach Einayim on Berakhot 8b:2	פ' חלק דף צ"ו	פ' חלק (סנהדרין דף צ"ו)
Petach Einayim on Berakhot 8b:3	פ' ערבי פסחים דף קי"ב ע"ב	פ' ערבי פסחים (פסחים דף קי"ב ע"ב)
Petach Einayim on Berakhot 20b:2	פ' חלק דף ק"ז	פ' חלק (סנהדרין דף ק"ז)
Petach Einayim on Berakhot 27b:2	פ' הישן דף כ"ח	פ' הישן (סוכה דף כ"ח)
Petach Einayim on Berakhot 28a:5	פ' חלק דף צ"ד ע"ב	פ' חלק (סנהדרין דף צ"ד ע"ב)
Petach Einayim on Berakhot 31a:2	בפ' חלק דף צ"ז	בפ' חלק (סנהדרין דף צ"ז)
Petach Einayim on Berakhot 31a:3	פ' כל הצלמים דף מ"ד ע"א	פ' כל הצלמים (עבודה זרה דף מ"ד ע"א)
Petach Einayim on Berakhot 47a:2	פ' תפלת השחר דף כ"ח	פ' תפלת השחר (ברכות דף כ"ח)
Petach Einayim on Berakhot 54a:1	פ' אלו מציאות דף ל'	פ' אלו מציאות (בבא מציעא דף ל')
Petach Einayim on Beitzah 4a:2	פ' לולב וערבה דף מ"ו	פ' לולב וערבה (סוכה דף מ"ו)
Petach Einayim on Beitzah 16a:4	פ' התכלת דף מ"ט	פ' התכלת (מנחות דף מ"ט)
Petach Einayim on Beitzah 20b:1	בפ' הזהב דף מ"ה	בפ' הזהב (בבא מציעא דף מ"ה)
Petach Einayim on Beitzah 20b:1	פ' הזהב דף נ"ה	פ' הזהב (בבא מציעא דף נ"ה)
Petach Einayim on Chagigah 6a:1	פ' המניח דף ל"ד	פ' המניח (בבא קמא דף ל"ד)
Petach Einayim on Sotah 12a:4	בפ' משוח מלחמה דף מ"ג	בפ' משוח מלחמה (סוטה דף מ"ג)
Petach Einayim on Sotah 22a:2	בפ' המקבל דף ק"ז	בפ' המקבל (בבא מציעא דף ק"ז)
Petach Einayim on Shabbat 4a:1	פרק השולח סוף דף מ"א	פרק השולח סוף (גיטין דף מ"א)
Petach Einayim on Shabbat 25b:1	פרק התכלת דף מ"א	פרק התכלת (מנחות דף מ"א)
Petach Einayim on Shabbat 32a:9	פ' התכלת דף מ"ד	פ' התכלת (מנחות דף מ"ד)
Petach Einayim on Shabbat 51a:2	פ' אין מעמידין דף ל"ח	פ' אין מעמידין (עבודה זרה דף ל"ח)
Petach Einayim on Shabbat 55a:11	פרק חלק דף ק"א	פרק חלק (סנהדרין דף ק"א)
Petach Einayim on Shabbat 119a:1	פ' הזרוע דף קל"ג	פ' הזרוע (חולין דף קל"ג)
Petach Einayim on Shabbat 130a:1	פ' ערבי פסחים דף קי"ב ע"ב	פ' ערבי פסחים (פסחים דף קי"ב ע"ב)
Petach Einayim on Yoma 19b:1	פ' שלשה שאכלו דף מ"ו ע"א	פ' שלשה שאכלו (ברכות דף מ"ו ע"א)
Petach Einayim on Yoma 23a:4	בפ' בני העיר דף כ"ח	בפ' בני העיר (מגילה דף כ"ח)
Petach Einayim on Yoma 39a:4	פ' הזרוע דף קל"ג	פ' הזרוע (חולין דף קל"ג)
Petach Einayim on Yoma 66a:1	פ' טרף בקלפי דף מ"ג ע"ב	פ' טרף בקלפי (יומא דף מ"ג ע"ב)
Maor VaShemesh, Vayechi 17	פרק אין עומדין דף ל"ב	פרק אין עומדין (ברכות דף ל"ב)
Maor VaShemesh, Shmini 12	פ' אלו טריפות דף ס' ע"ב	פ' אלו טריפות (חולין דף ס' ע"ב)
Penei Yehoshua on Makkot 2a:1	פ' היו בודקין דף מ"א	פ' היו בודקין (סנהדרין דף מ"א)
Penei Yehoshua on Makkot 2b:3	בס"פ אלו נערות דף מ"א	בס"פ אלו נערות (כתובות דף מ"א)
Penei Yehoshua on Makkot 4a:4	בפ' כל שעה (דף ל"ג	בפ' כל שעה (פסחים דף ל"ג
Penei Yehoshua on Makkot 4a:7	בפ' אלו נערות (דף ל"ב ע"ב	בפ' אלו נערות (כתובות דף ל"ב ע"ב
Penei Yehoshua on Makkot 4b:3	בפ' מרובה (דף ע"א	בפ' מרובה (בבא קמא דף ע"א
Penei Yehoshua on Makkot 4b:4	בפרק אלו נערות (דף ל"ב	בפרק אלו נערות (כתובות דף ל"ב
Penei Yehoshua on Makkot 5b:9	בפרק זה בורר דף ל'	בפרק זה בורר (סנהדרין דף ל')
Penei Yehoshua on Makkot 7a:2	בפ' הנשרפין ד' ע"ז	בפ' הנשרפין (סנהדרין ד' ע"ז)
Penei Yehoshua on Makkot 14a:1	בפ' אלו דברים דף ס"ח	בפ' אלו דברים (פסחים דף ס"ח)
Penei Yehoshua on Makkot 17a:5	בפרק הערל דף ע"ג	בפרק הערל (יבמות דף ע"ג)
Penei Yehoshua on Makkot 17a:5	בפ' כל שעה דף ל"ו ע"ב	ובפ' כל שעה (פסחים דף ל"ו ע"ב)
Penei Yehoshua on Rosh Hashanah 4a:18	בפרק משילין דף ל"ז	בפרק משילין (ביצה דף ל"ז)
Penei Yehoshua on Rosh Hashanah 9a:14	פרק הישן דף כ"ח	פרק הישן (סוכה דף כ"ח)
Penei Yehoshua on Rosh Hashanah 12a:2	בפ' בא סימן דף נ"א	בפ' בא סימן (נדה דף נ"א)
Penei Yehoshua on Rosh Hashanah 13b:2	פ' אלו נאמרין דף מ"א	פ' אלו נאמרין (סוטה דף מ"א)
Penei Yehoshua on Rosh Hashanah 14a:4	פרק המקבל דף ק"ו	פרק המקבל (בבא מציעא דף ק"ו)
Penei Yehoshua on Rosh Hashanah 15a:1	פרק לולב הגזול דף ל"ט ע"ב	פרק לולב הגזול (סוכה דף ל"ט ע"ב)
Penei Yehoshua on Rosh Hashanah 24b:1	פרק הוציאו לו דף נ"ד ע"ב	פרק הוציאו לו (יומא דף נ"ד ע"ב)
Penei Yehoshua on Rosh Hashanah 29a:3	בפרק כל הבשר דף ק"ו	בפרק כל הבשר (חולין דף ק"ו)
Penei Yehoshua on Rosh Hashanah 30b:6	פרק התכלת דף מ"ד	פרק התכלת (מנחות דף מ"ד)
Penei Yehoshua on Rosh Hashanah 32a:1	בפ' תפלת השחר דף כ"ט	בפ' תפלת השחר (ברכות דף כ"ט)
Shem MiShmuel, Bereshit 3:2	פרק מי שהחשיך (קנ"ו.	פרק מי שהחשיך (שבת קנ"ו.
Shem MiShmuel, Nasso 2:7	פ' המצניע (צ"ב.	פ' המצניע (שבת צ"ב.
Shem MiShmuel, Korach 5:6	פרק אין עומדין (ל"א.	פרק אין עומדין (ברכות ל"א.
Shem MiShmuel, Shoftim 6:3	פרק מקום שנהגו (נ"ה:	פרק מקום שנהגו (פסחים נ"ה:
Shem MiShmuel, Addenda 3:4	פרק הרואה (נ"ו:	פרק הרואה (ברכות נ"ו:
Shem MiShmuel, Rosh Hashanah 13:34	פרק אלו טריפות (מ"ה:	פרק אלו טריפות (חולין מ"ה:
Shem MiShmuel, Shemini Atzeret and Simchat Torah 9:2	ריש לולב וערבה (מ"ב.	ריש לולב וערבה (סוכה מ"ב.
Teshuvot haRashba part I 253:2	בפרק כל הבשר (דף קטז	בפרק כל הבשר (חולין דף קטז
Nachal Eitan on Mishneh Torah, Divorce 1:14:1	פרק גט פשוט (דף קס"ה	פרק גט פשוט (בבא בתרא דף קס"ה
Nachal Eitan on Mishneh Torah, Divorce 8:6:1	בפ' הזורק (דף ע"ט	בפ' הזורק (גיטין דף ע"ט
Nachal Eitan on Mishneh Torah, Divorce 10:21:1	פרק המגרש (דף צ'	פרק המגרש (גיטין דף צ'
Nachal Eitan on Mishneh Torah, Divorce 13:16:1	פרק החולץ (דף מ"ז ע"ב	פרק החולץ (יבמות דף מ"ז ע"ב
Nachal Eitan on Mishneh Torah, Divorce 13:16:1	פרק אלו טרפות (דף נ"ז ע"ב	רק אלו טרפות (חולין דף נ"ז ע"ב
Nachal Eitan on Mishneh Torah, Divorce 13:16:1	בפרק אלו טריפות (דף נ"ח	רק אלו טריפות (חולין דף נ"ח
Nachal Eitan on Mishneh Torah, Divorce 13:16:1	בפרק אלו טריפות (דף נ"ז ע"ב	ק אלו טריפות (חולין דף נ"ז ע"ב
Melechet Shlomo on Mishneh Torah, Divorce 2:12:1	בפ' מי שאחזו דף ע"ב	בפ' מי שאחזו (גיטין דף ע"ב)
Lev Shalem on Mishneh Torah, Sabbath 10:23:1	בפ' כל כתבי דף ק"כ	בפ' כל כתבי (שבת דף ק"כ)
Lev Shalem on Mishneh Torah, Sabbath 10:23:1	בפ' כל כתבי דף קי"ז	ובפ' כל כתבי (שבת דף קי"ז)
Lev Shalem on Mishneh Torah, Sabbath 10:23:1	בפ' נוטל אדם דף קמ"ג	ובפ' נוטל אדם (שבת דף קמ"ג)
Lev Shalem on Mishneh Torah, Sabbath 22:31:1	בפ' תולין דף קל"ח	בפ' תולין (שבת דף קל"ח)
Nachal Eitan on Mishneh Torah, Levirate Marriage and Release 4:17:1	פרק הערל (דף ע' ע"ב	פרק הערל (יבמות דף ע' ע"ב
Nachal Eitan on Mishneh Torah, Levirate Marriage and Release 7:10:1	בפרק רבן גמליאל (דף נ"ב	בפרק רבן גמליאל (יבמות דף נ"ב
Nachal Eitan on Mishneh Torah, Levirate Marriage and Release 7:10:1	פ' הערל (דף ע"ט	' הערל (יבמות דף ע"ט
Lev Shalem on Mishneh Torah, Foreign Worship and Customs of the Nations 2:7:1	בפ' ארבע מיתות דף ס"ו	בפ' ארבע מיתות (סנהדרין דף ס"ו)
Yad Eitan on Mishneh Torah, Marriage 4:1:1	בפ' הנושא (דף ק"ב ע"ב	בפ' הנושא (כתובות דף ק"ב ע"ב
Melechet Shlomo on Mishneh Torah, Daily Offerings and Additional Offerings 1:6:1	בפ' תמיד נשחט דף נ"ט	בפ' תמיד נשחט (פסחים דף נ"ט)
Melechet Shlomo on Mishneh Torah, Daily Offerings and Additional Offerings 1:6:1	בפ' תמיד נשחט דף נ"ט ע"ב	בפ' תמיד נשחט (פסחים דף נ"ט ע"ב)
Melechet Shlomo on Mishneh Torah, Heave Offerings 9:5:1	פ' השולח דף מ'	פ' השולח (גיטין דף מ')
Ben Aryeh on Mishneh Torah, Forbidden Intercourse 4:19:1	בפרק במה טומנין נ"א א	בפרק במה טומנין (שבת נ"א א)
Nachal Eitan on Mishneh Torah, Eruvin 1:11:1	בפרק אלו עוברין (דף מ"ד	בפרק אלו עוברין (פסחים דף מ"ד
Nachal Eitan on Mishneh Torah, Eruvin 1:11:2	פ' התקבל (דף ס"ה ע"ב	פ' התקבל (גיטין דף ס"ה ע"ב
Nachal Eitan on Mishneh Torah, Eruvin 6:15:1	בר"פ כיצד משתתפין (דף פ"ב	בר"פ כיצד משתתפין (עירובין דף פ"ב
Nachal Eitan on Mishneh Torah, Eruvin 8:5:1	בפרק הדר (דף ס"ח ע"א	בפרק הדר (עירובין דף ס"ח ע"א
Chidushim of Machaneh Ephraim on Mishneh Torah, Rebels 6:11:1	בפ' הכותב דף פ"ו	בפ' הכותב (כתובות דף פ"ו)
Melechet Shlomo on Mishneh Torah, Sales 1:4:1	בפ' חזקת הבתים דף נ"א	בפ' חזקת הבתים (בבא בתרא דף נ"א)
Melechet Shlomo on Mishneh Torah, Sales 3:5:1	בפ' הזהב דף מ"ז ע"ב	בפ' הזהב (בבא מציעא דף מ"ז ע"ב)
Melechet Shlomo on Mishneh Torah, Sales 3:5:1	בפ' חזקת הבתים דף נ"ד	בפ' חזקת הבתים (בבא בתרא דף נ"ד)
Melechet Shlomo on Mishneh Torah, Sales 24:16:1	בפ' מי שמת דף קמ"ח	בפ' מי שמת (בבא בתרא דף קמ"ח)
Melechet Shlomo on Mishneh Torah, Plaintiff and Defendant 1:3:1	בפ' הגוזל דף קי"ח	בפ' הגוזל (בבא קמא דף קי"ח)
Melechet Shlomo on Mishneh Torah, Plaintiff and Defendant 1:4:1	בפ' שבועת הדיינים דף מ"א	בפ' שבועת הדיינים (שבועות דף מ"א)
Melechet Shlomo on Mishneh Torah, Plaintiff and Defendant 2:2:1	בפ' הגוזל דף ק"ה	בפ' הגוזל (בבא קמא דף ק"ה)
Melechet Shlomo on Mishneh Torah, Plaintiff and Defendant 3:11:1	בפ' שבועת הדיינין דף מ'	בפ' שבועת הדיינין (שבועות דף מ')
Melechet Shlomo on Mishneh Torah, Plaintiff and Defendant 3:11:1	בפ' שבועת הדיינים דף מ'	בפ' שבועת הדיינים (שבועות דף מ')
Melechet Shlomo on Mishneh Torah, Plaintiff and Defendant 4:4:1	פ' יש נוחלין דף קכ"ח	פ' יש נוחלין (בבא בתרא דף קכ"ח)
Melechet Shlomo on Mishneh Torah, Plaintiff and Defendant 4:4:1	בפ' גט פשוט דף קע"ה	בפ' גט פשוט (בבא בתרא דף קע"ה)
Melechet Shlomo on Mishneh Torah, Plaintiff and Defendant 4:4:1	בפ' שבועת הפקדון דף ל"ז	ל בפ' שבועת הפקדון (שבועות דף ל"ז)
Melechet Shlomo on Mishneh Torah, Plaintiff and Defendant 4:10:1	בפ' כל הנשבעין דף מ"ו	בפ' כל הנשבעין (שבועות דף מ"ו)
Melechet Shlomo on Mishneh Torah, Plaintiff and Defendant 5:9:1	בפ' שבועת הדיינין דף מ'	בפ' שבועת הדיינין (שבועות דף מ')
Melechet Shlomo on Mishneh Torah, Plaintiff and Defendant 6:2:1	בפ' שבועת הדיינין דף מ"ב	בפ' שבועת הדיינין (שבועות דף מ"ב)
Melechet Shlomo on Mishneh Torah, Plaintiff and Defendant 6:5:1	בפ' כל הנשבעין דף מ"ה	בפ' כל הנשבעין (שבועות דף מ"ה)
Melechet Shlomo on Mishneh Torah, Plaintiff and Defendant 6:6:1	בפ' זה בורר דף כ"ט ע"א	בפ' זה בורר (סנהדרין דף כ"ט ע"א)
Melechet Shlomo on Mishneh Torah, Plaintiff and Defendant 7:1:1	בפ' מי שמת דף קמ"ט	בפ' מי שמת (בבא בתרא דף קמ"ט)
Melechet Shlomo on Mishneh Torah, Plaintiff and Defendant 7:5:1	בפ' איזהו נשך דף ע"ב ע"א	בפ' איזהו נשך (בבא מציעא דף ע"ב ע"א)
Melechet Shlomo on Mishneh Torah, Plaintiff and Defendant 8:7:1	בפ' חזקת הבתים דף נ"ב	בפ' חזקת הבתים (בבא בתרא דף נ"ב)
Melechet Shlomo on Mishneh Torah, Plaintiff and Defendant 11:4:1	בפ' גט פשוט דף קס"ט	בפ' גט פשוט (בבא בתרא דף קס"ט)
Melechet Shlomo on Mishneh Torah, Plaintiff and Defendant 14:5:1	בפ' חזקת הבתים דף ל"ה	בפ' חזקת הבתים (בבא בתרא דף ל"ה)
Nachal Eitan on Mishneh Torah, Ritual Slaughter 3:19:1	פ' אלו טריפות (דף מ"ג	פ' אלו טריפות (חולין דף מ"ג
Nachal Eitan on Mishneh Torah, Ritual Slaughter 8:24:1	פ' אלו טריפות (דף נ"ז	פ' אלו טריפות (חולין דף נ"ז
Nachal Eitan on Mishneh Torah, Ritual Slaughter 9:5:1	פ' אלו טריפות (דף מ"ג	פ' אלו טריפות (חולין דף מ"ג
Nachal Eitan on Mishneh Torah, Ritual Slaughter 10:10:1	פרק אלו טריפות (דף נ"ז	פרק אלו טריפות (חולין דף נ"ז
Nachal Eitan on Mishneh Torah, Ritual Slaughter 10:10:1	בפ' אלו טריפות (דף נ"ו	פ' אלו טריפות (חולין דף נ"ו
Lev Shalem on Mishneh Torah, Scroll of Esther and Hanukkah 4:9:1	פ' כירה דף מ"ד ע"א	פ' כירה (שבת דף מ"ד ע"א)
Melechet Shlomo on Mishneh Torah, Neighbors 6:12:1	בפ' החליל דף נ"א	בפ' החליל (סוכה דף נ"א)
Lev Shalem on Mishneh Torah, Virgin Maiden 1:3:1	בפ' אלו נערות דף ל"ט ע"ב	בפ' אלו נערות (כתובות דף ל"ט ע"ב)
Melechet Shlomo on Mishneh Torah, Borrowing and Deposit 5:3:1	בפ' אלו נערות דף ל"ד	בפ' אלו נערות (כתובות דף ל"ד)
Melechet Shlomo on Mishneh Torah, Borrowing and Deposit 5:6:1	בפ' הכותב דף פ"ח	בפ' הכותב (כתובות דף פ"ח)
Ben Aryeh on Mishneh Torah, Appraisals and Devoted Property 4:26:1	ר"פ יש בערכין דף י"ד ע"א	ר"פ יש בערכין (ערכין דף י"ד ע"א)
Nachal Eitan on Mishneh Torah, Virgin Maiden 1:2:1	בפ' אלו נערות (דף ל"ט	בפ' אלו נערות (כתובות דף ל"ט
Nachal Eitan on Mishneh Torah, Virgin Maiden 1:11:2	פרק מרובה (דף ע"א	פרק מרובה (בבא קמא דף ע"א
Nachal Eitan on Mishneh Torah, Virgin Maiden 2:11:1	פרק אלו נערות (דף ל"ב	פרק אלו נערות (כתובות דף ל"ב
Nachal Eitan on Mishneh Torah, Virgin Maiden 2:11:1	בפ' החובל (דף פ"ו	פ' החובל (בבא קמא דף פ"ו
Nachal Eitan on Mishneh Torah, Virgin Maiden 2:11:1	בפ' החובל (דף פ"ה ע"ב	' החובל (בבא קמא דף פ"ה ע"ב
Nachal Eitan on Mishneh Torah, Virgin Maiden 2:11:2	פ' אלו נערות (דף ל"ט	פ' אלו נערות (כתובות דף ל"ט
Nachal Eitan on Mishneh Torah, Virgin Maiden 2:11:2	פרק אלו נערות (סוף דף ל"ה	רק אלו נערות (סוף כתובות דף ל"ה
Nachal Eitan on Mishneh Torah, Virgin Maiden 2:13:1	בפרק אלו נערות (דף ל"ט ע"ב	בפרק אלו נערות (כתובות דף ל"ט ע"ב
Lev Shalem on Mishneh Torah, Forbidden Foods 13:12:1	בפ' אין מעמידין דף ל"א ע"ב	בפ' אין מעמידין (עבודה זרה דף ל"א ע"ב)
Yad Eitan on Mishneh Torah, Ritual Slaughter 2:2:1	בפ' חטאת העוף (דף ס"ח	בפ' חטאת העוף (זבחים דף ס"ח
Nachal Eitan on Mishneh Torah, Forbidden Intercourse 1:1:1	פ' אותו ואת בנו (דף פ"ב	פ' אותו ואת בנו (חולין דף פ"ב
Nachal Eitan on Mishneh Torah, Forbidden Intercourse 1:1:1	פ' גיד הנשה (דף ק"ב	' גיד הנשה (חולין דף ק"ב
Nachal Eitan on Mishneh Torah, Forbidden Intercourse 1:1:1	פ' אותו ואת בנו (ריש דף פ"ג	אותו ואת בנו (ריש חולין דף פ"ג
Nachal Eitan on Mishneh Torah, Forbidden Intercourse 2:7:1	פרק האשה רבה (דף צ"ד ע"ב	פרק האשה רבה (יבמות דף צ"ד ע"ב
Nachal Eitan on Mishneh Torah, Forbidden Intercourse 3:15:1	בפרק הבא על יבמתו (דף נ"ה	בפרק הבא על יבמתו (יבמות דף נ"ה
Nachal Eitan on Mishneh Torah, Forbidden Intercourse 3:15:1	פ' ד' אחין (דף ל"ד ע"ב	' ד' אחין (יבמות דף ל"ד ע"ב
Nachal Eitan on Mishneh Torah, Forbidden Intercourse 7:4:1	בפרק המפלת (דף כ"א	בפרק המפלת (נדה דף כ"א
Nachal Eitan on Mishneh Torah, Forbidden Intercourse 12:11:1	בפרק החולץ (דף מ"ה	בפרק החולץ (יבמות דף מ"ה
Nachal Eitan on Mishneh Torah, Marriage 3:4:1	פרק האיש מקדש (דף מ"ח	פרק האיש מקדש (קידושין דף מ"ח
Nachal Eitan on Mishneh Torah, Marriage 3:8:1	בפרק המגרש (דף פ"ד	בפרק המגרש (גיטין דף פ"ד
Nachal Eitan on Mishneh Torah, Marriage 3:8:1	פרק חזקת (דף מ"ה	רק חזקת (בבא בתרא דף מ"ה
Nachal Eitan on Mishneh Torah, Marriage 3:14:1	בפרק המדיר (דף ע"ה ע"ב	בפרק המדיר (כתובות דף ע"ה ע"ב
Nachal Eitan on Mishneh Torah, Marriage 4:1:1	בפ' הנושא (דף ק"ב ע"ב	בפ' הנושא (כתובות דף ק"ב ע"ב
Nachal Eitan on Mishneh Torah, Marriage 7:1:1	בפרק המדיר (דף ע"ג	בפרק המדיר (כתובות דף ע"ג
Nachal Eitan on Mishneh Torah, Marriage 7:1:1	פרק האשה שנפלו (דף ע"ט	רק האשה שנפלו (כתובות דף ע"ט
Nachal Eitan on Mishneh Torah, Marriage 10:1:1	פרק ארוסה (דף כ"ד ע"ב	פרק ארוסה (סוטה דף כ"ד ע"ב
Nachal Eitan on Mishneh Torah, Marriage 10:1:2	בפרק ארבעה אחין (דף כ"ט	בפרק ארבעה אחין (יבמות דף כ"ט
Nachal Eitan on Mishneh Torah, Marriage 12:9:1	פרק יש נוחלין (דף קל"ט	פרק יש נוחלין (בבא בתרא דף קל"ט
Nachal Eitan on Mishneh Torah, Marriage 12:9:2	בסוף מי שמת (דף קנ"ט ע"ב	בסוף מי שמת (בבא בתרא דף קנ"ט ע"ב
Nachal Eitan on Mishneh Torah, Marriage 17:1:2	פרק יש נוחלין (דף קל"ב	פרק יש נוחלין (בבא בתרא דף קל"ב
Nachal Eitan on Mishneh Torah, Marriage 21:11:1	בפרק הערל (דף פ' ע"ב	בפרק הערל (יבמות דף פ' ע"ב
Nachal Eitan on Mishneh Torah, Marriage 21:12:1	פרק אף על פי (דף ס' ע"ב	פרק אף על פי (כתובות דף ס' ע"ב
Nachal Eitan on Mishneh Torah, Marriage 24:2:1	פרק איזהו נשך (דף ס"ז	פרק איזהו נשך (בבא מציעא דף ס"ז
Nachal Eitan on Mishneh Torah, Marriage 24:17:2	פרק הכותב (דף פ"ז ע"ב	פרק הכותב (כתובות דף פ"ז ע"ב
Melechet Shlomo on Mishneh Torah, Ownerless Property and Gifts 2:11:1	בפרק עושין פסין דף כ"ה	בפרק עושין פסין (עירובין דף כ"ה)
Melechet Shlomo on Mishneh Torah, Ownerless Property and Gifts 2:18:1	בפ' מי שמת דף קמ"ב	בפ' מי שמת (בבא בתרא דף קמ"ב)
Melechet Shlomo on Mishneh Torah, Ownerless Property and Gifts 3:7:1	בפ' מי שאחזו דף ע"ה	בפ' מי שאחזו (גיטין דף ע"ה)
Melechet Shlomo on Mishneh Torah, Ownerless Property and Gifts 5:7:1	בפ' המגרש דף פ"ו	בפ' המגרש (גיטין דף פ"ו)
Melechet Shlomo on Mishneh Torah, Ownerless Property and Gifts 6:2:1	בפ' יש נוחלין דף קל"א	בפ' יש נוחלין (בבא בתרא דף קל"א)
Melechet Shlomo on Mishneh Torah, Ownerless Property and Gifts 6:9:1	בפ' יש נוחלין דף קל"ב	בפ' יש נוחלין (בבא בתרא דף קל"ב)
Melechet Shlomo on Mishneh Torah, Ownerless Property and Gifts 6:14:1	בפ' מי שמת דף קמ"ג	בפ' מי שמת (בבא בתרא דף קמ"ג)
Melechet Shlomo on Mishneh Torah, Ownerless Property and Gifts 6:18:1	בפ' מי שמת דף קמ"ה	בפ' מי שמת (בבא בתרא דף קמ"ה)
Melechet Shlomo on Mishneh Torah, Ownerless Property and Gifts 8:5:1	בפ' אלמנה לכהן גדול דף ס"ז	בפ' אלמנה לכהן גדול (יבמות דף ס"ז)
Melechet Shlomo on Mishneh Torah, Ownerless Property and Gifts 8:5:1	בפ' מי שמת דף קמ"ח	בפ' מי שמת (בבא בתרא דף קמ"ח)
Melechet Shlomo on Mishneh Torah, Ownerless Property and Gifts 8:5:1	בפ' אלמנה לכהן גדול דף ס"ז	ם בפ' אלמנה לכהן גדול (יבמות דף ס"ז)
Melechet Shlomo on Mishneh Torah, Ownerless Property and Gifts 8:5:1	בפ' יש נוחלין דף קכ"ז	"ש בפ' יש נוחלין (בבא בתרא דף קכ"ז)
Melechet Shlomo on Mishneh Torah, Ownerless Property and Gifts 8:15:1	בפ' מי שמת דף קמ"ט	בפ' מי שמת (בבא בתרא דף קמ"ט)
Melechet Shlomo on Mishneh Torah, Ownerless Property and Gifts 8:17:1	בפ' מי שמת דף קנ"א	בפ' מי שמת (בבא בתרא דף קנ"א)
Melechet Shlomo on Mishneh Torah, Ownerless Property and Gifts 9:3:1	בפ' מי שמת דף קמ"ח א	בפ' מי שמת (בבא בתרא דף קמ"ח א)
Melechet Shlomo on Mishneh Torah, Ownerless Property and Gifts 9:9:1	בפ' מי שמת דף קמ"ט	בפ' מי שמת (בבא בתרא דף קמ"ט)
Melechet Shlomo on Mishneh Torah, Ownerless Property and Gifts 9:17:1	בפ' מי שמת דף קמ"ח	בפ' מי שמת (בבא בתרא דף קמ"ח)
Melechet Shlomo on Mishneh Torah, Red Heifer 1:7:1	בר"פ אין מעמידין דף כ"ג	בר"פ אין מעמידין (עבודה זרה דף כ"ג)
Yad Eitan on Mishneh Torah, Admission into the Sanctuary 5:16:1	פ' כל הבשר (דף ק"ו ע"ב	פ' כל הבשר (חולין דף ק"ו ע"ב
Nachal Eitan on Mishneh Torah, Forbidden Foods 3:1:1	בפ' גיד הנשה (דף צ"ט	בפ' גיד הנשה (חולין דף צ"ט
Nachal Eitan on Mishneh Torah, Forbidden Foods 5:6:1	פ' העור והרוטב (דף קכ"ט ע"א	פ' העור והרוטב (חולין דף קכ"ט ע"א
Nachal Eitan on Mishneh Torah, Forbidden Foods 6:6:1	בפ' כל הבשר (דף ק"ט	בפ' כל הבשר (חולין דף ק"ט
Nachal Eitan on Mishneh Torah, Forbidden Foods 7:2:1	פ' גיד הנשה (דף ק"א ע"א	פ' גיד הנשה (חולין דף ק"א ע"א
Nachal Eitan on Mishneh Torah, Forbidden Foods 8:16:1	בפרק כל שעה (דף כ"ג ע"א	בפרק כל שעה (פסחים דף כ"ג ע"א
Divrei Yirmiyahu on Mishneh Torah, Blessings 1:2:1	בריש כיצד מברכין דף ל"ה ע"א	בריש כיצד מברכין (ברכות דף ל"ה ע"א)
Yad Eitan on Mishneh Torah, Paschal Offering 9:2:1	בפ' מי שהיה טמא (דף צ"ה	בפ' מי שהיה טמא (פסחים דף צ"ה
Yad Eitan on Mishneh Torah, Paschal Offering 9:2:2	בפ' מי שהיה טמא (דף צ"ה	בפ' מי שהיה טמא (פסחים דף צ"ה
Chidushim of Machaneh Ephraim on Mishneh Torah, Divorce 9:9:1	בפרק המביא תניין דף י"ח ע"ב	בפרק המביא תניין (גיטין דף י"ח ע"ב)
Melechet Shlomo on Mishneh Torah, Foundations of the Torah 5:8:1	בפ' כל שעה דף ל"ה ע"א	בפ' כל שעה (פסחים דף ל"ה ע"א)
Melechet Shlomo on Mishneh Torah, Foundations of the Torah 5:8:1	בפ' העור והרוטב דף ק"כ	בפ' העור והרוטב (חולין דף ק"כ)
Melechet Shlomo on Mishneh Torah, Foundations of the Torah 5:8:1	בפ' דם חטאת דף צ"ז ע"ב	ס בפ' דם חטאת (זבחים דף צ"ז ע"ב)
Melechet Shlomo on Mishneh Torah, Robbery and Lost Property 3:4:1	פ' מרובה דף ע"א ע"ב	פ' מרובה (בבא קמא דף ע"א ע"ב)
Melechet Shlomo on Mishneh Torah, Robbery and Lost Property 18:1:1	בפ' גט פשוט דף קס"ט	בפ' גט פשוט (בבא בתרא דף קס"ט)
Melechet Shlomo on Mishneh Torah, Robbery and Lost Property 18:1:1	בפ' חזקת הבתים דף מ'	בפ' חזקת הבתים (בבא בתרא דף מ')
Nachal Eitan on Mishneh Torah, Sabbath 1:5:1	בפרק ערבי פסחים (דף ק"א	בפרק ערבי פסחים (פסחים דף ק"א
Nachal Eitan on Mishneh Torah, Sabbath 2:16:1	בפרק כירה (דף מ"א ע"ב	בפרק כירה (שבת דף מ"א ע"ב
Nachal Eitan on Mishneh Torah, Sabbath 3:18:1	בפרק כירה (דף ל"ז ע"ב	בפרק כירה (שבת דף ל"ז ע"ב
Nachal Eitan on Mishneh Torah, Sabbath 5:19:1	בפרק הזהב (דף מ"ט	בפרק הזהב (בבא מציעא דף מ"ט
Nachal Eitan on Mishneh Torah, Sabbath 8:8:1	בפרק המניח (דף ל"ה	בפרק המניח (בבא קמא דף ל"ה
Nachal Eitan on Mishneh Torah, Sabbath 8:8:1	בר"פ נוטל (דף קמ"א	ר"פ נוטל (שבת דף קמ"א
Nachal Eitan on Mishneh Torah, Sabbath 9:4:1	פרק האורג (דף ק"ו ע"א	פרק האורג (שבת דף ק"ו ע"א
Nachal Eitan on Mishneh Torah, Sabbath 9:7:1	פרק המצניע (דף צ"ד	פרק המצניע (שבת דף צ"ד
Nachal Eitan on Mishneh Torah, Sabbath 12:15:1	בפרק מי שהוציאוהו (דף מ"ה	בפרק מי שהוציאוהו (עירובין דף מ"ה
Nachal Eitan on Mishneh Torah, Sabbath 12:15:2	בפרק מי שהוציאוהו (דף מ"ח	בפרק מי שהוציאוהו (עירובין דף מ"ח
Nachal Eitan on Mishneh Torah, Sabbath 23:12:1	פרק שואל (דף קנ"א	פרק שואל (שבת דף קנ"א
Nachal Eitan on Mishneh Torah, Sabbath 23:20:1	ר"פ המוצא תפילין (דף צ"ו ע"ב	ר"פ המוצא תפילין (עירובין דף צ"ו ע"ב
Nachal Eitan on Mishneh Torah, Sabbath 23:20:1	פרק במה אשה (דף ס"ה ע"ב	רק במה אשה (שבת דף ס"ה ע"ב
Nachal Eitan on Mishneh Torah, Sabbath 23:24:1	בפרק הגוזל בתרא (דף קט"ז	בפרק הגוזל בתרא (בבא קמא דף קט"ז
Nachal Eitan on Mishneh Torah, Sabbath 25:26:1	פ' מי שהחשיך (דף קנ"ד ע"ב	פ' מי שהחשיך (שבת דף קנ"ד ע"ב
Nachal Eitan on Mishneh Torah, Sabbath 27:1:1	פרק במה בהמה (דף נ"ג ע"ב	פרק במה בהמה (שבת דף נ"ג ע"ב
Divrei Yirmiyahu on Mishneh Torah, Rest on a Holiday 2:14:1	בפ' כלל גדול ע"ג ע"ב	בפ' כלל גדול (שבת ע"ג ע"ב)
Divrei Yirmiyahu on Mishneh Torah, Rest on a Holiday 7:1:1	בפ' מקום שנהגו נ' ע"א	בפ' מקום שנהגו (פסחים נ' ע"א)
Melechet Shlomo on Mishneh Torah, Oaths 2:14:1	בפ' שבועות שתים דף כ"ו	בפ' שבועות שתים (שבועות דף כ"ו)
Melechet Shlomo on Mishneh Torah, Oaths 2:14:1	בפ' תמיד נשחט דף ס"ג	בפ' תמיד נשחט (פסחים דף ס"ג)
Lev Shalem on Mishneh Torah, Fringes 1:1:1	בפ' התכלת דף מ"א ע"ב	בפ' התכלת (מנחות דף מ"א ע"ב)
Lev Shalem on Mishneh Torah, Fringes 1:1:1	בפ' הנחנקין דף פ"ח	בפ' הנחנקין (סנהדרין דף פ"ח)
Lev Shalem on Mishneh Torah, Fringes 3:10:1	בפ' התכלת דף מ"ד ע"א	בפ' התכלת (מנחות דף מ"ד ע"א)
Melechet Shlomo on Mishneh Torah, Torah Study 5:2:1	בפ' אין עומדין דף ל"א	בפ' אין עומדין (ברכות דף ל"א)
Lev Shalem on Mishneh Torah, Divorce 2:3:1	בפ' כל הגט דף כ"ה.	בפ' כל הגט (גיטין דף כ"ה.)
Lev Shalem on Mishneh Torah, Divorce 9:9:1	בפ' המביא תניין דף י"ח ע"ב	בפ' המביא תניין (גיטין דף י"ח ע"ב)
Yad Eitan on Mishneh Torah, Murderer and the Preservation of Life 3:7:1	בפ' החובל (דף צ' ע"ב	בפ' החובל (בבא קמא דף צ' ע"ב
Yad Eitan on Mishneh Torah, Murderer and the Preservation of Life 7:15:1	פרק אלו הן הגולין (דף ח':	פרק אלו הן הגולין (מכות דף ח':
Melechet Shlomo on Mishneh Torah, Mourning 4:9:1	בפ' אלו מגלחין דף כ"א ע"א	בפ' אלו מגלחין (מועד קטן דף כ"א ע"א)
Melechet Shlomo on Mishneh Torah, Mourning 5:16:1	בפ' בני העיר דף ל"א ע"ב	בפ' בני העיר (מגילה דף ל"א ע"ב)
Melechet Shlomo on Mishneh Torah, Inheritances 4:6:1	בפ' הזורק גט דף פ"א	בפ' הזורק גט (גיטין דף פ"א)
Melechet Shlomo on Mishneh Torah, Vows 5:2:1	בפ' המוכר את הבית דף ס"ג	בפ' המוכר את הבית (בבא בתרא דף ס"ג)
Melechet Shlomo on Mishneh Torah, Vows 12:14:1	בפ' נערה המאורסה דף ע"ג	בפ' נערה המאורסה (נדרים דף ע"ג)
Yad Eitan on Mishneh Torah, Sacrifices Rendered Unfit 18:16:1	בפ' כל הפסולין (דף ל"ה:	בפ' כל הפסולין (זבחים דף ל"ה:
Yad Eitan on Mishneh Torah, Sacrifices Rendered Unfit 18:16:1	ס"פ ב"ש (דף מ"ו:	"פ ב"ש (זבחים דף מ"ו:
Yad Eitan on Mishneh Torah, Sacrifices Rendered Unfit 19:5:1	בפרק הערל (דף ע"ב	בפרק הערל (יבמות דף ע"ב
Ben Aryeh on Mishneh Torah, Fringes 3:12:1	פ' התכלת מ"ג ב	פ' התכלת (מנחות מ"ג ב)
Chidushim of Machaneh Ephraim on Mishneh Torah, Forbidden Foods 13:12:1	בפ' אין מעמידין דף ל"א ע"ב	בפ' אין מעמידין (עבודה זרה דף ל"א ע"ב)
Lev Shalem on Mishneh Torah, Rest on a Holiday 5:20:1	בפ' כל הגט דף ל"א	בפ' כל הגט (גיטין דף ל"א)
Melechet Shlomo on Mishneh Torah, Slaves 3:11:1	בפ' החולץ דף מ"ג ע"ב	בפ' החולץ (יבמות דף מ"ג ע"ב)
Melechet Shlomo on Mishneh Torah, Slaves 8:11:1	בפ' החובל דף פ"ז	בפ' החובל (בבא קמא דף פ"ז)
Nachal Eitan on Mishneh Torah, Woman Suspected of Infidelity 1:6:1	פרק הבא על יבמתו (דף נ"ה ע"ב	פרק הבא על יבמתו (יבמות דף נ"ה ע"ב
Nachal Eitan on Mishneh Torah, Woman Suspected of Infidelity 1:6:1	בפרק ארוסה (דף כ"ו	פרק ארוסה (סוטה דף כ"ו
Nachal Eitan on Mishneh Torah, Woman Suspected of Infidelity 2:4:1	פרק ארבע מיתות (דף נ"ה ע"ב	פרק ארבע מיתות (סנהדרין דף נ"ה ע"ב
Nachal Eitan on Mishneh Torah, Woman Suspected of Infidelity 4:14:1	פרק היה נוטל (דף י"ט	פרק היה נוטל (סוטה דף י"ט
Lev Shalem on Mishneh Torah, Forbidden Intercourse 20:16:1	בפרק בכל מערבין דף ל"ו	בפרק בכל מערבין (עירובין דף ל"ו)
Melechet Shlomo on Mishneh Torah, Shofar, Sukkah and Lulav 2:4:1	בפ' ערבי פסחים דף קט"ו	בפ' ערבי פסחים (פסחים דף קט"ו)
Melechet Shlomo on Mishneh Torah, Shofar, Sukkah and Lulav 7:11:1	פ' לולב הגזול דף ל"ז ע"א	פ' לולב הגזול (סוכה דף ל"ז ע"א)
Melechet Shlomo on Mishneh Torah, Shofar, Sukkah and Lulav 8:1:1	פ' לולב הגזול דף ל"א	פ' לולב הגזול (סוכה דף ל"א)
Melechet Shlomo on Mishneh Torah, Shofar, Sukkah and Lulav 8:1:1	פ' הישן דף כ"ג	פ' הישן (סוכה דף כ"ג)
Divrei Yirmiyahu on Mishneh Torah, Prayer and the Priestly Blessing 2:14:2	פ' התכלת דף מ"ב ע"ב	פ' התכלת (מנחות דף מ"ב ע"ב)
Chidushei Mayim Chayim on Mishneh Torah, Foreign Worship and Customs of the Nations 2:3:1	בפרק ד' מיתות דף ס"ה ע"ב	בפרק ד' מיתות (סנהדרין דף ס"ה ע"ב)
Chidushei Mayim Chayim on Mishneh Torah, Foreign Worship and Customs of the Nations 2:3:1	בפ' ד' מיתות דף ס"ג ע"א	בפ' ד' מיתות (סנהדרין דף ס"ג ע"א)
Chidushei Mayim Chayim on Mishneh Torah, Foreign Worship and Customs of the Nations 2:6:1	בפרק נגמר הדין דף מ"ו ע"א	בפרק נגמר הדין (סנהדרין דף מ"ו ע"א)
Chidushei Mayim Chayim on Mishneh Torah, Foreign Worship and Customs of the Nations 2:7:1	בפרק שבועת העדות דף ל"ו ע"א	בפרק שבועת העדות (שבועות דף ל"ו ע"א)
Chidushei Mayim Chayim on Mishneh Torah, Foreign Worship and Customs of the Nations 2:7:2	בפרק שבועת העדות דף ל"ו	בפרק שבועת העדות (שבועות דף ל"ו)
Chidushei Mayim Chayim on Mishneh Torah, Foreign Worship and Customs of the Nations 3:4:1	בפ' ד' מיתות דף ס"ב	בפ' ד' מיתות (סנהדרין דף ס"ב)
Chidushei Mayim Chayim on Mishneh Torah, Foreign Worship and Customs of the Nations 3:6:1	בפ' ד' מיתות דף ס"ה ע"א	בפ' ד' מיתות (סנהדרין דף ס"ה ע"א)
Chidushei Mayim Chayim on Mishneh Torah, Foreign Worship and Customs of the Nations 4:2:2	בפ' האיש מקדש דף מ"ג	בפ' האיש מקדש (קידושין דף מ"ג)
Chidushei Mayim Chayim on Mishneh Torah, Foreign Worship and Customs of the Nations 4:6:2	בפ' חלק דף ק"י	בפ' חלק (סנהדרין דף ק"י)
Chidushei Mayim Chayim on Mishneh Torah, Foreign Worship and Customs of the Nations 4:12:1	בפ' כסוי הדם דף פ"ה ע"ב	בפ' כסוי הדם (חולין דף פ"ה ע"ב)
Chidushei Mayim Chayim on Mishneh Torah, Foreign Worship and Customs of the Nations 4:12:2	בפ' נגמר הדין דף מ"ח	בפ' נגמר הדין (סנהדרין דף מ"ח)
Chidushei Mayim Chayim on Mishneh Torah, Foreign Worship and Customs of the Nations 5:2:2	בפ' ד' מיתות דף ס"ז	בפ' ד' מיתות (סנהדרין דף ס"ז)
Chidushei Mayim Chayim on Mishneh Torah, Foreign Worship and Customs of the Nations 5:3:3	בפ' ד' מיתות דף ס"ז	בפ' ד' מיתות (סנהדרין דף ס"ז)
Chidushei Mayim Chayim on Mishneh Torah, Foreign Worship and Customs of the Nations 5:4:1	בפ' ד' מיתות דף נ"ז	בפ' ד' מיתות (סנהדרין דף נ"ז)
Chidushei Mayim Chayim on Mishneh Torah, Foreign Worship and Customs of the Nations 5:10:1	בפ' ד' מיתות דף ס"ו	בפ' ד' מיתות (סנהדרין דף ס"ו)
Chidushei Mayim Chayim on Mishneh Torah, Foreign Worship and Customs of the Nations 5:10:1	בפרק ארבע מיתות דף ס"ג	בפרק ארבע מיתות (סנהדרין דף ס"ג)
Chidushei Mayim Chayim on Mishneh Torah, Foreign Worship and Customs of the Nations 6:2:1	פ' ד' מיתות דף ס"ה	פ' ד' מיתות (סנהדרין דף ס"ה)
Chidushei Mayim Chayim on Mishneh Torah, Foreign Worship and Customs of the Nations 7:9:1	בפרק הערל דף פ"א	בפרק הערל (יבמות דף פ"א)
Chidushei Mayim Chayim on Mishneh Torah, Foreign Worship and Customs of the Nations 8:1:1	בפרק ר' ישמעאל דף נ"ט	בפרק ר' ישמעאל (עבודה זרה דף נ"ט)
Yad Eitan on Mishneh Torah, Theft 1:7:1	בפ' החובל (דף פ"ז	בפ' החובל (בבא קמא דף פ"ז
Ben Aryeh on Mishneh Torah, Oaths 6:3:1	בפרק הדר דף ס"ג ע"א	בפרק הדר (עירובין דף ס"ג ע"א)
Melechet Shlomo on Mishneh Torah, Defilement by a Corpse 9:12:1	פ' עשרה יוחסין דף ע"ג ע"א	פ' עשרה יוחסין (קידושין דף ע"ג ע"א)
Yad Eitan on Mishneh Torah, First Fruits and other Gifts to Priests Outside the Sanctuary 2:13:1	בס"פ השולח (דף מ"ח	בס"פ השולח (גיטין דף מ"ח
Lev Shalem on Mishneh Torah, Torah Study 3:5:1	בפ' מקום שנהגו דף נ'	בפ' מקום שנהגו (פסחים דף נ')
Yad Eitan on Mishneh Torah, The Sanhedrin and the Penalties within their Jurisdiction 12:3:1	בפרק ארבע מיתות (דף נ"ו	בפרק ארבע מיתות (סנהדרין דף נ"ו
Melechet Shlomo on Mishneh Torah, Eruvin 1:19:1	בפ' הדר דף ע"א ע"ב	בפ' הדר (עירובין דף ע"א ע"ב)
Melechet Shlomo on Mishneh Torah, Eruvin 4:6:1	בפ' הדר דף ע"ב	בפ' הדר (עירובין דף ע"ב)
Ben Aryeh on Mishneh Torah, Sales 22:3:1	פרק הזהב דף מ"ט ע"א	פרק הזהב (בבא מציעא דף מ"ט ע"א)
Nachal Eitan on Mishneh Torah, Human Dispositions 7:3:1	בפרק הרואה (דף סא	בפרק הרואה (ברכות דף סא
Nachal Eitan on Mishneh Torah, Human Dispositions 7:3:1	פרק הזהב (דף נ"ט	רק הזהב (בבא מציעא דף נ"ט
Melechet Shlomo on Mishneh Torah, Hiring 2:1:1	בפ' אין בין המודר דף ל"ז ע"א	בפ' אין בין המודר (נדרים דף ל"ז ע"א)
Melechet Shlomo on Mishneh Torah, Hiring 2:3:1	בפ' הזהב דף נ"ז	בפ' הזהב (בבא מציעא דף נ"ז)
Melechet Shlomo on Mishneh Torah, Hiring 2:3:1	בפ' אין בין המודר דף ל"ז	בפ' אין בין המודר (נדרים דף ל"ז)
Melechet Shlomo on Mishneh Torah, Hiring 10:1:1	בפ' השולח דף ל"ז	בפ' השולח (גיטין דף ל"ז)
Melechet Shlomo on Mishneh Torah, Hiring 10:1:1	בפ' השולח דף ל"ז	בפ' השולח (גיטין דף ל"ז)
Melechet Shlomo on Mishneh Torah, Hiring 10:1:1	בפ' הזהב דף מ"ח	ן בפ' הזהב (בבא מציעא דף מ"ח)
Melechet Shlomo on Mishneh Torah, Hiring 10:1:1	בפ' המקבל דף קי"ד	מע בפ' המקבל (בבא מציעא דף קי"ד)
Melechet Shlomo on Mishneh Torah, Hiring 12:13:1	בפ' אין בין המודר דף ל"ד	בפ' אין בין המודר (נדרים דף ל"ד)
Melechet Shlomo on Mishneh Torah, Creditor and Debtor 2:6:1	בפ' החובל דף פ"ט	בפ' החובל (בבא קמא דף פ"ט)
Melechet Shlomo on Mishneh Torah, Creditor and Debtor 11:5:1	בפ' חזקת הבתים דף מ"א	בפ' חזקת הבתים (בבא בתרא דף מ"א)
Melechet Shlomo on Mishneh Torah, Creditor and Debtor 11:5:1	בפ' חזקת הבתים דף מ"ב	בפ' חזקת הבתים (בבא בתרא דף מ"ב)
Melechet Shlomo on Mishneh Torah, Creditor and Debtor 14:9:1	בפ' חזקת הבתים דף ל"ב	בפ' חזקת הבתים (בבא בתרא דף ל"ב)
Melechet Shlomo on Mishneh Torah, Creditor and Debtor 26:6:1	בפ' הכונס דף נ"ח	בפ' הכונס (בבא קמא דף נ"ח)
Melechet Shlomo on Mishneh Torah, Admission into the Sanctuary 2:2:1	בפ' טבול יום דף ק"א ע"א	בפ' טבול יום (זבחים דף ק"א ע"א)
Ben Aryeh on Mishneh Torah, Neighbors 9:11:1	פ' הכונס [דף ס"א ע"ב	פ' הכונס (בבא קמא דף ס"א ע"ב)
Nachal Eitan on Mishneh Torah, Foundations of the Torah 5:8:2	בפרק כל שעה (דף כ"ד	בפרק כל שעה (פסחים דף כ"ד
Nachal Eitan on Mishneh Torah, Foundations of the Torah 5:8:2	בפרק כל הבשר (דף ק"ח ע"ב	פרק כל הבשר (חולין דף ק"ח ע"ב
Nachal Eitan on Mishneh Torah, Foundations of the Torah 5:8:2	בפרק כל שעה (דף כ"ב	רק כל שעה (פסחים דף כ"ב
Nachal Eitan on Mishneh Torah, Foundations of the Torah 5:8:2	בפרק כל שעה (דף כ"ב	ק כל שעה (פסחים דף כ"ב
Melechet Shlomo on Mishneh Torah, Agents and Partners 3:7:1	בפ' יש נוחלין דף קכ"ז	בפ' יש נוחלין (בבא בתרא דף קכ"ז)
Melechet Shlomo on Mishneh Torah, Agents and Partners 3:7:1	בפ' שבועת העדות דף ל"ג	בפ' שבועת העדות (שבועות דף ל"ג)
Melechet Shlomo on Mishneh Torah, Agents and Partners 8:7:1	בפ' מי שמת דף קמ"ד	בפ' מי שמת (בבא בתרא דף קמ"ד)
Melechet Shlomo on Mishneh Torah, Agents and Partners 9:2:1	בפ' אלו מציאות דף כ"ו	בפ' אלו מציאות (בבא מציעא דף כ"ו)
Melechet Shlomo on Mishneh Torah, Agents and Partners 9:3:1	פ' הכותב דף פ"ו	פ' הכותב (כתובות דף פ"ו)
Yad Eitan on Mishneh Torah, Service on the Day of Atonement 1:2:1	בפ' בא לו (דף ע'	בפ' בא לו (יומא דף ע'
Nachal Eitan on Mishneh Torah, Foreign Worship and Customs of the Nations 2:10:1	בפרק הערל (דף פ' ע"ב	בפרק הערל (יבמות דף פ' ע"ב
Nachal Eitan on Mishneh Torah, Foreign Worship and Customs of the Nations 7:10:1	בפרק הערל (דף פ"ב	בפרק הערל (יבמות דף פ"ב
Yad Eitan on Mishneh Torah, Sabbath 12:15:1	בס"פ כיצד מעברין (ס' ע"ב	בס"פ כיצד מעברין (עירובין ס' ע"ב
Nachal Eitan on Mishneh Torah, Shofar, Sukkah and Lulav 1:4:1	בפרק רבי אליעזר דמילה (דף ק"ל	בפרק רבי אליעזר דמילה (שבת דף ק"ל
Melechet Shlomo on Mishneh Torah, The Sanhedrin and the Penalties within their Jurisdiction 2:7:1	פ' זה בורר דף כ"ו	פ' זה בורר (סנהדרין דף כ"ו)
Melechet Shlomo on Mishneh Torah, The Sanhedrin and the Penalties within their Jurisdiction 7:3:1	בפרק שבועת הדיינים דף ל"ט	בפרק שבועת הדיינים (שבועות דף ל"ט)
Melechet Shlomo on Mishneh Torah, The Sanhedrin and the Penalties within their Jurisdiction 7:3:1	בפרק זה בורר דף כ"ג	בפרק זה בורר (סנהדרין דף כ"ג)
Melechet Shlomo on Mishneh Torah, The Sanhedrin and the Penalties within their Jurisdiction 7:3:1	בפ' שבועת הדיינים דף ל"ט	ם בפ' שבועת הדיינים (שבועות דף ל"ט)
Melechet Shlomo on Mishneh Torah, Theft 2:1:1	בפ' התכלת דף מ"ט ע"א	בפ' התכלת (מנחות דף מ"ט ע"א)
Melechet Shlomo on Mishneh Torah, Theft 2:12:1	בפ' מרובה דף ע"ח	בפ' מרובה (בבא קמא דף ע"ח)
Melechet Shlomo on Mishneh Torah, Theft 2:12:1	פ' הנשרפין דף פ'	פ' הנשרפין (סנהדרין דף פ')
Melechet Shlomo on Mishneh Torah, Theft 2:12:1	בפ' אלו טרפות דף נ"ח	ן בפ' אלו טרפות (חולין דף נ"ח)
Yad Eitan on Mishneh Torah, Vows 2:14:1	פ' מי שמת (דף קמ"ח	פ' מי שמת (בבא בתרא דף קמ"ח
Chidushei Mayim Chayim on Mishneh Torah, Torah Study 5:2:1	בפרק הדר בסוף דף ס"ב	בפרק הדר בסוף (עירובין דף ס"ב)
Chidushei Mayim Chayim on Mishneh Torah, Torah Study 5:9:2	בפ' כיצד מברכין דף מ"ג	בפ' כיצד מברכין (ברכות דף מ"ג)
Chidushei Mayim Chayim on Mishneh Torah, Torah Study 6:5:1	בפ' ערבי פסחים דף קי"א ע"ב	בפ' ערבי פסחים (פסחים דף קי"א ע"ב)
Chidushei Mayim Chayim on Mishneh Torah, Torah Study 6:5:1	בפ' גיד הנשה דף צ"א	בפ' גיד הנשה (חולין דף צ"א)
Nachal Eitan on Mishneh Torah, Reading the Shema 1:9:1	בפרק מי שמתו (דף כ"א	בפרק מי שמתו (ברכות דף כ"א
Nachal Eitan on Mishneh Torah, Reading the Shema 2:8:1	בפרק מי שמתו (דף כ'	בפרק מי שמתו (ברכות דף כ'
Nachal Eitan on Mishneh Torah, Reading the Shema 2:8:1	פרק שואל (דף ק"נ	רק שואל (שבת דף ק"נ
Nachal Eitan on Mishneh Torah, Reading the Shema 2:8:1	פרק מי שמתו (דף כ"א	ק מי שמתו (ברכות דף כ"א
Nachal Eitan on Mishneh Torah, Reading the Shema 3:1:1	פ' תפלת השחר (דף כ"ו	פ' תפלת השחר (ברכות דף כ"ו
Chidushim of Machaneh Ephraim on Mishneh Torah, Forbidden Intercourse 20:16:1	בפרק בכל מערבין דף ל"ו	בפרק בכל מערבין (עירובין דף ל"ו)
Divrei Yirmiyahu on Mishneh Torah, Sabbath 12:8:3	בפרק כלל גדול ע"ג ע"ב	בפרק כלל גדול (שבת ע"ג ע"ב)
Divrei Yirmiyahu on Mishneh Torah, Sabbath 25:6:2	בפ' כל הכלים קכ"ד ע"ב	בפ' כל הכלים (שבת קכ"ד ע"ב)
Divrei Yirmiyahu on Mishneh Torah, Sabbath 25:21:1	בפ' כירה דף מ"ד	בפ' כירה (שבת דף מ"ד)
Divrei Yirmiyahu on Mishneh Torah, Sabbath 29:4:1	בפ' מי שמתו דף י"ח ע"א	בפ' מי שמתו (ברכות דף י"ח ע"א)
Ben Aryeh on Mishneh Torah, Sacrificial Procedure 10:9:1	פרק הערל דף ע' ע"ב	פרק הערל (יבמות דף ע' ע"ב)
Ben Aryeh on Mishneh Torah, Heave Offerings 10:7:1	בפרק כיצד מברכין דף ל"ה ע"ב	בפרק כיצד מברכין (ברכות דף ל"ה ע"ב)
Ben Aryeh on Mishneh Torah, The Sanhedrin and the Penalties within their Jurisdiction 23:6:1	בפרק גט פשוט דף קס"ז	בפרק גט פשוט (בבא בתרא דף קס"ז)
Melechet Shlomo on Mishneh Torah, Sacrifices Rendered Unfit 4:1:1	בפ' המביא אשם דף כ"ו ע"א	בפ' המביא אשם (כריתות דף כ"ו ע"א)
Melechet Shlomo on Mishneh Torah, Sacrifices Rendered Unfit 4:1:1	בפ' הגוזל בתרא דף קי"ב	ובפ' הגוזל בתרא (בבא קמא דף קי"ב)
Melechet Shlomo on Mishneh Torah, Defilement of Foods 4:1:1	בפ' אלו עוברין דף מ"ט	בפ' אלו עוברין (פסחים דף מ"ט)
Melechet Shlomo on Mishneh Torah, Defilement of Foods 4:1:1	בפ' העור והרוטב דף קי"ח	בפ' העור והרוטב (חולין דף קי"ח)
Chidushei Mayim Chayim on Mishneh Torah, Human Dispositions 2:3:1	בפרק ערבי פסחים דף קי"ג ע"ב	בפרק ערבי פסחים (פסחים דף קי"ג ע"ב)
Melechet Shlomo on Mishneh Torah, Nazariteship 1:17:1	פ' מי שמת דף ק"מ ע"ב	פ' מי שמת (בבא בתרא דף ק"מ ע"ב)
Melechet Shlomo on Mishneh Torah, Nazariteship 7:7:1	בפ' מי שמתו דף י"ט	בפ' מי שמתו (ברכות דף י"ט)
Melechet Shlomo on Mishneh Torah, Nazariteship 7:7:1	בפ' כהן גדול דף נ"ב	בפ' כהן גדול (נזיר דף נ"ב)
Nachal Eitan on Mishneh Torah, Scroll of Esther and Hanukkah 1:1:1	פרק איזהו נשך (דף ס"א ע"א	פרק איזהו נשך (בבא מציעא דף ס"א ע"א
Ben Aryeh on Mishneh Torah, Sabbatical Year and the Jubilee 7:11:1	בפרק מקום שנהגו דף נ"ג.	בפרק מקום שנהגו (פסחים דף נ"ג.)
Yekar Tiferet on Mishneh Torah, Slaves 1:8:2	בפ' החולץ [דף מ"ו	בפ' החולץ (יבמות דף מ"ו)
Melechet Shlomo on Mishneh Torah, Testimony 3:5:1	פ' ארבעה אחין דף ל"א	פ' ארבעה אחין (יבמות דף ל"א)
Melechet Shlomo on Mishneh Torah, Testimony 3:5:1	בפ' חזקת הבתים דף ל"ב	בפ' חזקת הבתים (בבא בתרא דף ל"ב)
Melechet Shlomo on Mishneh Torah, Testimony 3:8:1	בפ' חזקת הבתים דף מ"ט	בפ' חזקת הבתים (בבא בתרא דף מ"ט)
Melechet Shlomo on Mishneh Torah, Testimony 13:8:1	פ' שבועת העדות דף ל"ג	פ' שבועת העדות (שבועות דף ל"ג)
Melechet Shlomo on Mishneh Torah, Testimony 14:1:1	בפ' יש נוחלין דף קכ"ח	בפ' יש נוחלין (בבא בתרא דף קכ"ח)
Melechet Shlomo on Mishneh Torah, Marriage 3:8:1	בפ' הכותב דף פ"ה	בפ' הכותב (כתובות דף פ"ה)
Melechet Shlomo on Mishneh Torah, Marriage 6:8:1	בפ' המגרש דף פ"ד	בפ' המגרש (גיטין דף פ"ד)
Melechet Shlomo on Mishneh Torah, Marriage 21:1:1	בפ' מי שמת דף קמ"ד	בפ' מי שמת (בבא בתרא דף קמ"ד)
Nachal Eitan on Mishneh Torah, Sanctification of the New Month 3:5:1	פרק ד' מיתות (דף מ"ט	פרק ד' מיתות (סנהדרין דף מ"ט
Ben Aryeh on Mishneh Torah, Eruvin 4:14:1	בפ' חלון ד' פ"א ע"ב	בפ' חלון (עירובין ד' פ"א ע"ב)
Nachal Eitan on Mishneh Torah, Rest on a Holiday 2:3:1	בפרק כירה (דף מ"ו ע"ב	בפרק כירה (שבת דף מ"ו ע"ב
Nachal Eitan on Mishneh Torah, Rest on a Holiday 2:3:2	פרק כירה (דף מ"ו ע"ב	פרק כירה (שבת דף מ"ו ע"ב
Nachal Eitan on Mishneh Torah, Rest on a Holiday 7:1:1	בפרק כל כתבי (דף קי"ז ע"ב	בפרק כל כתבי (שבת דף קי"ז ע"ב
Nachal Eitan on Mishneh Torah, Rest on a Holiday 7:8:1	בר"פ ערבי פסחים (דף ק'	בר"פ ערבי פסחים (פסחים דף ק'
Nachal Eitan on Mishneh Torah, Rest on a Holiday 7:8:1	פרק תולין (דף קל"ט	רק תולין (שבת דף קל"ט
Nachal Eitan on Mishneh Torah, Rest on a Holiday 7:8:1	בפרק כל כתבי (דף קי"ז	רק כל כתבי (שבת דף קי"ז
Nachal Eitan on Mishneh Torah, Leavened and Unleavened Bread 1:3:1	בפרק אלו עוברין (דף מ"ח ע"ב	בפרק אלו עוברין (פסחים דף מ"ח ע"ב
Nachal Eitan on Mishneh Torah, Leavened and Unleavened Bread 3:3:1	בפרק אלו עוברין (דף מ"ח	בפרק אלו עוברין (פסחים דף מ"ח
Nachal Eitan on Mishneh Torah, Leavened and Unleavened Bread 5:7:1	בפרק כל שעה (דף ל"ו	בפרק כל שעה (פסחים דף ל"ו
Nachal Eitan on Mishneh Torah, Leavened and Unleavened Bread 6:3:1	בפרק ערבי פסחים (דף קי"ד ע"ב	בפרק ערבי פסחים (פסחים דף קי"ד ע"ב
Nachal Eitan on Mishneh Torah, Leavened and Unleavened Bread 7:1:1	פרק ערבי פסחים (דף קט"ז	פרק ערבי פסחים (פסחים דף קט"ז
Nachal Eitan on Mishneh Torah, Blessings 1:2:2	בפ' אלו טריפות (ריש דף מ"ו	בפ' אלו טריפות (ריש חולין דף מ"ו
Nachal Eitan on Mishneh Torah, Blessings 1:2:2	פ' כיצד משתתפין (דף פ"ב	' כיצד משתתפין (עירובין דף פ"ב
Nachal Eitan on Mishneh Torah, Blessings 1:7:1	בפ' מי שמתו (סוף דף כ'	בפ' מי שמתו (סוף ברכות דף כ'
Nachal Eitan on Mishneh Torah, Blessings 1:11:1	פרק מי שמתו (דף כ' ע"ב	פרק מי שמתו (ברכות דף כ' ע"ב
Nachal Eitan on Mishneh Torah, Blessings 1:11:1	פ' הרואה (דף נ"ד ע"ב	' הרואה (ברכות דף נ"ד ע"ב
Nachal Eitan on Mishneh Torah, Blessings 3:2:1	בפרק כיצד מברכין (דף ל"ז	בפרק כיצד מברכין (ברכות דף ל"ז
Nachal Eitan on Mishneh Torah, Blessings 3:2:1	פ' כיצד מברכין (דף מ"ד ע"א	' כיצד מברכין (ברכות דף מ"ד ע"א
Nachal Eitan on Mishneh Torah, Blessings 4:4:1	פ' חלון (סוף דף פ"א	פ' חלון (סוף עירובין דף פ"א
Nachal Eitan on Mishneh Torah, Blessings 4:4:1	פ' ערבי פסחים (דף ק"ב ע"א	' ערבי פסחים (פסחים דף ק"ב ע"א
Nachal Eitan on Mishneh Torah, Blessings 4:4:1	בפרק מי שהוציאוהו (דף מ"ב	רק מי שהוציאוהו (עירובין דף מ"ב
Nachal Eitan on Mishneh Torah, Blessings 6:15:1	בפרק בכל מערבין (דף ל"ו	בפרק בכל מערבין (עירובין דף ל"ו
Nachal Eitan on Mishneh Torah, Blessings 10:8:1	בפרק ערבי פסחים (דף ק"ב	בפרק ערבי פסחים (פסחים דף ק"ב
Nachal Eitan on Mishneh Torah, Blessings 10:8:1	בפ' הרואה (דף ס'	פ' הרואה (ברכות דף ס'
Nachal Eitan on Mishneh Torah, Blessings 10:8:1	פרק מקום שנהגו (דף נ"ד ע"ב	ק מקום שנהגו (פסחים דף נ"ד ע"ב
Nachal Eitan on Mishneh Torah, Circumcision 1:10:1	בפרק ר' אליעזר דמילה (דף קל"א	בפרק ר' אליעזר דמילה (שבת דף קל"א
Nachal Eitan on Mishneh Torah, Circumcision 2:3:1	בפרק ר' אליעזר דמילה (דף קל"ג ע"ב	בפרק ר' אליעזר דמילה (שבת דף קל"ג ע"ב
Nachal Eitan on Mishneh Torah, Circumcision 2:4:1	בפרק ר' אליעזר דמילה (דף קל"ג ע"ב	בפרק ר' אליעזר דמילה (שבת דף קל"ג ע"ב
Nachal Eitan on Mishneh Torah, Circumcision 2:4:1	בפרק החולץ (דף מ"ו	פרק החולץ (יבמות דף מ"ו
Yad Eitan on Mishneh Torah, Firstlings 1:15:1	פ' כל פסולי המוקדשין (דף ל"ה ע"א	פ' כל פסולי המוקדשין (בכורות דף ל"ה ע"א
Yad Eitan on Mishneh Torah, Firstlings 6:9:1	ס"פ עד כמה (דף ל"א	ס"פ עד כמה (בכורות דף ל"א
Divrei Yirmiyahu on Mishneh Torah, Circumcision 1:1:1	בפרק כסוי הדם דף פ"ז ע"א	בפרק כסוי הדם (חולין דף פ"ז ע"א)
Divrei Yirmiyahu on Mishneh Torah, Circumcision 1:18:1	ר"פ הערל בדף ע' ע"א	ר"פ הערל (יבמות בדף ע' ע"א)
Lev Shalem on Mishneh Torah, Blessings 1:2:1	בפ' כיצד מברכין דף מ"ד	בפ' כיצד מברכין (ברכות דף מ"ד)
Melechet Shlomo on Mishneh Torah, Forbidden Foods 8:18:1	בפ' כל שעה דף כ"ג.	בפ' כל שעה (פסחים דף כ"ג.)
Melechet Shlomo on Mishneh Torah, Forbidden Foods 17:27:1	פ' תולין דף קל"ט	פ' תולין (שבת דף קל"ט)
Chidushei Mayim Chayim on Mishneh Torah, Foundations of the Torah 5:1:1	בפרק אין מעמידין דף כ"ז ע"ב	בפרק אין מעמידין (עבודה זרה דף כ"ז ע"ב)
B'Mareh HaBazak Volume IX 33:7	בפרק מצות חליצה דף קב	בפרק מצות חליצה (יבמות דף קב)
B'Mareh HaBazak Volume VI 84:9	פרק אלמנה לכ"ג (סט ע"ב	פרק אלמנה לכ"ג (יבמות סט ע"ב
B'Mareh HaBazak Volume VII 55:6	פרק במה טומנים (דף נא ע"א	פרק במה טומנים (שבת דף נא ע"א
B'Mareh HaBazak Volume VII 108:6	בפרק החובל (פה ע"ב	בפרק החובל (בבא קמא פה ע"ב
