Tosafot on Sukkah 11a:6:1	בסוף פירקין (דף יט:	בסוף פירקין (סוכה דף יט:
Tosafot on Sukkah 34b:4:1	בריש פירקין (דף כט:	בריש פירקין (סוכה דף כט:
Tosafot on Sukkah 36a:5:2	בריש פירקין (דף לא:	בריש פירקין (סוכה דף לא:
Tosafot on Sukkah 37a:7:1	בסוף פירקין (דף מב.	בסוף פירקין (סוכה דף מב.
Tosafot on Sukkah 37a:7:1	סוף פירקין לא	
Tosafot on Sukkah 39a:3:2	בסוף פירקין (דף מב.	בסוף פירקין (סוכה דף מב.
Tosafot on Sukkah 39a:3:2	בסוף פירקין (דף מב.	סוף פירקין (סוכה דף מב.
Tosafot on Sukkah 39a:3:2	בסוף פירקין (דף מב.	וף פירקין (סוכה דף מב.
Tosafot on Sukkah 39a:3:2	בסוף פירקין (דף מא:	ף פירקין (סוכה דף מא:
Rashi on Zevachim 111a:18:1	בריש פירקין (דף קז.	בריש פירקין (זבחים דף קז.
Rashi on Zevachim 117b:6:2	בסוף פירקין (דף קיט:	בסוף פירקין (זבחים דף קיט:
Rashi on Chullin 12b:3:1	בריש פירקין (דף ב:	בריש פירקין (חולין דף ב:
Rashi on Chullin 17a:16:2	בריש פירקין (דף ג.	בריש פירקין (חולין דף ג.
Rashi on Chullin 54a:9:1	בריש פירקין (דף מב.	בריש פירקין (חולין דף מב.
Rashi on Chullin 54b:9:1	[בריש פרקין] (דף מב:	[בריש פרקין] (חולין דף מב:
Rashi on Chullin 55b:4:2	בריש פירקין (דף מח.	בריש פירקין (חולין דף מח.
Rashi on Chullin 124b:12:1	בריש פירקין (דף קיח.	בריש פירקין (חולין דף קיח.
Rashi on Chullin 128a:7:1	בריש פרקין (דף קיח.	בריש פרקין (חולין דף קיח.
Rashi on Eruvin 15b:13:1	בריש פירקין (דף ד.	בריש פירקין (עירובין דף ד.
Tosafot on Moed Katan 23a:8:1	בריש פירקין (ד' יג:	בריש פירקין (מועד קטן ד' יג:
Tosafot on Shabbat 42b:6:2	בסוף פירקין (דף מז.	בסוף פירקין (שבת דף מז.
Rosh on Eruvin 6:17:2	סוף פירקין דף עה:	סוף פירקין (עירובין דף עה:)
Ran on Nedarim 43a:2:1	בריש פירקין (דף לב:	בריש פירקין (נדרים דף לב:
Rashi on Yoma 81b:1:2	בריש פרקין (דף עד.	בריש פרקין (יומא דף עד.
Rosh on Yevamot 6:10:2	סוף פרקין דף סה:	סוף פרקין (יבמות דף סה:)
Tosafot on Bava Kamma 22b:2:1	סוף פירקין (ד' כז.	סוף פירקין (בבא קמא ד' כז.
Tosafot on Bava Kamma 23a:2:1	בסוף פירקין (דף כו:	בסוף פירקין (בבא קמא דף כו:
Rashi on Sanhedrin 13b:11:2	בריש פירקין (דף ב:	בריש פירקין (סנהדרין דף ב:
Rashi on Sanhedrin 105a:10:2	בריש פרקין (דף צא:	בריש פרקין (סנהדרין דף צא:
Tosafot on Sanhedrin 3b:3:1	סוף פירקין (דף יד:	סוף פירקין (סנהדרין דף יד:
Tosafot on Sanhedrin 3b:11:1	בריש פירקין (דף ב.	בריש פירקין (סנהדרין דף ב.
Tosafot on Sanhedrin 3b:15:1	בסוף פירקין (דף יז.	בסוף פירקין (סנהדרין דף יז.
Tosafot on Sanhedrin 53a:3:1	בסוף פירקין (דף סו:	בסוף פירקין (סנהדרין דף סו:
Rashi on Kiddushin 10b:11:1	בריש פירקין (דף ה.	בריש פירקין (קידושין דף ה.
Rashi on Kiddushin 21b:4:1	בריש פירקין (דף טו.	בריש פירקין (קידושין דף טו.
Tosafot on Bava Metzia 53b:2:1	בריש פירקין (דף מה.	בריש פירקין (בבא מציעא דף מה.
Tosafot on Bava Metzia 64a:7:1	בסוף פירקין (דף עג.	בסוף פירקין (בבא מציעא דף עג.
Tosafot on Bava Metzia 64a:11:1	ובסוף פירקין (ד' עג:	ובסוף פירקין (בבא מציעא ד' עג:
Tosafot on Bava Metzia 64b:4:1	סוף פרקין (ד' עה:	סוף פרקין (בבא מציעא ד' עה:
Tosafot on Bava Metzia 66b:10:1	בסוף פירקין (דף עג:	בסוף פירקין (בבא מציעא דף עג:
Tosafot on Bava Metzia 66b:19:1	בריש פירקין (דף סב.	בריש פירקין (בבא מציעא דף סב.
Tosafot on Bava Metzia 113a:6:2	בסוף פירקין (דף קטז.	בסוף פירקין (בבא מציעא דף קטז.
Tosafot on Makkot 9a:8:4	בריש פירקין (דף ז:	בריש פירקין (מכות דף ז:
Tosafot on Gittin 11b:10:1	בריש פירקין (דף ה.	בריש פירקין (גיטין דף ה.
Rashi on Yevamot 41b:3:2	בריש פירקין (דף לה:	בריש פירקין (יבמות דף לה:
Rashi on Yevamot 44a:22:1	בריש פרקין (מא.	בריש פרקין (יבמות מא.
Rashi on Yevamot 72b:12:1	בריש פירקין (דף ע.	בריש פירקין (יבמות דף ע.
Rashi on Yevamot 73b:3:1	בריש פירקין (דף ע.	בריש פירקין (יבמות דף ע.
Tosafot on Rosh Hashanah 11a:9:1	בריש פירקין (דף ב:	בריש פירקין (ראש השנה דף ב:
Tosafot on Shevuot 25a:15:1	בריש פירקין (דף יט:	בריש פירקין (שבועות דף יט:
Tosafot on Shevuot 26b:14:1	בסוף פירקין (דף כט.	בסוף פירקין (שבועות דף כט.
Rashi on Menachot 6b:4:1	בריש פירקין (דף ב:	בריש פירקין (מנחות דף ב:
Rashi on Menachot 12a:2:1	בריש פירקין (דף ב:	בריש פירקין (מנחות דף ב:
Rashi on Menachot 12a:5:1	בריש פירקין (דף ב.	בריש פירקין (מנחות דף ב.
Tosafot on Menachot 57b:1:1	בריש פירקין (דף נג:	בריש פירקין (מנחות דף נג:
Tosafot on Menachot 60a:12:1	בריש פירקין (דף נג.	בריש פירקין (מנחות דף נג.
Tosafot on Menachot 66a:16:1	סוף פירקין (דף עא.	סוף פירקין (מנחות דף עא.
Tosafot on Menachot 66a:16:1	בסוף פירקין (דף עב.	סוף פירקין (מנחות דף עב.
Tosafot on Menachot 66a:16:1	בסוף פירקין (דף עב.	וף פירקין (מנחות דף עב.
Tosafot on Menachot 72a:8:1	בריש פירקין (דף סו.	בריש פירקין (מנחות דף סו.
Tosafot on Menachot 72a:9:1	בריש פירקין (דף סו.	בריש פירקין (מנחות דף סו.
Tosafot on Menachot 90a:19:1	בריש פירקין (דף פח.	בריש פירקין (מנחות דף פח.
Tosafot on Zevachim 28a:2:1	בסוף פירקין (דף לא:	בסוף פירקין (זבחים דף לא:
Tosafot on Zevachim 92a:8:1	בסוף פירקין (דף צח.	בסוף פירקין (זבחים דף צח.
Tosafot on Zevachim 108b:14:1	בריש פירקין (דף קז.	בריש פירקין (זבחים דף קז.
Tosafot on Zevachim 117b:4:1	בסוף פירקין (דף קיט.	בסוף פירקין (זבחים דף קיט.
Tosafot on Zevachim 117b:4:1	בסוף פירקין (קיג.	סוף פירקין (זבחים קיג.
Rashbam on Bava Batra 42b:4:2	בריש פרקין (דף כט:	בריש פרקין (בבא בתרא דף כט:
Tosafot on Chullin 29b:6:1	ובסוף פרקין (דף מ:	ובסוף פרקין (חולין דף מ:
Tosafot on Chullin 36a:1:1	בסוף פירקין (דף כו.	בסוף פירקין (חולין דף כו.
Tosafot on Chullin 50b:11:1	בריש פירקין (דף מג.	בריש פירקין (חולין דף מג.
Tosafot on Chullin 53b:9:1	בריש פירקין (מג.	בריש פירקין (חולין מג.
Tosafot on Chullin 54a:13:1	בריש פירקין (דף מב.	בריש פירקין (חולין דף מב.
Tosafot on Chullin 54b:9:1	בריש פרקין (דף מב:	בריש פרקין (חולין דף מב:
Tosafot on Chullin 89b:7:3	ובסוף פירקין (דף קא.	ובסוף פירקין (חולין דף קא.
Tosafot on Chullin 96a:13:1	ובסוף פירקין (דף קב:	ובסוף פירקין (חולין דף קב:
Tosafot on Chullin 101a:6:1	בריש פירקין (דף צ.	בריש פירקין (חולין דף צ.
Tosafot on Chullin 124b:3:1	ריש פירקין (דף קיט.	ריש פירקין (חולין דף קיט.
Tosafot on Chullin 124b:6:1	בריש פירקין (דף קיח:	בריש פירקין (חולין דף קיח:
Rashi on Rosh Hashanah 8a:10:1	בריש פרקין (דף ב.	בריש פרקין (ראש השנה דף ב.
Rashi on Rosh Hashanah 8a:14:1	בריש פרקין (דף ג:	בריש פרקין (ראש השנה דף ג:
Rashi on Avodah Zarah 48b:15:1	בריש פירקין (דף מב.	בריש פירקין (עבודה זרה דף מב.
Rashi on Avodah Zarah 49b:15:1	בריש פירקין (דף מא.	בריש פירקין (עבודה זרה דף מא.
Rashi on Avodah Zarah 52b:1:1	בריש פירקין (דף נ.	בריש פירקין (עבודה זרה דף נ.
Tosafot on Avodah Zarah 49b:15:1	בריש פירקין (דף מא.	בריש פירקין (עבודה זרה דף מא.
Tosafot on Yevamot 5a:7:1	בסוף פירקין (דף לב.	בסוף פירקין (יבמות דף לב.
Tosafot on Yevamot 44b:15:2	בסוף פירקין (דף מט.	בסוף פירקין (יבמות דף מט.
Tosafot on Yevamot 59a:14:2	בריש פירקין (דף נה.	בריש פירקין (יבמות דף נה.
Tosafot on Yevamot 74a:9:1	בריש פירקין (דף ע.	בריש פירקין (יבמות דף ע.
Tosafot on Yevamot 93b:8:1	ריש פרקין (דף פח:	ריש פרקין (יבמות דף פח:
Rashi on Keritot 3a:36:1	בסוף פירקין (דף ז.	בסוף פירקין (כריתות דף ז.
Tosafot on Bekhorot 4a:12:1	בסוף פרקין (יב:	בסוף פרקין (בכורות יב:
Tosafot on Bekhorot 25a:66:1	בסוף פירקין (דף כו.	בסוף פירקין (בכורות דף כו.
Tosafot on Bekhorot 52b:25:1	ריש פירקין (מח.	ריש פירקין (בכורות מח.
Tosafot on Bekhorot 58b:1:1	בריש פירקין (דף נג:	בריש פירקין (בכורות דף נג:
Tosafot on Bekhorot 61a:27:1	בריש פירקין (דף נג.	בריש פירקין (בכורות דף נג.
Rashi on Arakhin 27a:7:1	בריש פירקין (דף כד.	בריש פירקין (ערכין דף כד.
Rashi on Bekhorot 12a:60:2	בריש פירקין (דף ג:	בריש פירקין (בכורות דף ג:
Rashba on Avodah Zarah 71a:2	בריש פרקין (סג, ב	בריש פרקין (עבודה זרה סג, ב
Rashba on Avodah Zarah 72a:3	בריש פרקין (סב, ב	בריש פרקין (עבודה זרה סב, ב
Rashba on Avodah Zarah 73a:2	בריש פרקין (סב, ב	בריש פרקין (עבודה זרה סב, ב
Rashba on Bava Batra 36b:1	בריש פירקין (כח, ב	בריש פירקין (בבא בתרא כח, ב
Rashba on Bava Batra 57b:1	בריש פירקין (כט א	בריש פירקין (בבא בתרא כט א
Rashba on Berakhot 40b:3	בסוף פירקין (מה, א	בסוף פירקין (ברכות מה, א
Rashba on Berakhot 41b:5	בריש פרקין (לה, ב	בריש פרקין (ברכות לה, ב
Rashba on Berakhot 49a:1	בריש פרקין (מו, א	בריש פרקין (ברכות מו, א
Rashba on Chullin 10b:4	בריש פירקין (ג, א	בריש פירקין (חולין ג, א
Rashba on Chullin 10b:4	בריש פירקין (ב, א	ריש פירקין (חולין ב, א
Rashba on Chullin 52a:2	בריש פרקין   (מב, ב	בריש פרקין   (חולין מב, ב
Rashba on Chullin 53b:4	בריש פירקין (מג, ב	בריש פירקין (חולין מג, ב
Rashba on Chullin 53b:7	בריש פירקין (מג, ב	בריש פירקין (חולין מג, ב
Rashba on Chullin 54a:3	בריש פירקין   (מג, א	בריש פירקין   (חולין מג, א
Rashba on Chullin 54b:1	בריש פירקין (מב, ב	בריש פירקין (חולין מב, ב
Rashba on Chullin 54b:3	בריש פירקין   (מב, ב	בריש פירקין   (חולין מב, ב
Rashba on Chullin 75b:4	בריש   פירקין (סט, א	בריש   פירקין (חולין סט, א
Rashba on Chullin 76a:2	בריש פירקין (סח, ב	בריש פירקין (חולין סח, ב
Rashba on Chullin 92b:3	בריש פירקין (פט, ב	בריש פירקין (חולין פט, ב
Rashba on Gittin 10a:1	בריש פירקין (ג, א	בריש פירקין (גיטין ג, א
Rashba on Gittin 84b:1	בריש פירקין (פב, ב	בריש פירקין (גיטין פב, ב
Rashba on Ketubot 38a:2	ובריש פרקין (כט, ב	ובריש פרקין (כתובות כט, ב
Rashba on Ketubot 41b:5	בריש פרקין (מב, ב	בריש פרקין (כתובות מב, ב
Rashba on Ketubot 54a:1	בריש פירקין (מג, ב	בריש פירקין (כתובות מג, ב
Rashba on Ketubot 58b:4	בריש פרקין (נו, ב	בריש פרקין (כתובות נו, ב
Rashba on Ketubot 63b:4	בריש פרקין (נד, ב	בריש פרקין (כתובות נד, ב
Rashba on Kiddushin 11a:3	בריש פרקין (ג, א	בריש פרקין (קידושין ג, א
Rashba on Kiddushin 66b:3	בסוף פרקין (סח, א	בסוף פרקין (קידושין סח, א
Rashba on Yevamot 20a:4	בריש פרקין (יח, ב	בריש פרקין (יבמות יח, ב
Rashba on Yevamot 20a:4	בריש פרקין (יח, א	ריש פרקין (יבמות יח, א
Rashba on Yevamot 95b:2	בריש פרקין (פח, ב	בריש פרקין (יבמות פח, ב
Rashba on Yevamot 111b:1	בריש פרקין (קז, ב	בריש פרקין (יבמות קז, ב
Rashba on Bava Metzia 25b:7	בריש פרקין (כא, ב	בריש פרקין (בבא מציעא כא, ב
Rashba on Bava Metzia 53a:5	בריש פירקין (מה, א	בריש פירקין (בבא מציעא מה, א
Rashba on Bava Metzia 67a:2	בריש פרקין (סב, א	בריש פרקין (בבא מציעא סב, א
Rashba on Bava Metzia 71b:1	בריש פרקין (סב, א	בריש פרקין (בבא מציעא סב, א
Rashba on Bava Metzia 71b:7	בריש פרקין (סא, ב	בריש פרקין (בבא מציעא סא, ב
Rashba on Bava Metzia 72b:1	בריש פרקין (סג, ב	בריש פרקין (בבא מציעא סג, ב
Rashba on Bava Metzia 72b:2	בריש פרקין (סג, א	בריש פרקין (בבא מציעא סג, א
Rashba on Bava Metzia 72b:2	בריש פרקין (סג, ב	ריש פרקין (בבא מציעא סג, ב
Rashba on Beitzah 7a:4	בריש פרקין (ג, א	בריש פרקין (ביצה ג, א
Rashba on Beitzah 22b:3	בריש פרקין (י״ז, א	בריש פרקין (ביצה י״ז, א
Rashba on Shabbat 27b:3	בריש פרקין (כא, א	בריש פרקין (שבת כא, א
Rashba on Shabbat 27b:4	בריש פרקין (כא, א	בריש פרקין (שבת כא, א
Rashba on Shabbat 50b:1	בריש פרקין (מח, ב	בריש פרקין (שבת מח, ב
Rashba on Shabbat 124a:3	בריש פרקין (קכב, ב	בריש פרקין (שבת קכב, ב
Rashba on Eruvin 44b:1	ריש פרקין (מא, ב	ריש פרקין (עירובין מא, ב
Rashba on Eruvin 48a:5	ריש פרקין (מא, ב	ריש פרקין (עירובין מא, ב
Rashba on Eruvin 55a:3	בסוף פירקין (סא, א	בסוף פירקין (עירובין סא, א
Rashba on Eruvin 74b:5	בריש פירקין (סה, ב	בריש פירקין (עירובין סה, ב
Rashba on Eruvin 91b:1	בריש פרקין (פט, ב	בריש פרקין (עירובין פט, ב
Rashba on Eruvin 93a:3	בריש פרקין (פט, ב	בריש פרקין (עירובין פט, ב
Rosh on Nedarim 11:6:1	בריש פירקין דף פ.	בריש פירקין (נדרים דף פ.)
Maharam Shif on Bava Kamma 34a:1	סוף פרקין דף ל״ו	סוף פרקין (בבא קמא דף ל״ו)
Yad Ramah on Sanhedrin 31b:7	בריש פירקין (כ״ג.	בריש פירקין (סנהדרין כ״ג.
Yad Ramah on Sanhedrin 64b:5	בריש פירקין (נ״א:	בריש פירקין (סנהדרין נ״א:
Tosafot Yom Tov on Mishnah Bava Kamma 1:2:9	ריש פרקין [ד' ע״א	ריש פרקין (בבא קמא ד' ע״א)
Tosafot Yom Tov on Mishnah Bava Kamma 1:4:2	ריש פרקין [דף ב' ע״ב	ריש פרקין (בבא קמא דף ב' ע״ב)
Tosafot Yom Tov on Mishnah Bava Metzia 3:9:1	בסוף פרקין [דף מ״ג	בסוף פרקין (בבא מציעא דף מ״ג)
Tosafot Yom Tov on Mishnah Sanhedrin 1:6:2	ריש פירקין דף ג' ע״ב	ריש פירקין (סנהדרין דף ג' ע״ב)
Tosafot Yom Tov on Mishnah Yoma 2:5:2	ריש פרקין [כב.	ריש פרקין (יומא כב.)
Tosafot Yom Tov on Mishnah Zevachim 5:7:3	בסוף פרקין [נ״ו ע״ב	בסוף פרקין [זבחים נ״ו ע״ב
Tosafot Yom Tov on Mishnah Yevamot 8:6:1	בריש פירקין דף ע״ה	בריש פירקין (יבמות דף ע״ה)
Chiddushei Ramban on Bava Metzia 67a:1	בריש פירקין (ס״ב ע״א	בריש פירקין (בבא מציעא ס״ב ע״א
Chokhmat Shlomo on Shabbat 96b:3	בריש פרקין דף ד'	בריש פרקין (שבת דף ד')
Rashba on Bava Kamma 2b:8	בסוף פרקין (טו, ב	בסוף פרקין (בבא קמא טו, ב
Rashba on Bava Kamma 76a:3	בריש פרקין (סג, א	בריש פרקין (בבא קמא סג, א
Maharam on Chullin 13b:2	בריש פרקין בסוף דף ד'	בריש פרקין בסוף (חולין דף ד')
Melechet Shlomo on Mishnah Sukkah 1:10:2	בריש פירקין דף ד'	בריש פירקין (סוכה דף ד')
Melechet Shlomo on Mishnah Bava Kamma 6:4:1	בריש פירקין דף כ״ה	בריש פירקין (בבא קמא דף כ״ה)
Melechet Shlomo on Mishnah Sanhedrin 1:6:6	בריש פירקין ד' ג'	בריש פירקין (סנהדרין ד' ג')
Melechet Shlomo on Mishnah Nedarim 9:10:1	בריש פירקין דף ס״ה	בריש פירקין (נדרים דף ס״ה)
Beur Reuven on Bava Kamma 3b:22	בסוף פירקין, דף טו.	בסוף פירקין, (בבא קמא דף טו.)
Petach Einayim on Berakhot 27b:4	ריש פרקין דף כ״ו	ריש פרקין (ברכות דף כ״ו)
