Vayikra:1	כתונת מכפרת וכו׳‬. (ערכין טו.) מאמר ר׳‬ ענני בר ששון ע״‬ש כה״‬ע: ולא יזח החושן כו׳‬ נראה מיותר. וגם מה דפרט אפוד מכל בגדי כהונה צ״‬ע. ונראה משום דלקמן לא חשיב לאפוד כפרה מיוחדה להכי נקני הכא ומייתי קרא דלא יזח החושן ור״‬ל שחושן ואפוד נחשבים לבגד אחד:
Vayikra:2	על מקום שהוא מהרהר. בגמרא שם הלשון אבנט מכפר על הרהור הלב אהיכא דאיתא. וע״‬ש תוס׳‬ ד״‬ה אבנט. ואבנט הוא כמו חגור שש ארוכה מאוד. ואיתא נמי במדרש (ויקרא פ״‬י) שהיה הכהן מקיפו ל״‬ב פעמים כנגד לב האדם עכ״‬ל. וכ״‬ה הכוונה כאן על מקום שהוא מהרהר. וע״‬ש בהגהות הר״‬י ברלין בהגליון:
Vayikra:3	יבוא דבר שבקול. כי הפעמונים משמיעים קול. וכה״‬א והיה על מצח אהרן וכתיב ומצח אשה זונה היה לך כצ״‬ל:
Vayikra:4	עוז והדר לבושה. עיין תוס׳‬ ר״‬פ מי שמת דפרנסה היינו מלבוש:<br>ד. ואמר ר׳‬ יהושע בן לוי. דבר זה וכו׳‬ כצ״‬ל (ע״‬א י״‬ט:) כל המאמר. ובכאן חסר קצת:
Vayikra:5	דכתיב אדם כי יקריב. חסר וכצ״‬ל נשנית באהל מועד דכתיב מאהל מועד אדם כי יקריב וכו׳‬:
Vayikra:6	בערבות מואב דכתיב לפלא נדר (במדבר ט״‬ו) ושם נאמר אח״‬כ בערבות מואב עיין (סוטה ל״‬ז) בפירש״‬י. כללות נאמרו בסיני ע״‬ש וצ״‬ע:
Vayikra:7	לפיכך נקראו הלוים וכו׳‬. בר״‬ר פ׳‬ ס״‬ח ויק״‬ר ש״‬א ע״‬ש:
Vayikra:8	ששה שמות וכו׳‬. (מגילה י״‬ג.) ויק״‬ר פ״‬א ע״‬ש:
Vayikra:9	ר׳‬ שמואל ב״‬ר אמי. בויק״‬ר הגירסא ר׳‬ ישמעאל ב״‬ר אמי:
Vayikra:10	שביתר את העגל. קאי על אהרן שויתר לו הקב״‬ה מעשה העגל:
Vayikra:11	כאשר צוה ה׳‬ וכו׳‬. י״‬ח פעמים עיין ויק״‬ר שם י״‬ח צוויים כתיב בפרשת משכן כנגד י״‬ח מוליות שבשדרה וכנגדן קבעו י״‬ח אזכרות שבמזמור הבו לה׳‬ בני אלים:
Vayikra:12	שמא תאמר וכו׳‬ באברהם וכו׳‬. אינו מובן וכנראה חסר. עיין ויק״‬ר שם ויקרא אל משה ולא כאברהם באברהם כתיב ויקרא מלאך ה׳‬ אל אברהם המלאך קורא והדבור מלמד ברם הכא אמר הקב״‬ה אני הקורא ואני המדבר וזה שסיים ויקרא וידבר שהקב״‬ה קרא לו והוא עצמו היה המדבר:
Vayikra:13	ואין אור אלא תורה. עיין בר״‬ר פ״‬ג ה׳‬ פעמים כתיב אור כנגד חמשה חומשי תורה. וכ״‬ה בתנחומא כאן:
Vayikra:14	לא היה שם גדול ממשה. בויק״‬ר אז דברת בחזון זה משה וכו׳‬ תדע שמכולן לא קרא הדבור אלא למשה ובכאן קיצר הדורש. ועיין (יומא יד.) לחלוק כבוד למשה:
Vayikra:15	מכאן לא יכנס וכו׳‬. בויק״‬ר מכאן אמרו כל ת״‬ח שאין בו דעה כו׳‬ צא ולמד ק״‬ו ממשה אב החכמה וכו׳‬.<br>טו. וזה אחד מי״‬ג מדות. ת״‬כ כה״‬ע ועיין (ב״‬ק כ״‬ה) תוס׳‬ ד״‬ה ק״‬ו ע״‬ש:
Vayikra:16	ק״‬ו לשכינה י״‬ד כו׳‬. מיותר וכצ״‬ל ודבר זה נאמר בתורה שנוי בנביאים כו׳‬ ואביה ירוק ירק בפניה ק״‬ו לשכינה:
Vayikra:17	נידון נקרא דבר שבא לידון הימנו. זהו דברי המחבר לפרש מלת נידון וכן הרבה בספר הזה כי הוא מעתיק דברי הת״‬כ ומפרשו וזכרהו כי הוא כלל גדול בדברי המחבר הזה:
Vayikra:18	נאמר בש״‬ש אם לא שלח ידו וכו׳‬ ונאמר בש״‬ח אם לא שלח ידו מה בש״‬ש פטר את היורשים כן בש״‬ח. ובש״‬ש וכו׳‬ כצ״‬ל וכ״‬ה (שבועות מ״‬ז):
Vayikra:19	לנוחת אדם לבדו. פי׳‬ דבין משכב ובין מושב מיוחדים הם שינוח אדם עליהם ואינם עשויים להניח עליהם דבר זולת אדם:
Vayikra:20	כל שהוא ט״‬ס וכצ״‬ל אף כלים עשוי לנוחת אדם:
Vayikra:21	לסבלון אחר. פי׳‬ למשא אחרת עם האדם ואינו כמו מו״‬מ:
Vayikra:22	כגון פרשה נרות וכו׳‬. הצד השוה שביניהן שהן בצו מיד ולדורות אף כל שהוא בצו וכו׳‬ כצ״‬ל ובכאן ט״‬ס:
Vayikra:23	מידי אחרינא לא. כגון חיה אין ממינה קרבן:
Vayikra:24	לרבות כל מילי כצ״‬ל וכל הבהמה ט״‬ס ועיין בת״‬כ:
Vayikra:25	במאי קמיפלגי בהאי קרא. חסר כאן ועיין (סנהדרין מ״‬ה:) שם פלוגתא דר״‬א ורבנן:
Vayikra:26	כדמפרש דבי רב. היינו בת״‬כ ושם מפרש כל הי ״‬ג מדות בארוכה וספרי דבי רב קורין הראשונים לת״‬כ וכן האלפס בסוף פסחים קורא אותו ג״‬כ בשם זה ועיין (חולין מ״‬ו:) בפירש״‬י ד״‬ה תנא דבי רב קרי לברייתא קמייתא ששנויה בת״‬כ דמקריא ספרי דבי רב לפי שהיה שגור בבהמ״‬ד בפי כולם עכ״‬ל רש״‬י. ועיין לקמן בפ׳‬ צו מביא טעם אחר למה נקרא ספרי דבי רב ע״‬ש;
Vayikra:27	ומה להלן היה עונה הנני אף על כל קריאה כצ״‬ל:
Vayikra:28	הוא משה עד שלא נדבר עמו. יובן ע״‬ם דברי הזוהר (נשא קל״‬ח א׳‬). אברהם אברהם בכולהו פסיק טעמא לבר ממשה כו׳‬ ומסיים דמיומא דאתברי שלים הוי ע״‬ש ועיין בת״‬כ:
Vayikra:29	כל הנביאים וכו׳‬. ויק״‬ר פ״‬א:
Vayikra:30	כל הנביאים לא היו צלולות כצ״‬ל. וע״‬ש בויק״‬ר כל הנביאים רואין מתוך אספקלריא מלוכלכת הד״‬ד (הושע י״‬ב) ואנכי חזון הרביתי וביד הנביאים אדמה ושל משה מתוך אספקלריא מצוחצחת דכתיב ותמונת ה׳‬ יביט ;
Vayikra:31	רא״‬א הרי הוא אומר ונועדתי ונו׳‬ חסר ועיין ח״‬כ. והכוונה כי לישראל היה רק יעידה באוה״‬מ. והוא רק מלון שכינה אבל הדבור היה רק למשה ומסיים שם בת״‬כ ונועדתי לך ודברתי אתך לך היה יעידה ודבור ולא לכל ישראל:
Vayikra:32	קול שמפורש בכתובים וכו׳‬. א״‬כ למה נאמר מאוהל מועד שהיה הקול נפסק ולא יצא לחוץ מאוה״‬ה כצ״‬ל וכ״‬ה בת״‬כ:
Vayikra:33	שלא היה מדבר וכו׳‬. בת״‬כ ה״‬ג אמור להם דברי כבושי; בשבילכם מדבר עמי:
Vayikra:34	עד שלא נתנה תורה וכו׳‬. ויק״‬ר פ״‬א:
Vayikra:35	עד שהבאתיו וכו׳‬. זה סיני. שהש״‬ר פסוק כמעט שעברתי:
Vayikra:36	עשרה נקראו יקרים. ויק״‬ר פ״‬ב מדרש תהלים קט״‬ז מדרש שמואל פ״‬א:
Vayikra:37	לפי שהוא קרוב לבשרי. בויק״‬ר מסיים הקרא כאשר ידבק האזור על מתני איש:
Vayikra:38	לפי שאני שונא גזל בעולה. (סוכה ל׳‬.) מאמר רשב״‬י משל למלך וכו׳‬:
Vayikra:39	להלן הוא אומר אדם וכו׳‬. ויק״‬ר פ״‬ב:
Vayikra:40	שיוקדם הקדשו להקרבתו. דהוי מצי למכתב יקריב לה׳‬ וקרבן יהורא הוא:
Vayikra:41	מכאן שלא להזכיר וכו׳‬. כי יאמר תחלה קרבן: ואח״‬כ לה׳‬ ולא יאמר לה׳‬ תחלה דלמא שתיק ומוציא ש״‬ש לבטלה:
Vayikra:42	אמור ביו״‬ד ה״‬א כצ״‬ל. היינו בשם הויה דוקא ולא שם אחר:
Vayikra:43	ממקום שהיחיד מביא כו׳‬. פי׳‬ כמו ביחיד פסול רובע ונרבע ושארי פסולים כן קרבן רבים ג״‬כ פכולים דל״‬ת זכותא דרבים עדיף:<br>מג. וא״‬ת מאחר וכו׳‬. דבריו מעורבבים ועיין בת״‬כ וכן (זבחים ל״‬ד) וכצ״‬ל וא״‬ת מאחר דכתיב מן הבהמה למה לי מן הבקר והצאן אלא לפי שהחיה בכלל בהמה ה״‬א שנם חיה יכול להקריב ת״‬ל מן הבקר והצאן יכול לא יביא ואם הביא כשר ת״‬ל תקריבו את קרבנכם לעכב למה זה דומה למי שאמר לו רבו אל תביא אלא מן החטים והלך והביא גם שעורים הרי זה עובר על דבריו. ועיין בת״‬כ ותבין:
Vayikra:44	להביא עולת חובה. פי׳‬ שכל הפסולין שפוסלין עולת נדבה פוסלין ג״‬כ עולת חובה:
Vayikra:45	כשם שהקרבן וכו׳‬ בך האיש וכו׳‬. בת״‬כ גירסא אחרת ובכאן תמוה מאד אם על הכהן המקריב קאי ל״‬ל לרבות הא בהדיא כתיב מום בו ולא יחלל. ואם על הבעלים המקריב קאי אינו פוסל אס יש בו מום וגם מקבלין קרבנות מפושעי ישראל. וצע״‬ג כן העיר הרב רצ״‬ר ז״‬ל בפי׳‬ עז״‬כ על הת״‬כ. ואפשר לומר דמיירי בכהן שמתו אחיו מחמת מילה ומחמת זה לא מל עצמו שאינו רשאי להקריב קרבן דכן מצינו לשון תמים על המילה באברהם התהלך לפני והיה תמים דקאי על המילה דכתיב בתריה. וכן באדר״‬נ דמשיב שם אותן שנולדו מהולים חשוב שם איוב נולד מהול שנאמר בו תם וישר נח דכתיב איש צדיק תמים יעקב ויעקב איש תם דוד מכתם לדוד שהיתה מכתו תם דוד מכתם לדוד שהיה מכתו תם כנ״‬ל לפני ה׳‬ וסמך אע״‬פ נו׳‬ כצ״‬ל:
Vayikra:46	ותנן נמי כו׳‬. ר״‬ל אלמא שהיה השוחט והסומך לפני ה׳‬ שתיכף לסמיכה שחיטה ובמקום שסומכין שוחטין כמ״‬ש במשנה:
Vayikra:47	אחד עולת חובה. אחד עולת בקר ואחד עולת צאן זו וזו טעונות סמיכה והעולה פרט לעולת העוף שהרי הוא דברי המחבר שמפרש למה בתיבת עולה נכלל בקר וצאן ולא עוף ומפרש שהצאן והבקר שוה כו׳‬:
Vayikra:48	ונרצה לו. לכפר במכפר איזהו מכפר כצ״‬ל:
Vayikra:49	ד״‬א כו׳‬. ט״‬ס וכצ״‬ל הואיל ואין כפרה אלא בדם מת״‬ל והמך ונרצה אלא ללמד שאם עשה לסמיכה שירי מצוה פי׳‬ שלא נחשב בעיניו ולא עשאה:
Vayikra:50	[]
Vayikra:51	כאלו לא כיפר וכיפר. כ״‬ה בת״‬כ ופי׳‬ שלא עשה מצוה מן המובחר. כיפר נברא ולא כיפר קמיה שמיא הוא לשון הגמרא (זבחים ו׳‬) וכמו שמסיים והכי מפרש בזבחים:
Vayikra:52	את שעליו כמשא. בת״‬כ ליתא מילת כמשא והמחבר שהוסיף זה ע״‬פ דבריהם (זבחים ד:) כיון דאמר עלי כמאן דטען אכתפיה דמי:
Vayikra:53	מכאן אמרו כו׳‬. משנה מנחות. ברכות מ״‬ב. ירושלמי ברכות פ״‬א. שו״‬ט מזמור קל״‬ד ע״‬ש בביאורי:
Vayikra:54	ואפילו קדשים. בת״‬כ ובמשנה דזבחים ה״‬ג ואפילו קדשי קדשים:
Vayikra:55	לימד שלא תהא כשרה אלא בכהן כשר. כ״‬ה בת״‬כ:
Vayikra:56	כגון דם בכור ומעשר וכו׳‬. עיין ת״‬כ מקודם מרבה שנתערבה בדם אשם תודה ושלמים ואח״‬כ דרשה זו:
Vayikra:57	בבנין המזבח. ט״‬ס וצ״‬ל בין האולם ולמזבח משוך כלפי דרום וכ״‬ה בת״‬כ:<br>נז. אותה לנתחיה הכשרה ולא הפסולה שאם עלתה ע״‬ג המזבח קריבה כמות שהיא כ״‬ה בת״‬כ:
Vayikra:58	א״‬ר יהודא כצ״‬ל וכ״‬ה בת״‬כ מנין להצאת האליה וכו׳‬. פי׳‬ הדלקת קיסמין דקין להבעיר בהם המערכה כשהאש קרוב לכלות ובכלי שרת פי׳‬ בבגדי כהונה:
Vayikra:59	א״‬ר ישמעאל וכו׳‬. בת״‬כ ה״‬ג ר״‬ש והוא בפ׳‬ צו ולומד שם מקרא והאש על המזבח תוקד בו ע״‬ש:<br>נט. למערכה של תמיד של בין הערבים כצ״‬ל:
Vayikra:60	וערבו שנים ב״‬א שנים כו׳‬ כצ״‬ל וחסר כאן דרשת ר״‬י: לרבות את הקרבים. ט״‬ס וצ״‬ל הקרנים:<br>סט. שכבר הותז בשחיטה כצ״‬ל. וכ״‬ה בת״‬כ ופי׳‬ הראש כבר הותז בשעת שחיטה וא״‬צ לא לנתחו ולא להפשיטו:
Vayikra:61	עצים הנתונים וכו׳‬. בת״‬כ ה״‬ג הנתוכים וכ״‬ה (תמיד כט:) אבל מפירוש המבאר (שם) נראה שהיה גרסתו הנתונים. ופי׳‬ הנתונים או הניתוכים עצים בחורים דלא קטרי ולא מפקי מיא ע״‬ש בתמיד:
Vayikra:62	וי״‬א משום ישוב א״‬י. בתמיד שם בשם ר״‬א בן יעקב:
Vayikra:63	ד״‬א על העצים כו׳‬. על המזבח לימד מה מזבח כו׳‬ כצ״‬ל:
Vayikra:64	חוץ למערכה. שלא יעכב הילוך רגלי הכהנים:
Vayikra:65	והקטיר יבול וכו׳‬. ט״‬ס כאן ועת״‬כ:
Vayikra:66	ולמזוהם. שריחו רע:
Vayikra:67	לעולה לרבות תמורתה. כי העולה יתירא הוא דכתיב בסוף הפרשה עולה היא.
Vayikra:68	הירך בצפון והיכן הם פונים לדרום כצ״‬ל. וכ״‬ה בת״‬כ ופי׳‬ ירך נקרא רגלי המזבח הם בצפון נמצא ראשו ופניו לדרום:
Vayikra:69	לימד שהכבש בדרום וכו׳‬ כצ״‬ל. כבש נקרא מעלה שעולים ע״‬ג המזבח היה בדרום וכשעולה בו דרך ימין עולה למזרח כמ״‬ש בקרא ומעלותהו פנות קדים היינו למזרח:
Vayikra:70	שהמזבח כולו ראוי להיות בצפון כצ״‬ל. וכה בת״‬כ דכולא מזבח בצפון קאי:
Vayikra:71	שלא ישנה בהם מקום המערכה כצ״‬ל ופי׳‬ שלא יעשה מערכה אחרת:
Vayikra:72	את הכל לכבש. פי׳‬ שהולכת אברים לכבש בעי כהונה:
Vayikra:73	אין זבחי שלמים מן העוף. מן העוף ולא כל העוף אע״‬פ שאין תמות וזכרות וכז׳‬ כצ״‬ל:
Vayikra:74	יכול כל עוף כולו וכו׳‬. כי עוף משמע כל מיני עוף:
Vayikra:75	אבל היונה פותה וכו׳‬. תפס כלישנא דקרא (הושע ז׳‬) כיונה פותה אין לב:
Vayikra:76	אלא בעצמו של כהן. שלא ימלוק בסכין אלא ביד דוקא:
Vayikra:77	למטה מרגליו. היינו למטה מן הסובב שחוט של סיקרא החוגר באמצע המזבח כדי להבדיל בין דמים עליונים לתחתונים הוא למטה מן הסובב אמה כדתנן פ״‬ג דמדות:<br>עז. אפי׳‬ אמה אחת פסולה. ובת״‬כ ה״‬ג כשירה:
Vayikra:78	יטלנה עם נוצתה. הכוונה שיעקור בידו ולא בסכין עיין ת״‬כ:
Vayikra:79	נוטל את הקורקבן עמה. ומפרש בנוצתה היינו פרש ודבר מאוס כמו (איכה ד׳‬) נצו גם נעו. ועיין (זבחים פ״‬ב.) גם דעת ר׳‬ ישמעאל:
Vayikra:80	משום שנאמר שונא גזל בעולה. והיינו שהעוף אוכל מן הגזל לפיכך וכו׳‬:
Vayikra:81	בכנפיו. להכשיר את העור. בכנפיו מתרגמינן בגדפוהי והיינו נוצות שעליו וכיון שאפילו נוצות שעליו הוא מקטיר הרי הכשיר את העור. ועיין (שבת ק״‬ח) דייק מהכא דעוף אית ליה עור לענין שחייב בשבת מחמת חבורה:
Vayikra:82	נאמר בשור הגס. היינו עולת בהמה. וכ״‬ה בהדיא ת״‬כ:
Vayikra:83	כולם יש בהם צד השוה לאדם. פי׳‬ שכולם בעלי חיים:
Vayikra:84	על חטאת אדומים. כי החטא נקרא בלה״‬ק אדום (ישעיה א׳‬) אם יהיו חטאיכם כשנים וגו׳‬:
Vayikra:85	שהרי אדם לא נאמר בו ונרפא. כוונתו אף שבתחלת הפרשה (ויקרא י״‬ג) כתיב נגע צרעת כי תהיה באדם אבל הלשון ונרפא נמצא רק בלשון בשר ובשר כי יהיה שחין ונרפא עיין דרשה זו (סוטה ה) ובפירש״‬י שם:
Vayikra:86	אפילו כ״‬ש מביאה. פי׳‬ אפילו דבר קטן:
Vayikra:87	דוגמא לדבר אגריפס. ויק״‬ר פ״‬ג שו״‬ט מזמור כ״‬ב ע״‬ש:
Vayikra:88	שהקדימו העני. בויק״‬ר שם נראה לאגריפס בחלום קרבן של עני קדמך:
Vayikra:89	כדרך שדרש רבי תנחום כצ״‬ל ודרשת ר׳‬ תנחום הוא ויק״‬ר שם ע״‬פ נפש כי תקריב לפי שהנפש גוזלת וחומסת ע״‬ש:
Vayikra:90	ששמו של הקב״‬ה וכו׳‬. כי החילוק מאותיות איש ואשה באותיות י״‬ה והוא שמו של הקב״‬ה (סוטה י״‬ז) ושם בשם ר״‬ע:
Vayikra:91	לרבות כהן משיח אע״‬פ שחלק בחטאו בקרבנו מן היחיד. אעפ״‬כ יכול להביא מנחת נדבה כמו היחיד ודורש ו׳‬ מן והנפש לרבות ועיין, ת״‬כ:
Vayikra:92	מנחה ליתן האמור כאן בכל המנחות ואת האמור בכל המנחות כאן. סולת מה סולת וכו׳‬ כצ״‬ל. וכ״‬ה בת״‬כ. ופי׳‬ כי בכאן כתיב וכי תקריב קרבן: מנחה לה׳‬ סלח קרבנו ואח״‬כ כתיב מנחת מאפה תנור מנחת מחבת מנחת מרחשת וכולן דינם שוה. ומה שקיצר הכתוב כאן פירש להלן בשאר מנחות. ועיין בת״‬כ:
Vayikra:93	ויצק עליה שמן על כולה מפני שהוא נבלל עמה ונקמצת עמה ונתן עליה לבונה על מקצתה מפני שלא נבללת ולא נקמצת עמה וכ״‬ה בת״‬כ. ועיין (מנחות ז׳‬).
Vayikra:94	מלמד שיציקה וכו׳‬. חסר וכצ״‬ל והביאה מלמד שיציקה ובלילה כשרין בכל אדם וכ״‬ה בת״‬כ והביאה שאין זקוק להביאה אנא אחר יציקה ובלילה:
Vayikra:95	אפי׳‬ הן רבואות. פי׳‬ אפילו שהוא דבר מועט׳‬ יכול להתעסק בהם כהנים הרבה ורבואות קאי על הכהנים כמו שמסיים ברב עם וכו׳‬:
Vayikra:96	וקמץ קומץ אחד לעשרון אחד קומץ אחד לס׳‬ עשרונים כצ״‬ל. וכ״‬ה בת״‬כ:
Vayikra:97	כגון יו״‬ט הראשון וכו׳‬. עיין (מנחות ק״‬ג:) שכן הצבור מביא ביו״‬ט הראשון של חג שחל להיות בשבת ס״‬א עשרונים דיו ליחיד שיהיה פחות מן הצבור אחד וכצ״‬ל הכא:
Vayikra:98	היינו דאמר ר״‬ז. כל הראוי לבילה אין בילה מעכבת וכל שאין ראוי לבילה בילה מעכבת בו כצ״‬ל. וכ״‬ה במנחות שם. והכוונה כי ס׳‬ עשרונים יכול לבלול וע״‬כ אין בילה מעכבת וס״‬א אין יכול לבלול:
Vayikra:99	אבל ס״‬א עשרון שאין ראוין לבילה וכו׳‬ כצ״‬ל והוא סוף המאמר דר״‬ז ובכאן ט״‬ס:
Vayikra:100	מנא לן משמן. פי׳‬ שדורש וקמץ קומץ א׳‬ לעשרון א׳‬ קומץ א׳‬ לס׳‬ עשרונים ויליף זאת משמן. ועיין בת״‬כ פ׳‬ מצורע פ״‬ד פלוגתא בזה גבי שמן. והמחבר תפס הכא דעת ר״‬נ וראב״‬י אפילו מנחה של ס׳‬ עשרון אין לה אלא לוגה אבל בת״‬כ הכא גירסא אחרת ולומד מלבונה כי לבונה קומץ אחד לס׳‬ עשרון ואין שום פלוגתא בזה. ופריך או כלך לדרך זו לילף משמן מה שמן ס׳‬ לוגין לס׳‬ עשרונים ע״‬ש. ע״‬כ יותר נראה שט״‬ס כאן וצ״‬ל הלימוד מלבונה כמו שהוא כאן בת״‬כ וצ״‬ע:
Vayikra:101	ממקום שרגלי הזר וכו׳‬. היינו בעזרת ישראל בתוך י״‬א אמה:
Vayikra:102	ולא משמן חברתה. פי׳‬ שלא יביא שתי מנחות בכלי אחד ובת״‬כ הוא בהדיא:
Vayikra:103	נזכרים בה. פ,׳‬ שהבעלים נזכרים בהקטרה זו לטובה. ועיין בת״‬כ מוסיף עוד נזכרים בקומצה ונזכרים בלבונה:
Vayikra:104	לאהרן שלא במחלוקת. פי׳‬ כה״‬ג נוטל חלק בראש כמה שירצה אבל בניו כהנים הדיוטים מחלקים לכאו״‬א חלקו:
Vayikra:105	ואינו מביא חלות ורקיקין כצ״‬ל. פי׳‬ בקרבן אחד. ועיין בת״‬כ פלוגתא בזה:
Vayikra:106	ולא מאפה יורות הערביין כצ״‬ל וכ״‬ה בת״‬כ:
Vayikra:107	ואין הרקיקין בלולות בשמן. פי׳‬ החלות בעודן סלת נותן בתוכן שמן ובוללן משא״‬כ הרקיקין לש אותן במים ואופה בלא שמן:
Vayikra:108	הזית השלישי עוטנו בבית הבד כצ״‬ל. ופי׳‬ הזית השלישי מפני שאין החמה זורחת עליהם תדיר אינן מתבטלות יפה ע״‬כ עוטנה בבית הבד מניחן במעטן עד שילקה ויתרכך קליפתן ויצא שמנן (רש״‬י מנחות שם).
Vayikra:109	וכותש ונותן לתוך הסל כצ״‬ל. ומה שבנתיים ט״‬ס:
Vayikra:110	כל זה הענין וכו׳‬. הנראה כי לפני המחבר היה ספר דרשות כתוב ע״‬פ ערך א״‬ב ובערך זכר (היינו באות ז) לדרש בפ׳‬ ואתה תצוה (כשחל בפרשת זכור) ששם דיני שמן המשחה היה כתיב דרשות בזה:
Vayikra:111	מלמד שהשמן מצהיר את התבונה כצ״‬ל. והיינו שמצהיר דעתו של אדם וכ״‬ה (מנחות פ״‬ו) אר״‬י מתוך שרגילין בשמן זית חכמה מצויה בהם:
Vayikra:112	פירוש אלפא ראשונה הוא מדברי המחבר לבאר המשנה תקועה אלפא לשמן. ופי׳‬ כמו שהאל״‬ף אות ראשונה והיינו שפירותיה מתוקים ומשובחים כדמסיים:
Vayikra:113	מצות בלולות וכו׳‬ למצות שוי הרקיקים וכו׳‬. עיי: בת״‬כ וזה דברי ר״‬י וקאי כמו שבארתי, למעלה (ק״‬ז) ואין הרקיקין בלולות וכו׳‬ ור״‬י דרש זה מהאי קרא. ועיין בת״‬כ:
Vayikra:114	ולא לרחצה. שהכהנים אסורים לרחוץ מן הכן רק מן הכיור. עיין ת״‬כ:
Vayikra:115	ולא לכפול שהחושן לא היה כפול:
Vayikra:116	מלמד שהוא בוללה סולת כצ״‬ל היינו הבלילה תהיה בעודה סולת. ועיי: ת״‬כ שרבי חולק ע״‬ז:
Vayikra:117	יכול מצוה ת״‬ל תהיה הכתוב קבעה חובה כצ״‬ל. ופי׳‬ יכול מצוה כי רק המצוה שלא להחמיץ אבל בדיעבד אם החמיצה כשרה ת״‬ל תהיה הכתוב קבעה חובה שאף בדיעבד אם החמיצה פסול:
Vayikra:118	פתות וכו׳‬ יכול שתים (פי׳‬ פתות יחלק רק לשתים) ת״‬ל פיתים. וכ״‬ה בת״‬כ:
Vayikra:119	מבאן אמרו מנחת ישראל כופל אותה לשנים ושנים לארבעה ומבדיל מנחת כהן משיח מכפלה אחת לשתים ושתים לארבעה ואינו מבדיל כצ״‬ל וכ״‬ה בת״‬כ:
Vayikra:120	מרחשת עמוקה וכו׳‬. מתוך שהמחבת עמוקה כל שמן שבתוכה במקום א׳‬ וכשתתן אצבעך עליה צד השמן בתוכה וזה ומעשיה רוחשין:
Vayikra:121	בכלי קודש קודם לעשייתה כצ״‬ל:
Vayikra:122	מה אלה יש מהם לאשים כצ״‬ל וכ״‬ה בת״‬כ היינו שמקטירין מהם ע״‬ג המזבח יצאו שתי הלחם וכו׳‬:
Vayikra:123	והקריבה וכו׳‬ והגישה וכו׳‬. פי׳‬ מן והקריבה ממעט מנחת נסכים שאין באה בגלל עצמה רק בגלל הזבח ומן והגישה ממעט מנחת כהנים ועיין בת״‬כ בארוכה:
Vayikra:124	ת״‬ל להלן בקומצו. בפרשה צו את אהרן והרים ממנו בקומצו ושם איירי במנחת סולת כדכתיב (ויקרא ו׳‬) מסלת המנחה ומשמנה:
Vayikra:125	והקטיר המזבחה היה קומץ אע״‬פ שאין שיריים כצ״‬ל ומן ה״‬א דהמזבחה דורש. ודע דדרשה זו נשמטה בת״‬כ:
Vayikra:126	כדמפורש לקט: כצ״‬ל והוא בפסוק וכל קרבן וכו׳‬ במלח המלח הקומץ טעון מלח ואין מנחה כולה טעונה מלח:
Vayikra:127	לימד על כל המנחה כו׳‬ כצ״‬ל וכ״‬ה בת״‬כ דהוי אמינא אחרי דכתיב אשר תקריבו ורק הקומץ מקריב ובא כל לרבות אף השיריים אין נאכלין חמץ:
Vayikra:128	ומנין לרבות אפילו לחם הפנים. אף שאימעוט מהגשה ת״‬ל כל המנחה וכו׳‬ לא תעשה חמץ וכתיב (ויקרא ו׳‬) לא תאפה חמץ אפיה בכלל היתה וכו׳‬ יצאה להקיש כו׳‬ אף אני ארבה עשייתה לישתה ועריכתה כו׳‬ כ״‬ה בת״‬כ ובכאן קיצר בלשונו:
Vayikra:129	כל שהוא אשים. העולה לגבי המזבח:
Vayikra:130	שתהיה ראשית לכל המנחות. פי׳‬ השתי לחם קרבן ראשית מתבואה חדשה כמו שמסיים:
Vayikra:131	יכול אם קדמן ד״‬א וכו׳‬. היינו אם עבר והקריב קודם עצרת מתבואה חדשה לא יקריב אח״‬כ השתי לחם כי אז אינם ראשית ת״‬ל תקריבו:
Vayikra:132	לרבות הכבש. היינו שאם העלה שאור ודבש על הכבש עובר בלאו כמו שמעלה על המזבח עצמו:
Vayikra:133	אבל שלא לעבודה עולין. היינו לשם עצים מותר להעלות שאור ודבש ועי׳‬ בת״‬כ:
Vayikra:134	[]
Vayikra:135	יכול תהא מנחה כולה. היינו אף השיריים יצטרכו מלח. ועי׳‬ לעיל אות קכ״‬ו:
Vayikra:136	וכל קרב: לרבות הלבונה שצריכה מלח. עי׳‬ (מנחות כ׳‬) מרבה לה מסיפא דקרא על כל קרבנך תקריב מלח. ובת״‬כ הגי׳‬ כמו הכא:
Vayikra:137	יכול תבינהו כצ״‬ל וכ״‬ה בת״‬כ וכ״‬ה (מנחות כ״‬א) ופי׳‬ בערוך יכול יתן בו מלח כל דהוא להבין שיש בו טעם מלח. והרב רצ״‬ר פי׳‬ להיפך שיתן בו מלח הרבה ופי׳‬ יותר נכון לפי הענין עיין בת״‬כ:
Vayikra:138	מלח שאינה שובתת. ע״‬ש במנחות בהג׳‬ הרי״‬ ברלין:
Vayikra:139	מלח סדקנית. בת״‬כ ובמנחות׳‬ הגי׳‬ אסתרקניות. ופי׳‬ מלח הבא מן האדמה:
Vayikra:140	ולמה הוציאו הכתוב בלשון נדבה כצ״‬ל. ופי׳‬ ואם משמע שהוא רשות אם ירצה יקריב:
Vayikra:141	ואם לאו לצורך כו׳‬ וכה״‬א ולחם וקלי וכו׳‬ עד הביאכם את קרבן אלהיכם כצ״‬ל וכ״‬ה בת כ כי מזה עיקר הדרשא וביארו המבארים דכתיב את ק רבן אלהיכם היינו שתכוונו דוקא קרב: אלהיכם ולא בשביל שתוכלו לאכול תבואה מן החדש (אמר המבאר: נדרשה זו נ״‬ל להבין בת״‬כ בפ׳‬ אמור וכ״‬ה שם בפסיקתא בס׳‬ העומר והניף את העומר לפני ה׳‬ לרצונכם אין כופין את הצבור על כרחן. ורש״‬י בחומש שם הביא הגי׳‬ לרצונכם אם הביאו כמשפט הזה יהיה לרצון לכם ובאמת מה נשתנה דרשה זו גבי עומר דוקא. והוא עפ״‬י דרשא דהכא כי אם כוונתו להקריב העומר רק שיתרו להם לאכול מתבואה חדשה ולא לשם מצוה אין העומר מתיר. ובפרט לפי׳‬ הגי׳‬ בת״‬כ בפירוש ואם אין אתם מביאים אותה לרצון מעלה אני עליכם כאלו לצורך עצמכם. ע״‬כ שייך הדרשה מלרצונכם אין כופין וכו׳‬ כי המצוה הבאה דוקא ע״‬י כוונת הלב אין שייך ע״‬ז לשון כפיה שיכפו אותו אחרים לעשותו. והבן):
Vayikra:142	אביב של קלאים. פי׳‬ של מוכרי קליות מהמת שהיא לחה אינה נטחנה ברחיים:
Vayikra:143	ולא גרש קלוי. פי׳‬ שיהבהב אותה בעוד שהוא אביב קודם הטחינה ולא אתר הטחינה כשנקרא גרש:
Vayikra:144	כרמל. רך מל נוטריקון דריש מלת כרמל ופי׳‬ כר שלא נתבשלה בעודה במחובר מל שנמלל ביד:
Vayikra:145	וכה״‬א ואיש בא וכו׳‬ וסיפא דקרא עשרים לחם וכרמל בצקלונו עיין (מנחות פ״‬ו:) בארוכה:
Vayikra:146	תקריב וכו׳‬ מ״‬מ. כי הקריב יתירה הוא דכתיב ברישא דקרא ואס תקריב וכו׳‬.
Vayikra:147	ולא על לחם הפנים וכו׳‬. עי׳‬ ת״‬כ דה״‬א ללמוד ק״‬ו ממנחת נסכים:
Vayikra:148	מנחה היא לרבות וכו׳‬ היא להוציא מנחת מאפה. בת״‬כ וכן (מנחות נ״‬ט) דרשות אחרות בזה ע״‬ש. גם מה שמוציא מנחת מאפה כבר לימד לעיל ואין הרקיקין בלולות בשמן וצ״‬ע ליישב:
Vayikra:149	שילקט כל הלבונה. (זבחים כ״‬ז) דריש על כל לבונתה וכו׳‬ ואת כל הלבונה לעכב:
Vayikra:150	כל המביא שלמים מביא שלום וכו׳‬. דורש שלמים לשון שלום ומה נס שאינה באה על חטא:
Vayikra:151	והתשיעי הוא לפני הקדושה וכו׳‬. בת״‬כ מוסיף שההקדש עושה תמורה לאחריו ולא לפניו:
Vayikra:152	כיוצא בו גם את הארי וכו׳‬. פי׳‬ גם רבוי הוא:
Vayikra:153	שני רבוין. פי׳‬ ב׳‬ פעמים כתיב גם לרבות ארי נו׳‬:
Vayikra:154	קרבנו לרבות כל בעלי קרבן. סי׳‬ שאס יש לקרבן ב׳‬ או נ׳‬ בעלים כולם צריכין לסמוך:
Vayikra:155	ולא קרב: הגר׳‬ כ״‬ה ג״‬כ בת״‬כ אולם (מנחות צ״‬ג.) הגי׳‬ קרבן עובד כוכבים. והמבארים מחקו בת״‬כ קרבן הגר וגרסו קרבן עובד כוכבים כי הגר סומך כישראל:
Vayikra:156	שר׳‬ יהודה אומר אי: היורש סומך. קאי אלמעלה ולא קרבן אביו:
Vayikra:157	וכה״‬א כי ירחק ממך המקום אשר יבחר ה׳‬ אלהיך וכו׳‬ בריחוק מקום אתה זובח ולא בקירוב מקום כצ״‬ל. והיינו בקירוב מקום במדבר אסרו לאכול בשר תאוה רק שלמים וע״‬ז קאי אל פתח אה״‬מ פרט לחולין שנשחטו בעזרה ועיין בספרי שם וכן (קדושין כ״‬ז:) ע״‬ש:
Vayikra:158	פתח אה״‬ם לפני פתח אה״‬ם. ג׳‬ פרשיות כתיב בשלמים קמייתא בבן בקר כתיב פתח אה״‬מ ובכבשים ועזים כתיב לפני פתח אה״‬מ:
Vayikra:159	להכשיר את כל הרוחות. עיין (זבחים כ״‬ה) פלוגתא בזה:
Vayikra:160	אשה, לה׳‬ אשה לשם אשים לה׳‬ למי שעשה את העולם כצ״‬ל. וכ״‬ה בת״‬כ:
Vayikra:161	וחטאת ואשם לשם חטא. פי׳‬ לשם חטאו שחטא הבעלים יחשוב הכהן העובד בזה הזבח לכפר עליו:
Vayikra:162	מפני שהוא תנאי ב״‬ד כצ״‬ל:
Vayikra:163	לא בעל כוליא אחת וכו׳‬. היינו החסרון בפנים נפסל גבי קדשים עיין (בכורות ל״‬ט):
Vayikra:164	הפקוקלות. הוא החלב שעל העצם המחבר האטמות והחלחולת עוברת בתוכו ומחוברת בנקב הרעי:
Vayikra:165	תותב קרום ונקלף. (שמות כ״‬ג) היא שמלתו לעורו מתרגמינן היא תותביה כשמלה הוא פרוש על הקרב. קרום ונקלף ועל אוחו תותב יש בו קרום דק הנקלף מעל החלב ואינו אדוק בו. עי׳‬ ת״‬כ:
Vayikra:166	שימול מן הכבד. קצתו להקטיר:
Vayikra:167	אפילו בעל כוליא אחת כצ״‬ל ועיין (בכורות ל״‬ט.) דפריך דזה סותר מה שאמר למעלה ומשני ע״‬ש:
Vayikra:168	הכשר ולא הפסול. שאם הקטיר אברים שלמים פסולים עובר בעשה:
Vayikra:169	חלבים בחלבים. משני קרבנות:
Vayikra:170	נאמר כאן אשה ריח ניחוח. ונאמר למטה אשה לה׳‬ ולא נאמר ריח ניחוח כצ״‬ל:
Vayikra:171	שהבקר נתרבה בנסכים כצ״‬ל. ופי׳‬ גבי בקר ג׳‬ עשרונים בלולים בשמן חצי ההין ויין לנסך חצי ההין:
Vayikra:172	והצאן נתמעט בנסכים. שני עשרונים לאיל ויין ושמן שלישית ההין. ועשרון לכבש ויין ושמן רביעית ההין:
Vayikra:173	לרבות את הפסח לאליה. שתהיה קריבה עם האמורים לגבוה:
Vayikra:174	כגון שגבו מעות לפסח. הוא דברי המחבר ואינו מת״‬כ. ויש עוד כיוצא בו כגון תמורת פסח ופסח שנתכפרו בעליו באחר הכל שלמים:
Vayikra:175	מה חלב בשני לאוין. חד כל חלב וכל דם לא תאכלו. וחד לאו דזרות וכל זר לא יאכל קדש:
Vayikra:176	יכול יקיים בה מצות אליה. שימול קצת ממנה ידיה ת״‬ל תמימה שיקח כולה:
Vayikra:177	ת״‬ל לעמת העצה. כנגד הכליות שהוא למטה מחוט השדרה. הכליות נקראו עצה (ברכות ס״‬א) הכליות יועצות:
Vayikra:178	ת״‬ל יסירנה. ואמר לקמן כמו זרת למעלה וזה השיעור יכנס לפנים מן העצה.
Vayikra:179	אין לך אלא מה שאמור בעני: ולא חלב דפנות. וחסר כאן ועי׳‬ בת״‬כ ותבין ג״‬כ דברי ר׳‬ ישמעאל:
Vayikra:180	היינו דאמרינן. (פסחים ס״‬ד:) ע״‬ש כה״‬ע ובכאן מגומגם קצת:
Vayikra:181	ואע״‬ג דאליה קרויה חלב וכו׳‬ הוא דברי המחבר:
Vayikra:182	אלא על שם עולי. היינו האליה מאכל מובחר (פסחים ג׳‬:) מי קספי לך מאליה:
Vayikra:183	ואי משום שנקיבה וכו׳‬. כל הדרשה דבריו מעורבבים וע״‬ן הפרי ראה פיסקא כי ירחיב ה׳‬ וכו׳‬ וכן (בכורות ס״‬ו) ועיקר כוונתו כי הקרא דצבי ואיל וכו׳‬ הטמא והטהור יחדיו יאכלנו קאי על פסולי המוקדשין שנפדו שאימוריו מותרים לזרים. ומזה יצא לו האליה שהוא בכלל האימורין שמותר באכילה. ומה שמסיים להתיר בשר באכילה לזבין ולזבות אגב גררא מייתי לה הכא. ומה שמסיים וא״‬ת ואפילו חלבים נמי היינו אם מדמין לצבי ואיל יהיה כל חלב חולין מותר באכילה ע״‬ז מסיים כבר הזהירך הכתוב כל חלב ודם וכו׳‬. כן נראה כוונתו כפי לשונו. אבל באמת לא הבנתי דבריו למה לא העתיק דברי הגמרא מבכורות שם וכתב דברים מעורבבים מפי עצמו וצ״‬ע:
Vayikra:184	לרבות הגבולין. הוא ח״‬ל. ובת״‬כ הוא בהדיא:
Vayikra:185	ולא עוד אלא וכו׳‬. המחבר האריך בדברי עצמו בדבר האליה שאינה קרויה חלב ומותר. זה הוא לסתור דברי הקראים שאסרו חלב האליה. ובהקדמתי כתבתי בזה הרבה כי בימי המחבר נתפשטו דעות הקראים נגד הרבה מצות התורה לאסור את המותר ולהתיר את האסור. ואז עמדו נגדם ר׳‬ סעדיה גאון וחכמי הדור וזה המחבר ר׳‬ טוביה אחד מהם שנלחם מלחמת הדת נגד הקראים:
Vayikra:186	מן המחובר יכול לפי שנתמעט מן האליה וכו׳‬ כצ״‬ל:
Vayikra:187	והקטירם כולם כאחת כצ״‬ל. והיינו כל האימורין של קרבן בפעם אחד ולא כאיברי העולה דתנן (תמיד פ״‬ז) הושיט לו הראשון הראש והרגל ע״‬ש:
Vayikra:188	לחייב על החלב מעילה. היינו איסור מעילה חל על איסור חלב ועיין כריתות כ״‬ג ע״‬ב:
Vayikra:189	וכה״‬א נפש כי תמעול מעל וחטאה בשגגה מקדשי ד׳‬. עיין לקמן בת״‬כ מרבה חלב ק״‬ק וקדשים קלים למעילה. ועיין (כריתות כ״‬ג):
Vayikra:190	משום ר״‬י וכו׳‬. דמפיק האי קרא כל חלב וכו׳‬ להביא חלב מעשר ופסח שהם מעונין לגבי מזבח ועיין ספרי (קרח) שם. וכ״‬ה (פסחים סד:) דורש מקרא אד בכור שור וכו׳‬ קודש הם להביא את המעשר ופסח שיטענו מזבח. ולא מהאי קרא כל חלב ודם. ופלא הוא שדברי ר׳‬ ישמעאל לא נזכר שמה וצ״‬ע:
Vayikra:191	אין בו אלא אזהרה אחת. היינו לאו דדם אבל לאו דזרות גבי דם ליכא וכ״‬ה בת״‬כ:
Vayikra:192	ודם התמצית ודם אברים עומד עליהם באיסור לאו כצ״‬ל:
Vayikra:193	והזהיר הקב״‬ה על הדם בין של בהמה בין של חיה ועוף וכו׳‬ כצ״‬ל. ועל החלב ט״‬ס כי חלב של חיה ועוף מותר לאכלו והקרא מביא רק מאיסור דם והוא לקמן בפ׳‬ צו:
Vayikra:194	דאמר רבא. נדפס בטעות וכצ״‬ל. דאמר רבא (כריתות ד:) ה׳‬ לאוין האמורים בדם למה אחת לדם חולין ואחת לדם קדשים ואחת לדם כיסוי ואחת לדם האברים ואחת לדם התמצית: [מכאן ועד סוף דיני ניקור לא פירשתי] ששה חוטין יש בבהמה וצריך ליטלן. של כליות. ושל כסלים. ושל טחול. איסורן איסור חלב וקרמין שלהן כן וצריך לקלפן ולגרדן. ושל ביצים. ושל מוח. איסורן איסור דם. ואמרו חכמים כסלים שהן כחלב אל יניחם על גבי בשר וידיחם או ינקרם לפי שהבשר בולע מן החלב של כסלים והקשו חכמים על דבר (אמר) זה אם כן כסלים עצמן כשאתה מנקרן בולע בשר שבכסלים מחלב שבכסלים. וחזרו ואמרו קרום יש בין חלב לכסלים ואינו בולע. ועוד הקשו אם כן חלב גופו קרום יש לו ואין הבשר שתחתיו בולע ממנו. אמרו אותו קרום רך הוא ונמרט ובולע ואסור. טבח שנמצא אחריו חלב רב יהודה אמר כבשעורה ור׳‬ יוחנן אמר כבזית. ואמר רב פפא לא נחלקו בדבר זה האומר ככשעורה לעברו בלא מלקות והאומר כבזית להלקותו ולעברו. ואמר דבורא החטאת.
Vayikra:195	נפש ולא כנעני כצ״‬ל. וכ״‬ה בת״‬כ:
Vayikra:196	תני ר״‬ח משל וכו׳‬. (ויק״‬ר פ״‬ד):
Vayikra:197	יו״‬ד דברים משמשי: וכו׳‬. ויק״‬ר שם ע״‬ש עוד הוספות:
Vayikra:198	ואין הכנענים מביאין חטאת כו׳‬ כצ״‬ל:<br>ד. ואפילו מצות שנצטוו. דהיינו כנענים אם שגגו אין מביאין חטאת:
Vayikra:199	ועבדים. עבד כנעני שמל וטבל לשם עבדות:
Vayikra:200	ולא מצות המלך ופי׳‬. אע״‬פ שהממרה פי המלך חייב מיתה וכן זקן ממרה נגד ב״‬ד ג״‬כ חייב מיתה אעפ״‬כ אין על שגגתם קרבן מעילה:
Vayikra:201	מכל ולא כל מצות. מ״‬ם דמכל מיעוטא הוא:
Vayikra:202	לשמיעת הקול וביטוי שפתים. היינו שבועת העדות ושבועת ביטוי אין היחיד מביא חטאת קבועה רק הוא בקרבן עולה ויורד כדלקמן בפרשה ושמעה קול אלה:
Vayikra:203	מ״‬ע שבנדה. והזרתם את ב״‬י מטומאתם:
Vayikra:204	ת״‬ל מכל מצות ה׳‬. ריבה. כל רבויא הוא שיתחייב חטאת בשוגג ועיין בת״‬כ שמפרש למה לעיל ממעט מכל וכאן מרבה. והיינו כי נדה חייבין על זדונו כרת חייבין על שגגתו חטאת כמו שמסיים הכא לבסוף שיש בנדה עשה ול״‬ת וכ״‬ה בספרי:
Vayikra:205	עד שיכתוב שם קטן משם גדול. פי׳‬ אף שנתכוין לכתוב שם גדול כמו שמעון אעפ״‬כ כשכתב רק שם ג״‬כ חייב שהיא תיבה המתקיימת במקום אחר:
Vayikra:206	כגון תת שש וכו׳‬. והם ג״‬כ משם גדול תת מתתראו שש מששך וכן כולם ורבותא אע״‬פ שהם שני אותיות דומות אעפ״‬כ חייב:
Vayikra:207	ומפורש במס׳‬ שבת. בפרק כלל גדול ע״‬ש:
Vayikra:208	ולא כשהוא הדיוט. היינו אם חטא כשהוא הדיוט ואחר כך נעשה משוח אינו מביא פר אלא שעיר כהדיוט:
Vayikra:209	אלא על העלם דבר עם שגגת מעשה כצ״‬ל. והיינו שיתנה הוראתו בעצמו. אבל על שגגת המעשה גרידא שלא תלה בהוראתו לא:
Vayikra:210	והקריב וכו׳‬ כשהוא ממונה מביא חטאו משעבר כצ״‬ל. וכ״‬ה בת״‬כ. ופי׳‬ אם משיח עבר מנשיאותו ע״‬י מום או זקנה. אעפ״‬כ אם מביא שוגג בהוראה מביא פר ובזה משונה הוא מנשיא כי נשיא שעבר דינו כהדיוט. אבל הכהן המשיח בקדושתו עומד אף לאחר שעבר עיין: (הוריות י׳‬):
Vayikra:211	אינו מביא חלופין פי׳‬ אם לא מצא פר אינו מביא תחתיו שעיר כמו הדיוט. ומלת פר דריש דיתורא הוא:
Vayikra:212	לרבות פר יוה״‬כ לסמיכה. שלא נאמר בפ׳‬ אחרי מות:
Vayikra:213	ונאמר להלן לקיחה. דכתיב (שמות כ״‬ד) זיקת משה חצי הדם וישם באגנות:
Vayikra:214	דם מהפר יקבלנו. לאפוקי אם נשפך הדם על הרצפה ואספו פסול:
Vayikra:215	למעט קרבנו למצוה יחידית. היינו בחטא של עבודת כוכבים נידון המשיח כמו יחיד עיין בפ׳‬ שלח. ונקרא עבודת כוכבים מצוה יתירה שיחדה הכתוב בפרשה בפני עצמה בפ׳‬ שלח. או משים שאנכי ולא יהיה לך מפי הגבורה שמענום. וכדאמרינן (סנהדרין צ״‬ט) כי דבר ה׳‬ בזה זה העובד עבודת כוכבים (המבאר רצ״‬ר ז״‬ל):
Vayikra:216	ולא מספג. פי׳‬ מקנח:
Vayikra:217	על כל הזאה טבילה. פי׳‬ בכל הזאה נצרך להטביל אצבעו בדם ואח״‬כ יזרוק:
Vayikra:218	את אצבעו בדם, מה אצבעו האמורה להלן (ויקרא י״‬ד) גבי מצורע באצבע הימנית מה להלן ימין המיומנת שבימין אף כאן אצבעו המיומנת שבימין כצ״‬ל. ופי׳‬ המיומנת שבימין אצבע הרגילה למלאכה והיינו שאצל אגודל:
Vayikra:219	מן הדם שבענין. היינו מדם האמור שהזה ממנו הזאה ראשונה למעוטי שיריים:
Vayikra:220	ולא שבע טיפין. היינו בהזאה אחת:
Vayikra:221	מכוון כנגד בית הבדים כצ״‬ל:
Vayikra:222	על קרנות. בת״‬כ הגי׳‬ על קרן קרנות ולמטה הוא אומר על קרן קרנות. פי׳‬ דהוי ליה למכתב על קרן וכתיב קרנות מיעט קרנות שתים הרי ארבע. ולטה הוא בפר העדה כדמסייס:
Vayikra:223	והיינו דאמרינן. (סנהדרין ד׳‬:) ע״‬ש והוא לימד אחר לא מקרן קרנות ובכאן קיצר ולא סיים הך דסנהדרין:
Vayikra:224	ואין הכהן לפני ה׳‬ כצ״‬ל. כי הכהן עומד חוץ למזבח לא ככה״‬ג ביום הכפורים:
Vayikra:225	לרבות כל הקרנות וכו׳‬. פי׳‬ שיזה על הד׳‬ קרנות ועיין בת״‬כ. וזה דברי ר׳‬ יהודה ולא דריש מן קרן קרנות:
Vayikra:226	זה יסוד מערבי. שהיסוד שבאותו רוח כנגד פתחו של היכל הוא:
Vayikra:227	לרבות פר יוה״‬כ לשתי הכליות ויותרת הככד כצ״‬ל וכ״‬ה בת״‬כ:
Vayikra:228	ירים ממנו מן המחובר כצ״‬ל וכ״‬ה כת״‬כ ופי׳‬ שיהיה כל הפר מחובר יחד כשעת הרמה עיין (מנחות ע״‬ז:) שלא ינתח הבשר קודם שיטול האמורין:
Vayikra:229	כולו כשהוא שלם. כשיוציא הפר מחוץ למחנה יהיה שלם ולא ינתחנו מקודם:
Vayikra:230	מה ראשו וכו׳‬. האמורים להלן גבי עולה דכתיב את הראש וכו׳‬ וקרבו וכרעיו ירחץ במים והקטיר והוא ע״‬י ניתוח:
Vayikra:231	ת״‬ל וקרבו ופרשו וכו׳‬. עיין (זבחים נ׳‬.) אר״‬ם כשם שפרשו בקרבו כך בשרו בעורו והכוונה כשם שלא יקח הפרש מן הקרביים כך העור יהיה דבוק לבשרו:
Vayikra:232	שהרי כתיב ושרף אותו. לקמן בפך של צבור:
Vayikra:233	ששם היו נותנים. פי׳‬ שייחד מקום לדשן שיהיה תמיד כמקום אחד:
Vayikra:234	ולא הפסול. שאם אירע להם פסול קודם זריקה נשרפין בבית הדשן שבהר הבית ועי׳‬ (זבחים ק״‬ד:) תני לוי שלשה בית דשנים היו שם וכו׳‬ ע״‬ש:
Vayikra:235	אע״‬פ שאין שם דשן. דל״‬ת אל שפך הדשן דשן ממש קמ״‬ל הואיל ויחדו לשם דשן ג״‬כ כשר:
Vayikra:236	באש ולא בסיד. אע״‬פ שהוא תולדות אש אעפ״‬כ לא נקראים אש:
Vayikra:237	אלא שפר משיח קודם. לכן פרשתו מוקדמת. וכן אומר לקמן פר משיח ופר העדה פר משיח קודם:
Vayikra:238	סנהררי גדולה. והיינו של ע״‬א ועיין בת״‬כ בארוכה:
Vayikra:239	על שגגת המעשה. היינו שלא תלוי בהוראת ב״‬ד. אלא שנתחלף לכ״‬ד ולרוב הקהל שומן בחלב ואכלו:
Vayikra:240	ת״‬ל ונעלם דבר וכו׳‬ היינו שב״‬ד גרמו לדבר שטעו בהוראה והלשון שלא ידעו איסורו של דבר הוא פירוש על שגגת המעשה. עי׳‬ ת״‬כ:
Vayikra:241	מצוה כולה. כגון אין נדה בתורה אין שכת בתורה עיין (הוריות ד׳‬:) וזה מן ונעלם דבר דוקא, וזה זיל קרי בי רב הוא:
Vayikra:242	הוראה תלוי׳‬ בב״‬ד ומעשה תלוי בקהל כצ״‬ל. וכ״‬ה בת״‬כ והיינו אם עשו ב״‬ד בעצמם ע״‬י הוראתם דינם כיחידים:
Vayikra:243	מצות האמורים במשיח וכו׳‬. בת״‬כ ליתא דרשא זו ועי׳‬ (יבמות ט׳‬.) לימד זה מן לאשמת העם ע״‬ש:
Vayikra:244	כשם שנפרעין מן היחיד. דורש ואשם הוא לשון יחיד:
Vayikra:245	ולא שיודעו החטאים. פי׳‬ אם ב״‬ד הורו על חלב או דם שהוא מותר ועשו קהל על פיהם רק לא ידעו על מה הורו ב״‬ד אם על חלב אם על דם. ובהוריות ה׳‬ פליגי אמוראי בזה:
Vayikra:246	שני שבטים כו׳‬. כי כל שבט מביא בפני עצמו. וה״‬ה אם חטא שבט אחד מביא פר אחד ובהוריות פלוגתא בזה:
Vayikra:247	כגון שהורו על הלב הדקין. היא לשון המחבר:
Vayikra:248	וסמכו שנים זקני שנים וכו׳‬ כצ״‬ל:
Vayikra:249	יד כל יחיד ויחיד. אבל כ״‬א סומך בשתי ידיו:
Vayikra:250	[]
Vayikra:251	ואין שעירי עזים. היינו הבאים על חטא, עבודת כוכבים:
Vayikra:252	לרבות פר יו״‬ב. היינו בא״‬ת וד״‬ם וטבילה עיין (זבחים מ׳‬:) ותבין:
Vayikra:253	באשר ללמדך וכו׳‬. דורש אשר לשון אשרי:
Vayikra:254	ודומה לו, אשר יש צדיקים וכו׳‬. שם דורש ג״‬כ אשרי לצדיקים שמגיעים להם טובה בעוה״‬ז:
Vayikra:255	ונאמר להלן ה׳‬ אלהיו וכו׳‬. גבי מלך:
Vayikra:256	ולא נשיא שבט. שדינו כהדיוט ומביא כשבה או שעירה:
Vayikra:257	כשיחטא כשהוא נשיא. דורש הלשון נשיא יחטא שחטא כשהוא נשיא:
Vayikra:258	הלב שעל הדקין וכו׳‬. בהעלם אחת חייב שתים. פי׳‬ אפילו אכלו בהעלם א׳‬ באין ידיעות מחלקין אעפ״‬כ חייב שתים ועיין (כריתות ד׳‬) פריך למה חייב שתים הרי הכל לאו א׳‬ הוא ומסיק לבסוף כשאכלן בשני תמחויין ע״‬ש:
Vayikra:259	הן מצות האמורות כאן. היינו הכל בחטא שחייבין על זדונו כרת:
Vayikra:260	פרט לשמיעת הקול כו׳‬. דכל הני מביא עליהם קרבן עולה ויורד אין הנשיא מביא עליהם שעיר ועיין (הוריות ח׳‬ ע״‬ב) כי המלך והנשיא אינם בקרבן עולה ויורד כי אינם באים לידי עניות:
Vayikra:261	על שגגת המעשה. שסבור שהוא שומן ואכלו. ובזה חלוק הוא מכהן המשיח שהמשיח פטור משגגת המעשה:
Vayikra:262	מלמד שהוא מביא אשם תלוי וכו׳‬. פי׳‬ בלא הודע דינו כיחיד. אע״‬ג דבהודע יצא מכלל יחיד ומביא שעיר:
Vayikra:263	לא שיאמרו לו אחרים. והיינו שהוא מכחישן:
Vayikra:264	אפילו אמרה לו שפחתו. עיין בת״‬כ דרשא זו. ובכאן נצרך לדחוק הכוונה שהוא מכחישה:
Vayikra:265	כגון אשתו נדה ואחותו וכו׳‬. פי׳‬ אף שבשניהם חייב חטאת אך מחמת שלא ידוע לו החטיא עם מי חטא אינו מביא שעיר. ועיין בת״‬כ שזה דברי ר׳‬ יהושע ור״‬א מחייב חטאת:
Vayikra:266	ואינו יוצא בקרבן אביו. היינו אם אביו הפריש חטאת על חטאו ומת. ובנו ג״‬כ חטא באותו חטא אינו מביא קרבן אביו. וקשה הלא הוא חטאת שמתו בעליה דלמיתה אזלי. וצ״‬ע. וכן העיר הרצ״‬ר:
Vayikra:267	עזים ולא חלופין. פי׳‬ דה״‬א שיכול להביא ג״‬כ פר כמו המשיח ורק להקל עליו בא הכתוב:
Vayikra:268	לרבות שעיר נחשון לסמיכה. שגם הוא היה חטאת
Vayikra:269	ולמטה הוא אומר. בפ׳‬ שניה בכשבה דיחיד:
Vayikra:270	מכאן היה רש״‬א. מכאן לאו דוקא דמיתות ליכא למשמע מהכא ועי׳‬ ת״‬כ:
Vayikra:271	קבעו חובה. בצפון דוקא:
Vayikra:272	מכאן סמכו חכמים. (סוטה ל״‬ב) ע״‬ש:
Vayikra:273	שיקבל בימין. כי כל מקום שנאמר אצבע אינו אלא ימין וגמר ממצורע:
Vayikra:274	זה יסוד דרומי. עיין בת״‬כ בארוכה:
Vayikra:275	תותב קרום ונקלף. פירשתי למעלה:
Vayikra:276	כפרה לשמו. לשם בעלים:
Vayikra:277	שלא יכפר לשנים כאחת. שלא יערב דם חטאת בדם חטאת אחרת:
Vayikra:278	הרי אלו מיעוטין. עי׳‬ (שבת צ״‬ג.) תלתא מיעוטי כתיבי ושם דריש לכולהו:
Vayikra:279	והלך ועשה על פיהן. היינו היחיד עשה עפ״‬י ב״‬ד פטור לפי שתלה בב״‬ד ועיין בת״‬כ בארוכה:
Vayikra:280	במלגז. כמו מזלג ולוזנים הוא מאסף השבלים:
Vayikra:281	הזכורים למעלה במשיח. שחייבין על זדונו כרת. וכמו שמסיים לבסוף:
Vayikra:282	השב מידיעתו וכו׳‬. למעוטי׳‬ ישראל מומר לעבודת כוכבים שאינו שב מידיעתו:
Vayikra:283	אשר לא תעשינה ואשם מלמד שהוא מביא אשם תלוי כצ״‬ל וכ״‬ה בת״‬כ. ועיין במבארי הת״‬כ:
Vayikra:284	מה חטאת עז בת שנתה. כדכתיב (במדבר ט״‬ו) והקריבה עז בת שנתה לחטאת ועיין ת״‬כ שיליף ג״‬כ ממצורע:
Vayikra:285	לרבות חטאת עבודת כוכבים לסמיכה. כי שם במדבר לא נאמר סמיכה:
Vayikra:286	ושחט את החטאת במקום העולה וכו׳‬. אלא בצפון כמו עולה:
Vayikra:287	מכאן אמרו וכו׳‬. דורש סיפא דקרא דלמעלה. במקום העולה ולקח הכהן וכו׳‬ היינו שיקח. במקום העולה שנשחטה בצפון. ועי׳‬ ת״‬כ:
Vayikra:288	שאם קיבל וכו׳‬. בד׳‬ כוסות וכו׳‬. פי׳‬ שנתן מכל כוס מתנה אחת אזי מותר הדמים דין שיריים יש להם ונשפכין ע״‬ג היסוד:
Vayikra:289	שתהא כפרה לשמו. בת״‬כ מוסיף שלא יכפר לשנים כאחת ושיהא הכהן מכפר ע״‬י עצמו כצ״‬ל בת״‬כ. והכוונה הכהן הזורק יהיה מכוון הכפרה לשם הבעלים ולא יעשה כוונה זו ע״‬י כהן אחר:
Vayikra:290	ת״‬ל אם כבש יביא קרבנו לחטאת כצ״‬ל. וכ״‬ה בת״‬כ ולעיל כתיב והביא קרבנו שעירת עזים כאן הקדים עז לכבש:
Vayikra:291	אבל אמרו חכמים וכו׳‬. בכאן חסר וכנ״‬ל וכ״‬ה בת״‬כ האב קודם לאם בכ״‬מ יכול מפני שכבוד האב עודף על כבוד האם ת״‬ל (ויקרא י״‬ט) איש אמו ואביו תיראו מלמד ששניהם שקולין אבל אמרו חכמים האב קודם וכו׳‬ כצ״‬ל:
Vayikra:292	לרבות חטאת נזיר. דה״‬ל למיכתב וסמך ידו על ראשה וחטאת יתירא היא:
Vayikra:293	והיינו דאמרי ב ״‬ה. (סנהדרין ד׳‬: זבחים ל ״‬ח) ועיין בת״‬כ נאמרו דמים למעלה כצ״‬ל:
Vayikra:294	דיו במחנה אחת כצ״‬ל. ועיין כל הדרשא בת״‬כ ובסנהדרין ובזבחים כי הלשון דהכא אינו מדוייק:
Vayikra:295	הסמיך חטאת יחיד לאשם יחיד כצ״‬ל. כי בפרשה שלמעלה חטאת יחיד ובכאן אשם יחיד:
Vayikra:296	אין לי אלא באלה שיש עמו שבועה. כמו בסוטה:
Vayikra:297	ושמעה קול אלה. מקול משמע אפילו כאלה שאין עמו שבועה. ועיין (שבועות ל״‬ו:) לומד (מיחזקאל י״‬ז) ויבא אותו באלה ע״‬ש:
Vayikra:298	עד שישמע מפי התובע כצ״‬ל. דעיקר קרא כתיב במושבע מפי אחרים:
Vayikra:299	ולא מפי עבדו. היינו ששלח התובע עבדו להעדים ונשבעו (ועיין בשבועות ל״‬ה.):
Vayikra:300	שקדמה עדות לשבועה. דורש ושמעה קול אלה והוא עד בשעה שנשבע כבר ידע העדות:
Vayikra:301	נאמר כאן אוין. היינו או ראה או ידע:
Vayikra:302	ונאמר להלן אוין כצ״‬ל היינו גבי פקדון או בתשומת יד או בגזל או עשק:
Vayikra:303	מה אוי האמורים בפקדון וכו׳‬. אינו אלא בתביעת ממון כדכתיב בהדיא או בגזל או עשק אף אוין האמורים כאן גבי שבועה בתביעת ממון כצ״‬ל וכ״‬ה בת״‬כ ובכאן הלשון מעורבב:
Vayikra:304	ריה״‬ג אומר וכו׳‬. הוא אוין לא דריש ודריש מקרא אחרינא.
Vayikra:305	ואיזו זו זו תביעת ממון. ולא בעדי נפשות שאם הודה שהרג את הנפש לפני עדים הוא פטור עד שיראו בעיניהם ולא שייך ע״‬ז שבועה. וכן בעדי קנס אם הודה לפני עדים פטור. ע״‬ז קאי הקרא והוא עד או ראה או ידע. דוקא בתביעת ממון:
Vayikra:306	כפרו שניהם כאחת. היינו השני עדים:
Vayikra:307	הכופר חייב. היינו א היה ראשון שכפר חייב כי אולי יגיד ג״‬כ השני ויתחייב ממון ע״‬י השני. משא״‬כ השני אם כפר אחר שכפר הראשון בפני עצמו. ושוב הראשון לא יכול לחזור ולהגיד שוב אין השני ראוי להעיד. ורק לחייבו שבועה להכחיש את העד אינו נקרא תביעת ממון:
Vayikra:308	מפני שהעדות יכולה להתקיים בשתיהן כצ״‬ל:
Vayikra:309	אם לוא יגיד. (כתיב לוא בוא״‬ו ואל״‬ף) דורש אם לו לא יגיד רק שהודה חוצה לו אינו נפטר מן השבועה עד שיגיד למי שהשביעו:
Vayikra:310	שאם השביע עליו וכו׳‬. היינו אם כפר אח״‬כ בב״‬ד חייב קרבן שבועה:
Vayikra:311	יכול אפי׳‬ נגע אדם במגע טומאה יהא חייב כצ״‬ל. וכ״‬ה בת״‬כ והיינו שלא נגע בנבילה עצמה אלא באדם שנגע בנבילה והוא ראשון לטומאה:
Vayikra:312	שהם מטמאין במשא כצ״‬ל לפי גירסת הת״‬כ. וכמו שכתב הרב ק״‬א. והלשון במשא לאו דוקא כי רק טומאת מגע יש בה. ע״‬ש:
Vayikra:313	אפילו כזית ממנה. מלת טמאה מיותר ע״‬כ דורש לרבות כזית ועיין בת״‬כ בארוכה:
Vayikra:314	להוציא קרניה ושערה. לפי גירסא דהכא להוציא יהיה הכוונה קרנה ושערה שאינם מחוברים לבשר ע״‬כ אין בהם טומאה. אבל בת״‬כ הגירסא לרבות קרנה ושערה ופירשו המבארים שמחובר לכזית בשר וקמ״‬ל דקרנה ושערה מטמאין משום יד:
Vayikra:315	לרבות צירופן ועירובן כצ״‬ל. עי׳‬ לקמן בפ׳‬ שמיני:
Vayikra:316	אשר יטמא לרבות בועל נדה. בה לרבות נבלת עוף טהור כצ״‬ל. ועיין ת״‬כ:
Vayikra:317	דכתיב כי את מקדש ה׳‬ וכו׳‬. חסר כאן ועיין ת״‬כ. גבי אזהרת מקדש כתיב (במדבר ה׳‬) ולא יטמאו אח מחניהם וכתיב בתריה ונכרתה כי את מקדש ה׳‬ טמא הרי עונש מקדש (ויקרא י״‬ב) בכל קדש לא תגע זו אזהרת קדש. וכתיב (שם ז׳‬) והנפש אשר האכל מבשר זבח השלמים וטומאתו עליו ונכרתה הרי עונש קודש מה עונש האמור להלן בטומאת מקדש וקדשיו אף קרבן שחייב כאן על טומאת מקדש וקדשיו כצ״‬ל:
Vayikra:318	רבי אומר ונעלם ממנו. מכלל דהוי ליה ידיעה בתחילה והוא ידע ידיעה לבסוף עיין (שבועות ה׳‬) לימד הגמ׳‬ היכא משמע ע״‬ש וכצ״‬ל הכא וכ״‬ה בת״‬כ:
Vayikra:319	עד שיבטא בשפתיו. דכתיב לבטא בשפתים:
Vayikra:320	אף הרעה רשות יצא להרע לאחרים וכו׳‬ כצ״‬ל. ופי׳‬ להרע לאחרים כגון שיכה לאיש פלוני שאינו רשאי שהוא פטור מקרבן:
Vayikra:321	כי הא דאר״‬י אהא וכו׳‬. (תענית י״‬ב מכות כ״‬א) יכול נשבע לעבור על המצוה יהיה חייב קרבן כצ״‬ל:
Vayikra:322	אף הרעה רשות יצא הנשבע לבטל המצוה כצ״‬ל:
Vayikra:323	וכן אמר דוד. (נדרים ח׳‬:) ע״‬ש:
Vayikra:324	האדם בשבועה פרט לאנוס. היינו בשבועה שעבר קסבר שנשבע באמת שלבו אונסו:
Vayikra:325	מלמד שהוא טעון וידוי חי כצ״‬ל וכ״‬ה בת״‬כ. כי על וידוי בעצמו אינו צריך לימוד שכתוב בהדיא והתודה.
Vayikra:326	מלמד שהוא טעון סמיכה. מלת עליה דריש:
Vayikra:327	והביא אף לאחר יוה״‬כ. כי אינו מתכפר עד שיביא קרבנו:
Vayikra:328	ולא הפלגס. כל חודש י״‬ג נקרא פלגס:
Vayikra:329	ואינו מביא שתים. דה״‬א ללמוד כמו שבדלות מביא תורים א׳‬ לחטאת וא׳‬ לעולה כמו כן כאן יביא ב׳‬ א׳‬ לחטאת וא׳‬ לעולה עיין בת״‬כ בארוכה:
Vayikra:330	והעני. פי׳‬ כי הוקרו הטלאים אחר שהפריש המעות והעני ואין לו מעות להוסיף יביא עוף:
Vayikra:331	מנין שיביא קרבן עני ת״‬ל די שה כצ״‬ל. ודי מיעוטא הוא:
Vayikra:332	והביא אותו וכו׳‬ שיפרישם וכו׳‬. הלשון בכאן מעורבב משני דרשות. גם בת״‬כ הלשון אינו מכוון כ״‬כ ועי׳‬ בילקוט. וכפי שהעלו המבארים בת״‬כ כצ״‬ל אחד לחטאת ואחד לעולה והביא אותם אל הכהן שיפרישם הכהן א׳‬ לחטאת וא׳‬ לעולה. ומנין שאם הפרישם הוא (היינו הבעלים) יהיה הפרישו הפרש ת״‬ל אחד לחטאת ואחד לעולה. והביא אותם אל הכהן. היינו שהוא הפרישם תחלה ואח״‬כ הביא אותם אל הכהן. ואח״‬כ צ״‬ל והביא אותם אל הכהן שהוא חייב בטיפול הבאתן שכל כמה שלא מסרן ליד כהן בבל תאחר קאי:
Vayikra:333	ומלק את ראשו ממול ערפו מול הרואה את העורף כצ״‬ל. וזה שהוא מולקה למעלה מהאגפיה בגרון וזה הוא מול הרואה את העורף:
Vayikra:334	והוא יושב ממולי. והיינו כל היכא דכתיב ממולי לאו עליו ממש כי לא עליו היו יושבים רק שבלק ראה אותם. ועיין (חולין י״‬ט) מביא קרא אחרינא:
Vayikra:335	מעצמה של חטאת. שלא יקבל בכלי ויזה רק מחטאת עצמה יזה על קיר המזבח:
Vayikra:336	זה קיר התחתון. היינו מחוט הסיקרא ולמטה:
Vayikra:337	כמשפט עולת בהמה. בת״‬כ הגירסא כמשפטי חטאת בהמה. עיין כ״‬ז (חולין כ״‬א) הסוגיא בארוכה. אבל רש״‬י פי׳‬ בחומש כמשפט עולת נדבה כפי פשוטו של מקרא. ואולי דברי רש״‬י נלקחים מכאן אם אין כאן ט״‬ס:
Vayikra:338	ר׳‬ ישמעאל אומר כמשפט חטאת העוף. כ״‬ה בת״‬כ ובחולין שם ובכאן ערבובי דברים ע״‬ש ותבין:
Vayikra:339	חביבה מצוה בשעתה. פי׳‬ כשנעשית מיד ואין מחמיצין אותה כמו שמסיים:
Vayikra:340	האיפה ג׳‬ סאין וכו׳‬. הוא מדברי המחבר בעצמו:
Vayikra:341	נותן הוא על שיריה. פי׳‬ ששירי מנחות נאכלות לכהנים ויכולים לאכול עם שמן וכן עם לבונה אבל משום דאין דרך בני אדם לאכול לבונה להכי נקט שמן:
Vayikra:342	הא מנחת כה״‬ג אינה חטאת וטעונה לבונה כצ״‬ל וכ״‬ה בת״‬כ. ומנחת כה״‬ג היא עשירית האיפה של מנחת חביתין שמביא בכל יום:
Vayikra:343	שיהיה מקטיר לאשים ומתכוין לשם כצ״‬ל וכ״‬ה בת״‬כ:
Vayikra:344	להשוות קלים כחמורים. פי׳‬ כי ג׳‬ עבירות כתובים בפרשה. וכל אחד חמיר מחבירו טומאת מקדש וקדשיו זדונו בכרת. ושמיעת הקול חומרא בו שהשווה שוגג כמזיד ושבועת ביטוי קלה מכולן שלא עשה בו שוגג כמזיד ואין זדונה בכרת. וג׳‬ קרבנות כתובים. כשבה או שעירה. ועוף. ומנחה. ולא תימא ליתן לכאו״‬א קרב: בפני עצמו קמ״‬ל שכולן שוות בו. ורק החילוקים הוא מעשיר לדל ודלי דלות כמו שמסיים. ועי׳‬ בת״‬כ בארוכה וכ״‬ה ברש״‬י בפירושו לחומש:
Vayikra:345	שתהא עבודת מנחה של כהן שלו. בת״‬כ קצת גירסא אחרת. וגירסא דהכא יותר נכונה. ואין הכוונה שהעבודה שייך לו ולא לבית אב המשמר של אותו שבוע. כי זה נלמד לקמן וכן בספרי פרשת נשא מאיש את קדשיו לו יהיו. אלא הכא רבותא קמ״‬ל מדכתיב וכפר עליו מאשר חטא. ה״‬א כי הוא בעצמו אינו יכול להקריב אחרי שהוא בעצמו החוטא רק כהן אחר יכפר עליו. כמו ע״‬ד מאמרם אין קטיגור נעשה סניגור קמ״‬ל כי הכהן החוטא בעצמו יכול להקריב (הרב רצ״‬ר בבאורו) בקצת תבלין:
Vayikra:346	הרי הוא לו כמנחת נדבה. הוא דרשא אחרת. ועיין בת״‬כ בארוכה:
Vayikra:347	קנא. לרבות כהן משיח וכו׳‬. עיין (מעילה י״‬ח):
Vayikra:348	אלא שיקור. בת״‬כ וכן במעילה שם הגי׳‬ אלא שינוי וכה״‬א וימעלו מעל בה׳‬ היינו ג״‬כ ששינו עבודת השם לכנעני:
Vayikra:349	בשגגה פרט למזיד. דהא כאן לחייב את המזיד מחמת שיש בו עון מיתה. ועיין ת״‬כ בארוכה:
Vayikra:350	יצאו ק״‬ק וכו׳‬. היינו קודם זריקת דמים ואז עדיין אינם מיוחדים לשם ואין בהם מעילה אבל באימיריהם לאחר זריקת דמים מועלין בהם. ועיין ת״‬כ:
Vayikra:351	והביא אף לאחר יוה״‬כ. כי אין יו״‬כ מכפר עד שיביא קרבנו:
Vayikra:352	שאין איל אלא לשון קשה. וזה כשהוא בן שתי שנים נשלם גידולו:
Vayikra:353	לאשם שיהיה הפרש מעות לאשם. כ״‬ה ג״‬כ בת״‬כ והמבארים נלחצו מאוד בכוונת הת״‬כ. והנה המחבר הזה הוסיף פירש האשם הוא הממון. נ״‬ל כוונתו כי אחרי כי התורה נתנה ערך האשם כסף שקלים בין בשעת היוקר ובין בשעת הזול כי לא נביט אל מיטב הקרבן רק שיעלה שני שקלים וזה כוונת הדרשה האשם הוא הממון כי השני שקלים הם האשם כן נ״‬ל בכוונתו והבוחר יבחר:
Vayikra:354	לרבות פחות משוה פרוטה. דורש ואת לרבות. כי אתין וגמין ריבויא הוא:
Vayikra:355	שהכהן עצמו מועל. אם בא לידו חטא מעילה חייב ג״‬כ קרן וחומש. דה״‬א אחרי כשזר מועל נותן לכהן א״‬כ כהן עצמו כשימעול יפטור קמ״‬ל דחייב:
Vayikra:356	האשם זו מעילת ממון. דורש באיל האשם ונסלח לו האיל. והאשם (זה הממון) מעכבי הכפרה:
Vayikra:357	אין משיירין לו ליו״‬כ. דלא תימא שהקרבן תולה עד שיבוא יו״‬כ ויתכפר לו קמ״‬ל שנתכפרה לו מיד:
Vayikra:358	הרי זה מוסיף על ענין ראשון כצ״‬ל. כי ואם מוסיף על ענין ראשון. ועיין בת״‬כ כי ר״‬ט פליג ע״‬ש.
Vayikra:359	חייב על כל אחת ואחת. כי המה שמות מחולקים:
Vayikra:360	קבע הכתוב פקוח נפש וכו׳‬ כצ״‬ל וכ״‬ה בת״‬כ. והיינו מה שנותה התורה לעשות ערי מקלט להציל הרוצח בשגגה:
Vayikra:361	הא אם ידע. (היינו אח״‬כ) אינו מתכפר לו עד שיביא חטאת כצ״‬ל וכ״‬ה בת״‬כ וכ״‬ה ברש״‬י בחומש:
Vayikra:362	אע״‬פ שנערפה וכו׳‬. היינו כמו התם אם נמצא הרוצח יהרג כי העגלה הערופה מכפר רק על לא נודע. ואף הכא אם שהביא אשם תלוי אם נודע לו שחטא ודאי אינו מתכפר באשמו ונצרך לו להביא חטאת עיין (כריתות כ״‬ג) בהתחלת הפרק:
Vayikra:363	ואח״‬ב נודע לו שחטא, ונצרך להביא חטאת. וכן הדין אם נודע לו שלא חטא ג״‬כ האשם מותר לכהנים:
Vayikra:364	יצא וירעה בעדר. פי׳‬ הוא חולין גמורים והוא דברי ר״‬מ עיין ת״‬כ:
Vayikra:365	אשם הוא אשם אשם לה׳‬ כצ״‬ל. יכול כולו לבדק הבית (היינו שדורש אשם לה׳‬) והוא כולו לה׳‬ ת״‬ל אשם לכהן וכו׳‬ כ״‬ה הגי׳‬ בת״‬כ. אבל הלשון אשם לכהן לא מצאנו בקרא. והמבארים בארו או על קרא הקדום לאשם אל הכהן. או קרא גבי מצורע (ויקרא י״‬ד) כחטאת כאשם לכהן. ובאמת דוחק הוא כי הלימוד רק מהאי קרא ממלות כפולות. אשם הוא אשם אשם לה׳‬. ומתורתו של אליהו למדתי מפי הגר״‬א ז״‬ל באדרת אליהו וזה לשונו אשם הוא יכול לכהן (פי׳‬ כי מלת הוא דורש אל הכהן) ת״‬ל לה׳‬ וע״‬ז מסיים הדרשא מותרי אשמות וכו׳‬ וכן אפשר לפרש בת״‬כ וכן הכא ת״‬ל אשם לכהן על קרא דהכא אשם הוא היינו הכהן וכן נראה מבבלי (חולין כ״‬ג. זבחים ק״‬ג) אשם הוא וכו׳‬ כל שבא לשם חטאת ואשם וכו׳‬ הבשר לה׳‬ ועורה לכהנים. דורש הוא על הכהן. וכאשר מסיים הת״‬כ והפסיקתא הדרשא שדרש יהוידע הכהן. ולאשר זה דבר חדש ע״‬כ הארכתי קצת:
Vayikra:366	ומוציא אשם נזיר ומצורע. שהם כשב בן שנתו. הלכך בבציר סגי. דאיל בן שתי שנים בשני סלעים וכבש בן שנתו די בסלע:
Vayikra:367	אר״‬ל קשה גזל ההדיוט. (ב״‬ב פ״‬ח:):
Vayikra:368	אר״‬י ב: חנילאי. בת״‬כ וכן (ב״‬ק י״‬ג.) ה״‬ג ר״‬י הגלילי להביא קדשיס קלים למעילה והיינו שהם ממונו וכחש בעמיתו קרינן ביה.
Vayikra:369	והנושא והנותן אינו מלוה אלא בעדים והמכחש בעדים מכחש וכו׳‬ כצ״‬ל:
Vayikra:370	יכול דברים. פי׳‬ שכיחש לו בדברים בעלמא כמו שאומר אכלת והוא לא אכל ת״‬ל בפקדון דבר בהוא ממון:
Vayikra:371	פירשו רבותינו. (בב״‬מ מ״‬ח:) ע״‬ש שייחד לו כלי לעשקו:
Vayikra:372	עמיתו עמיתו שני פעמים. וכחש בעמיתו וכו׳‬ או עשק את עמיתו (ועיין בת״‬כ):
Vayikra:373	פרט לאחרים. היינו כנענים:
Vayikra:374	שיקדם חטא לכחישה. כגון דבר של ממון דמיד שנתן עיניו לגזול אה חבירו חטא:
Vayikra:375	בה ולא במוצאה. עיין ת״‬כ ורבו בזה הפירושים. ויותר נכון דעת רש״‬י (ב״‬ק ק״‬ה:) האבדה שאמר שראה אותה מהלכה ברשות אחרת ואינו יודע מי הוא או הודה שהכיר במוצאה ולא בה והיה לו לומר איש פלוני מצא האבדה ואינו יודע אם שלך וכו עכ״‬ל רש״‬י ופטור. ותפס כפי דעת ר״‬א אר״‬ח לפעור ע״‬ש:
Vayikra:376	כגון המערב מים ביין וכו׳‬. עי׳‬ ת״‬כ. והכוונה אפילו על דבר שאין ידוע בשעה שמכר ואח״‬ כ הודה חייב קרבן שבועה.
Vayikra:377	יצאו הקנסות וכו׳‬. פי׳‬ אחרי שקנס אם הודה מעצמו פטור ע״‬כ אם כפר בו פטור ג״‬כ מקרבן שבועה. ובת״‬כ גי׳‬ אחרת ומרבה קנסות. ושם הכוונה קנס לאחר שעמד בדין הוה ממון.
Vayikra:378	והיה מיד. פי׳‬ מתחלה ישיב הגזילה ואח״‬כ יביא הקרבן לכפרה:
Vayikra:379	גזילה הוא משיב וכו׳‬. עיין בת״‬כ יכול משיב ומשלם פי׳‬ מדכתיב והשיב את הגזילה. ואח״‬כ ושלם אותו בראשו ה״‬א אם הגזילה קיימת כי זולת שישיב הגזילה בעין עוד יוקנס שיתן דמי שויה זולת החומש כמו שמצאנו גבי גנב שמשלם כפל:
Vayikra:380	אשר גזל על מה שגזל. הוא דורש אשר גזל הוא דוקא משלם חומש ואשם וכ״‬ה בת״‬כ:
Vayikra:381	יכול לא ישיבנו כל עיקר כצ״‬ל. וקאי על גזילת אביו היינו גם הקרן לא ישיב:
Vayikra:382	ר״‬ש אומר. במתניתין שם ליתא מלת רבי שמעון. אלא בגמ׳‬ שם (קי״‬ג.) מתני ליה רבי לר״‬ש בריה ע״‬כ תפס הכא ר״‬ש:
Vayikra:383	ולא שעשק אביו. היינו לענין חומש:
Vayikra:384	פרט למציל מן הים וכו׳‬. שכבר נתייאשו הבעלים עיין (בבא קמא קי״‬ד):
Vayikra:385	להביא תשומת יד לשקר. כי בקרא דלמטה והיה כי יחטיא חסר בקרא תשומת יד:
Vayikra:386	אינו משלם אלא לאחר שבועה כצ״‬ל. והיינו החומש וכ״‬ה בת״‬כ:
Vayikra:387	ולא תשלומי כפל. פי׳‬ אם כפר בפקדון ואמר להד״‬מ ונשבע ואח״‬כ באו עדים שגנבו אם לא הודה מעצמו משלם כפל. ואם הודה מעצמו מעיקרא קודם שבאו העדים משלם קרן וחומש אבל לא תשלומי כפל אפילו באו עדים אח״‬כ:
Vayikra:388	עד שיתמעט הקרן פחות משוה פרוטה כצ״‬ל וכ״‬ה בת״‬כ:
Vayikra:389	שיהיו הוא וחומשו חמשה וזה חומש מלבר כצ״‬ל ולגבי קרן הוא חומש מלגאו:
Vayikra:390	ולא יתנו לשלוחו. עי׳‬ (ב״‬ק ק״‬ד) לשלוחו היינו שכירו ולקיטו אבל עשאו הבעלים שליח יכול למסרו ומקיים מצות השבה עש״‬ה:
Vayikra:391	לשליח ב״‬ד אבל יתננו לשליח ב״‬ד או ליורש כצ״‬ל וכ״‬ה בת״‬כ ובזה מקיים השבה ויכול להביא קרבן אח״‬כ:
Vayikra:392	היינו דתנן ב״‬ש וכו׳‬. נ״‬ל כוונת הדורש כי כל התנאים למדו מקרא ביום אשמתו כי ביום אשמתו נוכל לפרש בשעה שגזל שאז עבר עבירה בגזל. ויש ג״‬כ לפרש ביום אשמתו בשעה שמביא האשם ואז הוא אחר שמשלם הגזילה בשעה שמביא הקרבן. ובזה אבוא לפרש פלוגתתם לב״‬ש ספוקי מספקא ליה פי׳‬ הקרא ע״‬כ דורשים לחומרא שילקה בחסר וביתר וב״‬ה אומרים כשעת הוצאה ס״‬ל ביום אשמתו בשעה שגזל. ר״‬ע אומר כשעת התביעה ר״‬ל ביום אשמתו בשעה שמשלם הגזילה קודם שיביא האשם ועיין (ב״‬מ ס׳‬:) על דברי ר״‬ע היכא שיש עדים שגזל דפליגי שם אמוראי אס מחייב כשעת התביעה או כשעת הגזילה ע״‬ש:
Vayikra:393	ואת אשמו וכו׳‬ אף לאחר יו״‬כ. דורש יתורא דוא״‬ו ממלת ואת:
Vayikra:394	כיצד ה׳‬ תובעין וכו׳‬. עירבובי דברים בכאן. ועיין בת״‬כ כל פרטי דינים בזה. וכללא הוא. שאין חילוק בין א׳‬ לה׳‬ בני אדם. אם תבע אותו א׳‬ פקדון ותשומת יד וגזל וכו׳‬ ואמר שבועה שאין לך בידי אינו חייב אלא אחת. אין לך בידי פקדון ותשומת יד וכו׳‬ חייב על כל או״‬א. היו ה׳‬ בני אדם תובעין אותו וכו׳‬ אמר שבועה שאין לכם בידי חייב אחת לא לך ולא לך וכו׳‬ חייב על כל או״‬א:
Vayikra:395	לאשמה בה פרט לפחות משוה פרוטה כצ״‬ל היינו אם הקרן פחות משוה פרוטה לאו בר השבון הוא ואינו חייב קרבן שבועה: טיכום חטרי השבועות פי׳‬ טיכו״‬ס מלשון (Tekst) בלע״‬ז ופירושו עיקר. חטר״‬י על גדרות צאן התרגום חטר״‬י דענא. ויהיה הפירוש עיק״‬ר גדר״‬י השבועו״‬ת אשר מבוארים בפרקים האלה:
Tzav:1	צו זה זירוז וכו׳‬. ת״‬כ ועיין (קדושין כ״‬ט.) לימד זה ר״‬י מקראי:
Tzav:2	ויש בו חסרון כיס. עיין ת״‬כ ופי׳‬ כי העולה כולה כליל ויש חסרון כיס לכהנים:
Tzav:3	לאמר להזהיר גדולים על הקטנים. בת״‬כ ליתא דרשא זו ודרשא זו לא הבנתי הלא ההקרבה דווקא בגדולים ולא בקטנים ורק בפרשת אמור לענין טומאה שייך הדרשא. וצ״‬ע:
Tzav:4	שלא כל העתים וכו׳‬. עיין (יומא פ״‬א משנה ח׳‬) ביוה״‬כ תורמים מחצות וברגלים מאשמורה הראשונה:
Tzav:5	וחזיתה מזרחה כצ״‬ל ופי׳‬ מראית פניה דהיינו הפתח והחלון של מערכה לצד מזרח של מזבח:
Tzav:6	וריוח בין הגזרים נצ״‬ל:
Tzav:7	עצי תאנים יפים למערכה כצ״‬ל:
Tzav:8	הפיסו זכה מי שזכה כצ״‬ל:
Tzav:9	סודרין אותם בסובב על גבי הכבש כצ״‬ל:
Tzav:10	ולסדר אש המערכה כצ״‬ל:
Tzav:11	מה ת״‬ל ילבש. פי׳‬ כי מתחלה כתיב ולבש קאי ג״‬כ על המכנסים מה תלמוד לומר ומכנסי בד ילבש:
Tzav:12	ר״‬ש אומר וכו׳‬. חסר קצת ועי׳‬ בת״‬כ וכצ״‬ל מדו בד אלו ד׳‬ כלים וכו׳‬ ומכנסי בד ילבש על בשרו ולא רטיה על בשרו כשהוא אומר להלן (היינו בפרשת אחרי גבי כה״‬ג) ומכנסי בד יהיו על בשרו שלא יהיה דבר קודם למכנסים וכו׳‬:
Tzav:13	ת״‬ל אשר האבל האש וכו׳‬. והכוונה שהיה חותה מן המאוכלות הפנימיות (כמו שמסיים) מאמצע הדליקה והוא מן אברי העולה שאכלם האש ולא מן העצים עיין בת״‬כ וק״‬א שם:
Tzav:14	ושמו שלא יפזר ושמו בנחת. היינו שלא ישליך רק יקח במתון והוא דרשה א׳‬ עם שלא יתפזר:
Tzav:15	והוציא את הדשן זה כל הדשן וכו׳‬ כצ״‬ל. ועיין במס׳‬ תמיד. והיינו כשהיה הדשן מרובה מוציא אותו מחוץ למחנה ואינו הרמת הדשן:
Tzav:16	והואיל ומכשיר הקטורת. פי׳‬ העצים מכשירין את הקטורת כי לקטורת להקריב נצרך אש ועיין (יומא ל״‬ג):
Tzav:17	משקל זה הפסוק. פי׳‬ הקרא דהכא הקרב הכוונה הקרב יקריבו כמו התם העלם יעלימו:
Tzav:18	שנאמר העלם עיניך מאשת חן. קרא הוא בבן סירא עיין (סנהדרין ק׳‬) מביא שם קרא זה:
Tzav:19	לפני ה׳‬ יכול במערב ת״‬ל אל פני המזבח. אי אל פני יכול בדרום. (פי׳‬ כי פני המזבח הוא כותל דרומי ששם הכבש) ת״‬ל לפני ה׳‬ הא כיצד מגישה בקרן דרומית מערבית כצ״‬ל וכ״‬ה בת״‬כ ובכאן ע״‬ס:
Tzav:20	מן המחובר. פי׳‬ שיהיה כל המנחה בכלי אחד ומחוברת יחדיו כדמסייס שלא יביא בשני כלים:
Tzav:21	אוי להם וכו׳‬. בימי המחבר הזה היו הרבה פוקרים שהכחישו הקבלה מחז״‬ל ועשו דינים מחודשים כפי העולה על רוחם ע״‬כ דבר דברים כאלה. גם רבינו הרמב״‬ם בפי׳‬ המשניות נדרים פ״‬ו על המשנה הפרת נדרים כל היום כותב לפי שבמקומינו אינם נובעים מים הרעים וכו׳‬ כוון ג״‬כ לפוקרים כאלה:
Tzav:22	תאכלו אפילו כ״‬ש כצ״‬ל. ופי׳‬ אפילו כל שהוא אסור לאכול חמץ ובת״‬כ דרשה זו בארוכה ע״‬ש:
Tzav:23	יאכלוה שלא יאכלו עמה חולין ותרומה בזמן שהיא מרובה כצ״‬ל. וכ״‬ה בת״‬כ ופי׳‬ בזמן שהקודם מרובה לא יאכל עמה חולין ותרומה שלא יאכל הקודש באכילה גסה:
Tzav:24	ומעשה יחידי כצ״‬ל. ועי׳‬ (מנחות נ״‬ה) מעשה יחידי נקרא קיטוף שמחליק פניה במים הוא גם כן חשוב לחייב ע״‬ז בפ״‬ע. ועיין בת״‬כ:
Tzav:25	אף כל קדשים אין לך בה וכו׳‬ כצ״‬ל:
Tzav:26	יאכלנה הכשירה וכו׳‬. קאי על המנחה אם היא כשירה אם פסולה פסולה. ואס כשירה יאכלו כחמור שבה כצ״‬ל פי׳‬ כחמור שבה אם נגע הנאכלין לשני ימים עם הנאכלין ליום אהד תאכל כחמור שבה ליום אחד:
Tzav:27	ואומר בנחמיה זה אלהיך ישראל כצ״‬ל וקאי על העגל:
Tzav:28	מלמד שהיא טעונה וכו׳‬ להוסיף וכו׳‬. פי׳‬ כי בשמן יתורא הוא כיון דכתיב על מחבת ומנחת מחבת היא בשמן. ע״‬כ דורש להוסיף עוד שמן:
Tzav:29	יש להם תרבוך. הוא כמו קצף (שוי״‬ם) מלמעלה:
Tzav:30	ומרנא ורבנא טוביהו וכו׳‬. עי׳‬ )מנחות נ״‬א) כי גם הצאן קדשים הגיה ג״‬כ כפי גירסת המחבר דנין תש״‬ט יג״‬ל:
Tzav:31	תופיני האפנה נא כצ״‬ל. ועיין בת״‬כ (ובמנחות נ׳‬.) ומי שסובר תאפה נא היינו שלא יאפה כל צרכו כמו אל תאכלו נא:
Tzav:32	ר׳‬ דוסא אומר וכו׳‬. בת״‬כ הגי׳‬ ר׳‬ יהורם אומר תאפנה נאה. ועיין במנחות וברש״‬י שם שני לשונות בזה:
Tzav:33	יצא משוח מלחמה שאין בנו עומד תחתיו כצ״‬ל שנא׳‬ שבעת ימים וכו׳‬ וזה ראיה שבן משוח מלחמה אינו עומד תחתיו. וכ״‬ה בהדיא בת׳‬׳‬כ:
Tzav:34	מנחת כהנת נאכלת. היינו הנשואה לישראל כדתנן בסוטה דמנחתה נאכלת:
Tzav:35	תורת החטאת הורה אחת לכל החטאות כצ״‬ל וכ״‬ה בת״‬כ:
Tzav:36	ת״‬ל אשר יזה על הבגד. ומה בגד ראוי לקבל טומאה אף עור משהופשט ראוי לקבל טומאה. ועי׳‬ בת״‬כ בשם גירסא אחרת בזה:
Tzav:37	וכלי חרש אשר תבושל בו ישבר. והיכן ישבר נאמר למעלה תכבס במקום קדוש מה כיבוס במקום קדוש אף שבירת כלי חרס במקום קדוש כצ״‬ל. ובכאן הגי׳‬ מוטעה ועיין בת״‬כ:
Tzav:38	אבל שאר מיני מתכות טעונין ליבון באש. לא יכולתי לבאר זה כלל. ובת״‬כ בפירוש מרבה ואם בכלי נחושת אין לי אלא כלי נחושת שאר מתכות מנין ת״‬ל ואם בכלי נחושת. ואם ריבה הכל. ובלי ספק כי טעות הוא ע״‬כ הסגרתי במוסגר:
Tzav:39	אלא וכל לרבות את האשם. דכתיב כחטאת כאשם תורה אחת להם והוא דברי ר״‬א בת״‬כ וכן צ״‬ל הכא:
Tzav:40	פרט לתודה ואיל נזיר. שנאכלין לכל אדם:
Tzav:41	פרט לעולת הקדש. עיין (זבחים ק״‬ג.) מאי ממעט:
Tzav:42	פרט לטבול יום וכו׳‬. שאינו חולק לא בבשר ולא בעורות:
Tzav:43	יבול לו לבדו. כדכתיב בסוף הקרא לכהן המקריב לו יהיה:
Tzav:44	ת״‬ל וכל וכו׳‬ והריבה לבל בני אהרן תהיה איש באחיו. הרי שכל הכהנים חולקים נשוה:
Tzav:45	מלמד שהתודה וכו׳‬. ולשם שלמים כדכתיב ברישא וזאת תורת זבח השלמים:
Tzav:46	הלכה למשה מסיני. קאי על כולם על חצי לוג שמן לתודה ורביעית שמן לנזיר וכו׳‬:
Tzav:47	והקריב ממנו אחד מן המחובר כצ״‬ל וכ״‬ה בת״‬כ. ופי׳‬ היינו בשעת הרמה צריך להיות הג׳‬ מינים ביחד:
Tzav:48	אף לחם חמץ האמור כאן עשירון לחלה. חסר סיום הדרש ועיין בת״‬כ מפייס נראה למי דנין. דנין דבר שבאה חמץ ובאה עם הזבח ואל יוכח לחם הפנים שאינה באה חמץ ואינה באת עם הזבח:
Tzav:49	עשרה עשרונים לחמץ עשרה עשרונים למצה כצ״‬ל:
Tzav:50	תנהו הענין לשחיטתו יהי׳‬ ע״‬מ לאכול ליום א׳‬ וכו׳‬ כצ״‬ל:
Tzav:51	מה בין נדר לנדבה. אין כוונתו החילוק לדינא כי בזה חייב באחריותו ונדבה פטור רק הכוונה על הלשון נדר ונדבת קאי:
Tzav:52	יכול אם עבר יום השלישי ולא נשרף לא ישרף עוד ת״‬ל ישרף לעולם כצ״‬ל וכ״‬ה בת״‬כ.
Tzav:53	אר״‬א כוף את אזניך וכו׳‬. הוא עפ״‬י מאמרם (חולין פ״‬ט ע״‬א) כל מקום שאתה מוצא דבריו של ר״‬א בנו של ריה״‬ג באגדה עשה אזניך כאפרכסת וכו׳‬ ע״‬ש:
Tzav:54	ולא המאכלת. היינו מי שתחב לחבירו בפיו אינו חייב חטאת:
Tzav:55	לרבות בשר הפנימי. פי׳‬ כגון אם יצא קצת מאברי ק״‬ק חון לעזרה או מקדשים קלים חון לחומה ונשאר מקצתו בפנים דהיוצא אסור. והפנימי הנשאר בפנים מותר לאכול:
Tzav:56	לפי שנאמר ודם זבחיך ישפך על מזבח ה׳‬ אלהיך והבשר תאכל (כצ״‬ל) ה״‬א והבשר תאכל מהדר אלעיל היינו על הבעלים שדם זבחו ישפך והבשר יאכל רק הבעלים. קמ״‬ל כל טהור יאכל בשר. וכ״‬ה בת״‬כ ועיין ג״‬כ רש״‬י בחומש מביא דרשה זו:
Tzav:57	בזמן שראוי לטהורים חייבין בו הטמאים פרט לפני זריקה כצ״‬ל:
Tzav:58	שיש בהם מינין הרבה וכו׳‬ כצ״‬ל:
Tzav:59	במגע ולא במשא. פי׳‬ במשא אינו מטמא. ובת״‬כ יליף מקרא כי תגע במגע מטמא ולא במשא:
Tzav:60	אלו נאמרו חמורות וכו׳‬. חמורות טמא מה קלות מגע בהמה. ועי׳‬ (זבחים מ״‬ד.) קלות טומאת שרץ חמורות טמא מת. ובת״‬כ קצת גירפא אחרת:
Tzav:61	ואין העובדי כוכבים מוזהרין על חלב. דה״‬א לחייבן בק״‬ו מן אבר מן החי עי׳‬ ת״‬כ:
Tzav:62	לאמר להזהיר זה על זה. אולי הוא כעין דרשה של מעלה להזהיר גדולים על הקטנים עמש״‬ל. ובת״‬כ הדרשה אל בני ישראל לרבות הגרים והמשוחררים ואולי ט״‬ס בכאן:
Tzav:63	שאינו בכרת והוא במלקות. תפס כדברי ר״‬ש כ״‬ש למלקות עיין (מכות י״‬ז) ובת״‬כ הגירסא הרי הוא באזהרה:
Tzav:64	יכול דם מהלכי שתים. הוא דם האדם ההולך בשני רגליו. ודם ביצים ודם חגבים ודם דגים הכל בכלל ת״‬ל לעוף ולבהמה מה עוף ובהמה מיוחרים שיש בהם טומאה קלה ויש בהם טמאה חמורה יש בהם איסור ויש בהם היתר והם מין בשר ?צא דם מהלכי שתים שאין בהם קלה דם שרצים שאין בהם טומאה חמורה דם ביצים שאין מין בשר דם דגים וחגבים שכולו טהור כצ״‬ל וכ״‬ה בת״‬כ ובכאן נשמט הרבה:
Tzav:65	מה זה בא לחדש תנופה. להניף אותו תנופה לפני ה׳‬. ע״‬ז קאי בני ישראל מניפין וכו׳‬ ועיין בת״‬כ וכן (מנחות ס״‬א) דהכוונה אין קרבן עובדי כוכבים ונשים טעונין תנופה היינו שהם בעצמם לא היו מניפין הקרב: רק הכהן בעצמו מניף הקרבן. ועי׳‬ בק״‬א שהאריך בזה:
Tzav:66	ת״‬ל זבח יצאו מנחות ועופות שאינן טעוני: תנופה. מזבח יצא בכור וכו׳‬ מ״‬מ דריש עיין ת״‬כ:
Tzav:67	בנין אב וכו׳‬. חפר כאן וכצ״‬ל וכ״‬ה בת״‬כ למדנו שטעונין כולם תנופה מנין שטעונין הרמה כו׳‬ ת״‬ל וקדשת את חזה התנופה ואת שוק התרומה אשר הונף׳‬ ואשר הורם אלא זה בנין אב כל שטעון תנופה טעון הרמה:
Tzav:68	ת״‬ל והיה החזה וכו׳‬. עיין בת״‬כ ובכאן נפל טעות בהתחלת הדרשה וכצ״‬ל נטמאו אימורין או אבדו יכול לא יהיו אהרן ובניו זכאין בחזה ושוק ת״‬ל והיה כו׳‬ והיה רבוי אם נטמאו או אבדו האימורין באונס אעפ״‬כ החזה והשוק לכהנים עיין בת״‬כ. והראיה וכה״‬א בבני עלי קאי אלמעלה אם לא נטמאו אזי אין הכהנים זכאין בחזה ושוק עד אחר הרמה. ובני עלי נטלו בזרוע חלקם קודם הקרבה: מחצה
Tzav:69	מחצה מחצה. היינו מחצה לאהרן ומחצה לבניו שכה״‬ג נוטל חלק בראש:
Tzav:70	כל שאינו מודה בעבורה. פי׳‬ שאומר בלבו דבר הבל הן שלא צוה המקום להקריב קרבנות וכו׳‬ ודורש המקריב את דם המודה בעבודה:
Tzav:71	שני דברים וכו׳‬. חסר כאן ועיין בת״‬כ. ב׳‬ דברים המשמשין את הגוף אין בני אדם נמנעין מלעשותן ואין מקבלים עליהם שכר שאדם אומר לחבירו הדלק לי את הנר הזה (פי׳‬ שמדליק נרו מנר של חבירו ואין בזה היזק לו) ואגף לי את הדלת אחריך (פי׳‬ כשיוצא מהבית אחריו סגור הדלת כי אין זה מלאכה) אין נמנעים מלעשותן ואין מקבלים עליהם שכר ואתם לא עשיתם חנם וכו׳‬ כי הנהנים מקבלים מתנות כהונה בעבור עבודתם:
Tzav:72	זה אהרן ודוד. היינו שבניהם יהיו משוחים לעתיד מאותו שמן ׳‬ שנמשחו כבר. עיין בת״‬כ ובק״‬א:
Tzav:73	שאף האשים סייעו. היינו זכות הקרבנות:
Tzav:74	מרצון בני ישראל. שכולם הסכימו לדבר ועיין בת״‬כ:
Tzav:75	אר״‬ל מאי דכתיב זאת התורה וכו׳‬. (מנחות ק״‬י) כה״‬ע ע״‬ש:
Tzav:76	למדנו מזה וכו׳‬ אלא תש״‬ט שכולם טעונים כלי כצ״‬ל. ועיין לעיל בדברי המחבר:
Tzav:77	וכן אתה מוצא וכו׳‬. פי׳‬ זה ג״‬כ ראיה שהוא באחד בניסן שהרי משה דרש את השעיר למה נשרף הרי שלא היה העבודה בידו אלא ביד הכהנים. וג׳‬ שעירים היו באותו יום שעיר נחשון זו חטאת וחטאת יום השמיני ושעיר של ר״‬ח ע״‬ש בת״‬כ וכן בדברי המחבר לקמן:
Tzav:78	שלא יהא לבם אלא לדבר אחד. כה״‬ג ג״‬כ בת״‬כ ודחוק. ועיקר הכוונה נראה כי משה הבטיח לו שכבר נתכפר לו במעשה העגל ואל ידאג מזה. ורק יעסוק בהקרבת הקרבנות. וכן משמע ממדרש רבה. וכן בילקוט שמעתיק מדברי התנחומא:
Tzav:79	זה היה מעשה וכו׳‬. כמו שאמ למעלה:
Tzav:80	לא כסדר וכו׳‬. עיי: בת״‬כ ובק״‬א דובר בזה דברים נכונים:
Tzav:81	בשם שהסדיר משה עבודת המקדש כן הסדיר עבודת כהונה ובגדי כאו״‬א לפי מה כהוא מקריב כצ״‬ל. וכ״‬ה בת״‬כ ובכאן חסר:
Tzav:82	שנעשה משה סגן לאהרן. שהיה משמשו:
Tzav:83	ולימדה לעתיד לבוא. הכוונה לימים הבאים כמו שמסיים לשירות יוה״‬כ:
Tzav:84	וכאן היה מסרגן. סירוג נקרא דבר שלא כסדר כמו קראה סירוגין (מגילה י״‬ז) ועיין ערוך וכן כאן אומר סידור הבגדים שלא כסדרן ועיין בק״‬א שהביא דברי המחבר:
Tzav:85	בדמפורש. (בהוריות י״‬א. ובכריתות ה׳‬) ע״‬ש:
Tzav:86	מאחר שהלבישן חוזר ומושחן פי׳‬ כי המשיחה שהמשיח אותן נתקדשו ג״‬כ הבגדים:
Tzav:87	מתחלה לא היה נקרא וכו׳‬. עיין בק״‬א שכתב דברים של טעם למה מהחלה לא היה נקרא פר חטאת ואחר כך נקרא פר חטאת:
Tzav:88	כפרה זו וכו׳‬. עיין רש״‬י בחומש שפי׳‬ בענין אחר:
Tzav:89	כל שלא למד מב׳‬ פרשיות וכו׳‬. כה״‬ג בילקוט ג״‬כ ובת״‬כ גירסא אחרת בזה. וגירסא דהכא נכונה. ופי׳‬ ב׳‬ פרשיות מה שנאמר קרבנות המלואים באתה תצוה ונשנית כאן עוד הפעם. והיינו דברים שנאמרו בפרשת ואתה תצוה אינו עיכובא שינהג כן לדורות (עיין בק״‬א) כמו שמסיים אח״‬כ מכאן למדנו סמיכה לעולה זריקה לעולה וכו׳‬:
Tzav:90	מלמד שהשני וכו׳‬. עיין בת״‬כ. שחסר כאן כי גם הפר וסל,המצות. אם לא הקריב לא יצא ידי חובת המלואים:
Tzav:91	בשמחה. אולי דורש ויסמכו בני אהרן. כאילו היה כתוב וישמחו בשי״‬ן ואותיות גיח״‬ק נמי מתחלפים וכ׳‬ נתחלף לח׳‬. עי׳‬ בק״‬א שפירש באופן אחר:<br>צא. [עי׳‬ בפס׳‬ ויקח משה משמן המשחה ובאות צ״‬ד]:
Tzav:92	זה גדר האמצעי. הוא חוט אמצעי שבאוזן:
Tzav:93	ללמדך וכו׳‬. מסיפא דקרא מאיל המלואים למשה היה למנה. וזה שאמר ומה משה וכו׳‬:
Tzav:94	שלשה דמים וכו׳‬. עיין כ״‬ז בת״‬כ ובק״‬א ובכאן הנוסחא מוטעת:
Tzav:95	כמו שנאמר. קאי על קרא דהכא כאשר צויתי והיינו בפ׳‬ ואתה תצוה:
Tzav:96	שבע פעמים. כתיב בפ׳‬ המלואים שבעה ימים היינו ב״‬פ דכאן ובואתה חצוה:
Shmini:1	אמר רשב״‬א א״‬ר יוחנן. אסתר רבה פ״‬א ושם הגי׳‬ בשם ר׳‬ יונתן. וע״‬ש בקצת שינוי. ועיין בבלי (מגילה י״‬א).
Shmini:2	ואם תאמר. והיה ביום אשר נלכדה ירושלים כצ״‬ל וכ״‬ה במגילה:
Shmini:3	וכן אמר ר׳‬ יהושע ב: לוי. במגילה הגי׳‬ ר׳‬ שמואל בר נחמני בשם ר׳‬ יוחנן:
Shmini:4	שהיה המשכן מצוייר. וזה בעטרה שעטרה לו אמו. וכ״‬ה בהדיא בה״‬כ:
Shmini:5	כדרך ששנינו. בתמיד פרק ר׳‬:
Shmini:6	חוטמו. כלפי זרועו:
Shmini:7	כעין מיתה וכו׳‬ כצ״‬ל. וכ״‬ה (סנהדרין נ״‬ב):
Shmini:8	במסכת סנהדרין. (שם נ״‬ב):
Shmini:9	וכמה בנים כו׳‬. דורש הנותרים הראוים לישרף:
Shmini:10	לפי שאין הכהנים כ׳‬ כצ״‬ל:
Shmini:11	רבי אומר בגדולה וכו׳‬. (תענית ט״‬ו מ״‬ב) ובקללה מתחילין מן הקטן. וכ״‬ה בה״‬כ:
Shmini:12	או שמא תאמר כו׳‬. ויהיה הפירוש אל תפרעו מלשון כי פרוע הוא:
Shmini:13	מכאן אמרו בה״‬ג וכו׳‬. (סנהדרין י״‬ח):
Shmini:14	רבותינו אמרו וכו׳‬. כל החשבון כמו שהוא כאן עי׳‬ ברב אלפס סוף מסכת פסחים:
Shmini:15	לפי שאי אתה יכול להוציא את אהרן וכו׳‬. עיין ת״‬כ בהתחלה אליו למעט את אהרן. אריב״‬ב י״‬ג דיברות נאמרו בתורה למשה ולאהרן וכנגדן י״‬ג מיעוטין ללמדך שלא לאהרן נאמר אלא למשה. וזה שאמר בכאן אי אתה יכול להוציא את. רק הדבור לאהרן:
Shmini:16	רבי אומר אומר אני. (סנהדרין כ״‬ב. תענית י״‬ז):
Shmini:17	ומנין שאף התרגום וכו׳‬. בת״‬כ גירסא אחרת יכול אף התרגום ת״‬ל ולהורות ועיין בילקוט גירסא אחרת:
Shmini:18	הנותרים שקולים וכו׳‬. חסר כאן וכצ״‬ל וכ״‬ה בת״‬כ יכול אף הראשונים שקולים לו בכבוד ת״‬ל הנותרים הנותרים שקולים עמו בכבוד ואין הראשונים שקולים עמו בכבוד:
Shmini:19	מלמד שהחלבים למטה כצ״‬ל וכ״‬ה בת״‬כ. ודורש מדכתיב על אשה החלבים הרי שהחלבים נתנים למטה בשעת הקרבה:
Shmini:20	מפני מה לא נשרף זה ומפני מה נאכלו אלו וכצ״‬ל:
Shmini:21	מלמד שאף אהרן וכו׳‬. דורש מדכתיב בני אהרן וכ״‬ה בהדיא בת״‬כ:
Shmini:22	הנותרים להוציא את פנחס. בת״‬כ הגירסא הנותרים מלמד שלא היה פנחס עמהם והוא גירסא יותר נכון:
Shmini:23	לכך נאמר כאלה. מן כ׳‬ דכאלה דריש וכ״‬ה בת״‬כ:
Shmini:24	אותי. הכהן אסור באנינה ואין הלוים אסורים באנינה בשיר כצ״‬ל. ובת״‬כ ליתא דרשה זו רק הילקוט מביא זה ושם מסמיך על קרא דכאלה:
Shmini:25	ומי גרם וכו׳‬. עיין בת״‬כ כי זה קושיא על דברי חנניה בן יהודה שהוא שלא כדבריו כי בכאן היה הטעות קודם ההקפדה ע״‬ש:
Shmini:26	זאת החיה אשר תאכלו מכל הבהמה מלמד שהחיה בכלל בהמה וכו׳‬ כצ״‬ל. ודורש שפתח בחיה וסיים בבהמה וכ״‬ה בת״‬כ.
Shmini:27	מכל הבהמה אשר על הארץ להוציא מה שבים כצ״‬ל וכ״‬ה בת״‬כ. והיינו חיות ובהמות מה שבים אסור:
Shmini:28	לרבות את השליל. מלת תאכלו דריש. וכ״‬ה בת״‬כ:
Shmini:29	ואם נשחטה במדבר וכו׳‬. (חולין נ״‬ט) כל המאמר ובסופו צ״‬ל ובלבד שיכיר גמל:
Shmini:30	שהרי אשה המעוברת וכו׳‬ כצ״‬ל:
Shmini:31	למדנו לשאר בהמות טמאות מק״‬ו כצ״‬ל. והק״‬ו הוא שאין להם אפילו סימן א׳‬ של טהרה:
Shmini:32	אך חלוק יש לך מעלה גרה וכו׳‬. שאין אתה אוכל היינו כשנטרפה הבהמה. וע״‬ז קאי המאמר ואלו טרפות וכו׳‬ ועיין (בכורות ז׳‬) דרשה אחרת בזה:
Shmini:33	נפחתה הגלגולת וכו׳‬. הם מהכשרות כדמסיים:
Shmini:34	ניקב הלב ולא ניקב לבית חללו כצ״‬ל:
Shmini:35	פחות משנים. ואין קשקשים פחות משנים כצ״‬ל ועיין בת״‬כ פלוגתא בזה:
Shmini:36	כגון אקונם וכו׳‬. (חולין ס״‬ו ע״‬ב) וע״‬ש ברש״‬י כי הוא שמות פרסים על דנים ועיין (ע״‬א ל״‬ט):
Shmini:37	וסימן עוד בדגים וכו׳‬. זה דבר חדש שלא הביאו כל המחברים ופלא הוא להגיד מדעתו סימן שלא נמצא בגמרא ובשארי דברי הגאונים:
Shmini:38	וכסימני ביצים וכו׳‬. (ע״‬א מ׳‬. חולין ס״‬ג) ע״‬ש:
Shmini:39	ואת הקיפה. הוא רוטב שנקרש.
Shmini:40	שהם בסאתים קצ״‬ב. (חולין צ״‬ט) ועיש ברש״‬י והוא כדברי המחבר:
Shmini:41	שאם אין לו כלל הוא אסור אבל וכו׳‬ כצ״‬ל ופי׳‬ דווקא אין לו.
Shmini:42	לפי שבבראשית. היינו בפ׳‬ בראשית בעת הבריאה:
Shmini:43	ואת אלה תשקצו וכו׳‬ לפי שהיו כצ״‬ל:
Shmini:44	לא יאכלו לחייב המאכיל באוכל. היינו המאכיל לקטנים עיין רש״‬י בחומש וכ״‬ה (יבמות קי״‬ד) ועי׳‬ בת״‬כ ובק״‬א שגירסא מוטעה היא. וכן כתב המזרחי בפירושו והדברים ארוכים. ואכמ״‬ל:
Shmini:45	יענה הם היענים וכו׳‬. עיין (חולין ס״‬ג ע״‬ב) וצ״‬ע קצת כי דרשותיו אינם כמו שהוא שם ע״‬ש:
Shmini:46	ידעו את עת בואנה. היינו שבאים בתחילת האביב סמוך לחג המצות ונקרא בלשוננו (בושעל):
Shmini:47	כגון הגמל וכו׳‬. לא הבנתי למה עירבב להביא ראיה מבהמות וחיות טמאים על עופות כי בהם נצרך השני סימני טהרה. ובעוף אם יש לו סימן א׳‬ טהרה רק שאינו דורס נאכל במסורת וצ״‬ע:
Shmini:48	ואווז הבר. המחבר התיר האווז הבר ועי׳‬ בשו״‬ע ונושאי כליו:
Shmini:49	יכול הכל יהיו אסור וכו׳‬ יכול הכל יהיו מותר וכו׳‬. הלשון אינו מדוקדק ועיין בת״‬כ ובק״‬א:
Shmini:50	את הארבה למינו ואת הסלעם למינהו. וזה שאומר רבה ה״‬א יתירה אצל סלעם. ועיין בת״‬כ גס (חולין ס״‬ה ע״‬ב) דורש למינהו ד׳‬ פעמים:
Shmini:51	וכן תנינן. (עדיות פ״‬ז) העיד ר׳‬ צדוק על ציר דגים טמאים שהוא טהור כצ״‬ל ונ״‬ה ג״‬כ בת״‬כ:
Shmini:52	להביא את השליל. בת״‬כ מסיים שיהיה אבר החי ממנו מטמא:
Shmini:53	ואם בחזיר וכו׳‬. וסיפא דקרא והוא גרה לא יגר:
Shmini:54	שלא תהיה שחיטה מטהרת כצ״‬ל. וכ״‬ה בת״‬כ והיינו אף ששחטה כדין אעפ״‬כ היא נבילה:
Shmini:55	נאמר למעלן וכו׳‬. ששני פעמים כתיב בקרא כל הנוגע בנבלתם:
Shmini:56	באבר מן המת וכו׳‬. בכאן צ״‬ע עיין בת״‬כ דרשה זו אם נאמר למעלה למה נאמר למטה אלא עליונים באבר מן החי ותחתונים באבר מן המת והלא דין הוא וכו׳‬ ע״‬ש אבל הלשון שאין לו חליפין לא נאמר שם כי באמת לא מצאנו שוס אבר מן החי שיהיה לו חליפין. רק דרשה זו נאמרה למעלה בספרי פ״‬ד יכול אף בשר הפורש מן החי יטמא ת״‬ל נבילה מה נבילה שאין לה חליפין אף אבר מן החי שאין לה חליפים (יצא בשר שיש לו חליפין אינו מטמא) ועיין ג״‬כ (חולין קכ״‬ה:) דתניא יכול יהא בשר הפורש מן החי טמא ת״‬ל וכי ימות מן הבהמה מה מיתה שאינה עושה חליפין אף כל שאינו עושה חליפין. וע״‬ש בתוס׳‬ ד״‬ה כוליא וכו׳‬ ע״‬כ הגי׳‬ דהכא מוטעת היא וצ״‬ע:
Shmini:57	ומנין אפילו ירד לים שהוא טמא ת״‬ל השרץ כל מקום שהוא שורץ כצ״‬ל וכ״‬ה בת״‬כ:
Shmini:58	בשרץ להביא עכבר שחציה בשר וחציה אדמה שמטמא כצ״‬ל. והכוונה אע״‬פ שאין יכול לשרוץ מ״‬מ טמא. ועיין ת״‬כ כל הדרשה:
Shmini:59	לרבות עורותיהן. היינו משמונה שרצים:
Shmini:60	כל הנוגע בהם וכו׳‬. חסר קצת ועיין בת״‬כ וכצ״‬ל יכול אע״‬פ שהיא סתומה (פי׳‬ הביצה סתומה) ת״‬ל הנוגע יטמא את שאפשר לו ליגע טמא. עד כמה הנקב עד כשעורה שכן אפשר לו ליגע כשעורה:
Shmini:61	כל הנוגע וכו׳‬ לרבות ידות הכלים. היינו יד הכלי שנגע בשרץ נטמא הכלי. ועיין בת״‬כ:
Shmini:62	מה שק וכו׳‬ שהוא משמש את האדם ואת משמשי אדם. פי׳‬ השק משמש אח האדם בעצמו לשכב עליו ולישב עליו והוא ג״‬כ משמש את משמשי אדם היינו להניח בו קערות וכוסות שהם משמשי אדם:
Shmini:63	והתם מנלן דכתיב בכל מלאכת עור. עיין בת״‬כ כאן וכן בפרשה תזריע או בעור להוציא עורות שבים דומיא דבגד מה בגד הגדל מן הארץ אף עור הגדל בארץ. וכן העתיק המחבר הזה הדרשה לקמן ולא הבנתי מה לעשות בכאן דרשה חדשה וצ״‬ע:
Shmini:64	למדנו לאוכלי בהמה וכו׳‬. היינו דווקא מאכל אדם מטמא ולא מאכל בהמה. ועי׳‬ ת״‬כ:
Shmini:65	יצאו בבורות  וכו׳‬. אינם מקבלים טומאה במחוברים. ועי׳‬ בת״‬כ:
Shmini:66	וכל אשר יפול וכו׳‬. עיין דרשה זז בת״‬כ ובכאן צ״‬ע:
Shmini:67	שאינן מקבלין טומאה. פי׳‬ טומאה כלי חרס שמטמאין מאוירו. אבל טומאת כלי מתכות יש להם כמו שמסיים:
Shmini:68	שמותר לקיימן לצורך אחרת. פי׳‬ דלא תימא מדכתיב יותץ שאסור לקיימן כשהם טמאים ת״‬ל טמאים הם אבל מותר לקיימן כשהם טמאים:
Shmini:69	הוצרך לומר אך מעין ובור וכו׳‬. פי׳‬ שהם אינם מקבלים טומאה אבל סוף הדרשה המקוה יהיה טהור ולא המעיין לא הבנתי הלא במחובר אינם מקבלים טומאה וצע״‬ג. ובת״‬ה ליתא דרשה זו:
Shmini:70	אלא בהכשר. היינו שיתכשר המים והיינו שיחשוב כמו שמסיים:
Shmini:71	ידות האשכולות וידוית מכבדות תמרים כצ״‬ל ועיי: בת״‬כ כי אין שיעורן שוה:
Shmini:72	יכול אפילו בססן. היינו להידות. שדרס ברגלי הבהמה ונתבטלו מתורת יד:
Shmini:73	הרי זה מיתה וודאי. פי׳‬ ולא אבר מן החי להביא בהמה טמאה פי׳‬ אף ששחטה אין שחיטתה מטהרתה מידי נבילה:
Shmini:74	להביא בן שמונה כצ״‬ל ששחטו שחיטתו מטהרתו מידי נבילה. ובת״‬כ איתא פלוגתא בזה:
Shmini:75	יכול תהא נבלת בהמה טמאה וכו׳‬. עיין בת״‬כ ובק״‬א שהאריך בדרשה זו:
Shmini:76	[]
Shmini:77	יכול נבלת עוף תטמא. מן הכתוב ונבלת בהמה מק״‬ו (היינו ק״‬ו מנבלת העוף) ת״‬ל בה. בה את מטמא בבית הבליעה ואין את מטמא בנבלת בהמה טמאה בבית הבליעה כצ״‬ל. וכ״‬ה בת״‬כ ואח״‬כ מתחיל א״‬כ למה נאמר והאוכל וכו׳‬ כצ״‬ל ובכאן משובש:<br>עז. יכבס בגדיו כולם כאחת כצ״‬ל ועיין בת״‬כ:
Shmini:78	להוציא שבתוך הקטניות. והיינו כי אין שרצו בארץ. ועיין ברש״‬י בחומש.
Shmini:79	לא האכלום יכול יאכילם לתינוקות ת״‬ל לא יאכל כצ״‬ל. וכ״‬ה בת״‬כ. ודע כי גם בת״‬כ ט״‬ס בסוף:
Shmini:80	ומרבה טפשיות באדם כצ״‬ל. ובילקוט ראובני מקיים הגי׳‬ ומרבה הפשפשין ופירושו שמפשפשין במעשיו:
Shmini:81	מלמד שצריכין הוראה וכו׳‬. כמו שמסיים בין נשחט רוב הקנה כו׳‬:
Shmini:82	ליתן אזהרה לחיה. עיין ת״‬כ ופי׳‬ ק״‬א ויותר נכון פירושו האחרון אזהרה לחיה היינו לאבר מן החי:
Tazria:1	וצריכה לישב שבועים בדמי טומאה. ול״‬ג בדמי טהרה. פי׳‬ הל״‬ג לאו דוקא כי נצרך ג״‬כ לחשוב השבוע השני מימי טומאה בתוך הל״‬ג בדמי טהרה. כי אולי זכר הוא:
Tazria:2	וקרי ביה באריך. הא׳‬ קודם לר׳‬. כמו שמלה ושלמה אותיות הפוכות:
Tazria:3	והשני בשני בשבח סופרת עוד וכו׳‬ כצ״‬ל היינו שמתחלת לספור מלידת השני:
Tazria:4	דותה תטמא. עיין בת״‬כ (ובנדה ל״‬ה ל״‬ו) כל הסוגיא:
Tazria:5	ערלתו וודאי דוחה את השבת ואין ספק דוחה את השבת כצ״‬ל. פי׳‬ ספק אם הוא בן קיימא אינו דוחה שבת:
Tazria:6	מה מקדש שיש בו נטילת נשמה. פי׳‬ שחייב מיתה כמו שמסיים:
Tazria:7	לרבות יולדת זכר עד ל״‬א כצ״‬ל:
Tazria:8	למדנו שיש אם למקרא. היינו שלא לקרות שבעים יום. ועי׳‬ ת״‬כ:
Tazria:9	מלמד שאין א׳‬ מעכב את חבירו כצ״‬ל. וסי׳‬ כי החטאת אינה מעכבת את העולה:
Tazria:10	להביא עכ״‬פ שהפילה. פי׳‬ מה שהפילה אם יש בו מצורת הולד כמו שאומר למעלה מביאה קרבן:
Tazria:11	ואינה מביאה שלשה. עיין בת״‬כ כי הו״‬א היה ללמוד מק״‬ו שתביא שלשה:
Tazria:12	והשוטים שמעו וכו׳‬. דע כי הרמב״‬ם והרבה מהגאונים קראו תגר על מנהג זה. ועיין בטוי״‬ר סי׳‬ קצ״‬ד. אעפ״‬כ עיין בפרדס הגדול המיוחס לרש״‬י ז״‬ל דף ע״‬ד מביא זה בשם הירושלמי בכל קדש לא תגע זה אישה (היינו בעלה) שנאמר קדש ישראל לה׳‬. ובלי ספק כי המחבר לא ראה זה וחלילה לכנותם בשם גנאי הזה ועיין בס׳‬ קרמה הזוהר להגאון רד״‬ל ז״‬ל עשה לזה קצת סמוכים שבזמן הזה שאין לנו קדשים יש להחמיר לקיים והתקדשתם והייתם קדושים לקדש לבעלה בימי טוהר כמו לקדשים בזמן המקדש:
Tazria:13	אסורה לשמש. היינו עונה אחת. עיין בטוי״‬ד סי׳‬ קצ״‬ד:
Tazria:14	ואם לאו לוקה בצרעת כצ״‬ל:
Tazria:15	אע״‬פ שאין ראוי לגדל שער. עיין בת״‬כ מדכתיב ושער בנגע וכו׳‬ ה״‬א שיהיה דווקא במקום הראוי לגדל שער:
Tazria:16	והיה מלמד שמצטער הימנו וכו׳‬ כצ״‬ל. והדרשה מעורבבת בכאן. עיין בת״‬כ ובילקוט ושם הגי׳‬ והיה בעור בשרו מלמד שהוא מצטער הימנו. ומנין שאף אחרים מצטערים ממנו כשרואים אותו ת״‬ל לנגע. והסיום דהכא לפי שפחות מכאן וכו׳‬ לא ידעתי לפרשו. ואולי צ״‬ל צרעת כגרים וע״‬ז קאי שפחות מכאן אינה נראית לכל והיינו שאין מצטערים בזה:
Tazria:17	לרבות ברגים אחרים. היינו כהגיס הדיוטים:
Tazria:18	שאי: בהם מורה. היינו שיגיד בהם טומאה:
Tazria:19	שאפי׳‬ אחד רואה את הנגעים. פי׳‬ שדי בכהן א׳‬ ועי׳‬ בת״‬כ:
Tazria:20	שיהיה נותן עיניו בו בשעה שרואה את הבשר. עי׳‬ בת״‬כ והרב ק״‬א פירש באופן אחר. ואס ראה מה שכתוב כאן לא כתב מה שכתב:
Tazria:21	שאת עיקרן משחיר וראשן מלבין טהור עיקרן מלבין, וראשן משחיר טמא כצ׳‬ל. וכ״‬ה בת״‬כ ובפ״‬ד דנגעים:
Tazria:22	ומראה פניה כו׳‬. הוא פי׳‬ על כמראה החמה וכו׳‬ והוא מדברי המחבר:
Tazria:23	ע״‬פ הכהן. אינו טמא עד שיטמאנו הכהן:
Tazria:24	שבעת ימים תחלה. היינו ההסגר הראשון:
Tazria:25	צריך לומר כשבוע הראשון. פי׳‬ לפיכך צריך לומר הקרא בשבוע הראשון וכן בשבוע השני וכ״‬ה בת״‬כ:
Tazria:26	יכול תהא הפשיון מטמא בתחלתה כצ״‬ל. פי׳‬ קודם שראהו הכהן:
Tazria:27	בראשונה חסר וכצ״‬ל הכהן הרואה אותה בראשונה רואה אותה בשניה וכו׳‬:
Tazria:28	שאם נשתנה מראיהו. היינו לד׳‬ מראות נגעים כמו שמסיים:
Tazria:29	שבא בכולו. שמטמא ג״‬כ בקרחת ובגבחת. עיין בת״‬כ:
Tazria:30	את הבא בכולו חסר וכצ״‬ל באדם לרבות שבא בכולו. וכ״‬ה בת״‬כ. ופי׳‬ שפרח הנגע בכל גופו אע״‬ג רטהור הוא כדכתיב כולו הפך לבן טהור הוא. אי הוה ליה מחיה טמא משום מחיה. ועי׳‬ בק״‬א:
Tazria:31	צרעת נושנת היא אינה צריכה דבר אחר לסעדה. א״‬כ למה נאמר שער לבן וכו׳‬ כצ״‬ל. ועיין ג״‬כ בת״‬כ רק שם נהפכה הגירסא. והכוונה כי אף בלא שער לבן מטמא המחיה אם יש בה כשיעור לקבל שער לבן ומחיה. ועיין ברש״‬י בחומש כוון ג״‬כ לדרשה זו:
Tazria:32	למדנו שאין מסגירין את המוחלט. היינו אם נראה בו נגע אחר כמו שמסיים שכל הנקרא טמא אינו זקוק לו לא להסגיר ולא להחליט:
Tazria:33	אפילו פורחת וכו׳‬ מעט מעט. בת״‬כ הגירסא אפילו פורחת וחוזרת ופורחת. וכאן ג״‬כ הכוונה כזה. וע״‬ש הרבה שינוי דינים בזה:
Tazria:34	על כל מיני צרעת. פי׳‬ אף שקרא כתוב רק בשאת. ודרשה זו כפול הוא כאן:
Tazria:35	ונאמר להלן בשר חי. היינו למעלה ומחית בשר חי בשאת:
Tazria:36	אין בוהק החוזר טמא. בת״‬כ מוסיף ג״‬כ ואין שער לבן החוזר טמא:
Tazria:37	שער לבן בתחלה וכו׳‬. עיין בת״‬כ הרבה דינים מחולקים בכאן והמחבר קיצר בזה:
Tazria:38	לא שנעשה צלקת. עי׳‬ בת״‬כ ובק״‬א באורו בזה:
Tazria:39	שיקרום השחין וכו׳‬. היינו דווקא מתחלה היה שחין ואח״‬כ שאת ולא להיפך ועיין ת״‬כ:
Tazria:40	תטמא חלקה. היינו מראה לבן:
Tazria:41	ולא בחוט היוצא ממנה. שיש בו רוחב שתי שערות כ״‬ה בת״‬כ:
Tazria:42	כענין שלמעלה כיצד שנים שבאו אצל כהן וכו׳‬ כצ״‬ל:
Tazria:43	להביא את שניתק נתק בתוך נתק. עיין ת״‬כ ובק״‬א. גם בנגעים פ״‬י:
Tazria:44	אין לי עמוק אלא דבר שהוא בידי שמים. לאפוקי נתקי אדם עיין ת״‬כ:
Tazria:45	וטימא אותו וכו׳‬. אינו מטמא מקום הבהרת. חסר כאן כל הדרשה ואינו מביא אלא סופה. ועיין בת״‬כ סוף פרשה ז׳‬ פיסקא ח׳‬ ט׳‬ ועיין ברש״‬י בחומש נתק הוא כך שמו של נגע כוון ג״‬כ לדרשה זו כפי הנדרש בת״‬כ שם:
Tazria:46	והתגלח בכל אדם. היינו שאינו צריך כהן:
Tazria:47	ולפשיון שיטמא שלא בשער הצהוב כצ״‬ל וכ“ה בת״‬כ. ופי׳‬ או פשיון או שער הצהוב הצהוב סימן טומאה:
Tazria:48	וכן שבבן. היינו בתינוק ותינוקת סימן גדלות:
Tazria:49	פירש עיקר. זה מדברי המחבר שמפרש מלת אום עיקר המכה:
Tazria:50	ואין הזקן מעכבו וכו׳‬. שאם היה לו נתק בראש ונמרט הראש אף שלא נמרט הזקן טהור הוא. ועיין בת״‬כ:
Tazria:51	ת״‬ל ראשו ראשו טהור הוא כצ״‬ל. פי׳‬ דכתיב כי ימרט ראשו. ואם מפאת פניו ימרט ראשו.
Tazria:52	ולפי שזכר אשה למעלה כצ״‬ל. פי׳‬ דכתיב ואיש או אשה כי יהי׳‬ בעור בשרם וכו׳‬:
Tazria:53	ולהלן הוא אומר שגלשו. בשיר השירים שגלשו מהר גלעד:
Tazria:54	הרי זו כזו מה זו מטמא כצ״‬ל ומטמא ג״‬כ חלקה שלא בפתוח ועיין ת״‬כ:
Tazria:55	ולא שאר הטומאות תהי טומאת: עפ״‬י כהן. בת״‬כ ליתא דרשה זו ואולי כוונתו שאר הטומאות זולת טומאת נגעים אינם שייכים לכהן:
Tazria:56	אף בראשו מחוץ לגופו. ויהיה הפירוש לר״‬ע ראשו יהיה פרוע מגולה ועיין (מ״‬ק ע״‬ו.) גבי אבל כהאי גוונא:
Tazria:57	לא של שער. הוא דרשה בפ״‬ע ששער אינו מטמא דה״‬א לילף מנזיר שמטמא עיין בת״‬כ:
Tazria:58	יכול יהיו מטמאין מיד. היינו קודם שנגמרה מלאכתן מדכתיב או בשתי או בערב מעת שנארגו שתי וערב יטמאו:
Tazria:59	אפילו כולו ערב. ט״‬ס וצ״‬ל אפילו כולו שתי ואפילו כולו ערב. וכ״‬ה בת״‬כ ופירושו האונין השיעור שיארג בו ג׳‬ על ג׳‬ או של שתי או של ערב. ועיין בק״‬א שם. ועיין בנגעים פ׳‬ י״‬א וכמה יהא בפקעת כי דברי המחבר מועתק מן המשנה:
Tazria:60	לרבות עורות אהלים שהם כלים כצ״‬ל וכ״‬ה בת״‬כ ודורש מלאכת עור:
Tazria:61	והיה הנגע ירקרק. יכול כל מראה ירוק ת״‬ל ירקרק ירוק שבירוקים אדום יכול כל מראה אדום ת״‬ל אדמדם אדום שבאדומים כצ״‬ל. וכ״‬ה בת״‬כ.
Tazria:62	לא יצטרפו זה עם זה. היינו ירוק ואדום:
Tazria:63	ה״‬ל ימים ט״‬ם וכצ״‬ל וכ״‬ה בת״‬כ נגע צרעת הוא והראה כו׳‬ דלא קפיד קרא אמקום אלא אנגע בכל מקום שהוא והובא:
Tazria:64	ת״‬ל בבגד. דורש הקרא כך כי פשה הנגע (אפילו כל שהוא) בבגד? משמע כל שטח הבגד אף במקום אחר צרעת ממארת הוא. אך כשהוא במקום אחר צריך להיות כגרים דוקא כמו שמסיים:
Tazria:65	יכול יביא גיזי צמר. פי׳‬ מדיכתיב ושרף וכו׳‬ אח השתי וכו׳‬ בצמר או בפשתים זיהוי צריך לכתוב מצמר וכו׳‬ ועי׳‬ בת״‬כ דהא דכתיב בצמר לרבות האמריות ע״‬ש:
Tazria:66	[]
Tazria:67	הא אם היפך ולא פשה. עיין ברש״‬י בחומש בפסוק זה:
Tazria:68	כהה למראה שני ולא למראה שלישי. פי׳‬ מראה שני מהירקות מדרגה אחת אבל עדיין נשאר ירוק אבל אינו ירקרק. ולא למראה שלישי שהוא ב׳‬ מדרגות למטה שהוא פחות מירוק. וכן הדין גבי אדמדם:
Tazria:69	יכול ישפצנו. פי׳‬ כלומר יתפרנו במחט אבל לא תפירה יפה והלשון נלקח (מגילה ד׳‬) אחא אסא ושפצינהו ע״‬ש. וע״‬ז מסיים מן הבגד שיקרענו מן הבגד:
Tazria:70	אין עוד אלא מקומו. פי׳‬ כיון שכבר נקרע מקום הנגע וניתן עליו מטלית ויהיה הנגע על המטלית:
Tazria:71	במראה ושלא במראה. היינו אם מתחלה היה ירקרק ואח״‬כ נעשה על המטלית מראה אדום טמא. ג״‬כ טמא ולא ניתן להסגיר:
Tazria:72	לפי שכתוב למעלה וכו׳‬. כוונתו כי היה לו לסיים הפרשה בלשון טהרה ולומר להיפך לטמאו או לטהרו. ע״‬ז אמר להסמיך טיהרה לטהרה. וה׳‬ יטהרנו אמן:
Metzora:1	ואינו בא בכפישה. היינו באונאה שלא כדין (יבמות ק״‬ז) לפיכך מודדו לו במרה כפושה וכו׳‬:
Metzora:2	ומעשה בכהן אחד וכו׳‬. ויק״‬ר פ׳‬ ט״‬ו ע״‬ש בשינוי קצת:
Metzora:3	והלא כל שער וכו׳‬. דורש מן הסערה כמו השערה בשי״‬ן שמאלית שפירושו שער:
Metzora:4	ולקחתי מידו מאומה. ע״‬ש בפרש״‬י מומה כתיב לשון מום וכ״‬ה בירושלמי חלק:
Metzora:5	א״‬ר אחא וכו׳‬ אם שימש וכו׳‬. תנחומא פ׳‬ מצורע סי׳‬ א׳‬:
Metzora:6	ושלמה וכו׳‬ מצרת נפשו. בתנחומא מסיים אל תקרא מצרת נפשו אלא מצרעת נפשו שבעון לשון הרע נגעים באים כמו גבי מרים ונמו שמסיים הדרוש דהכא:
Metzora:7	כמה גדול עונש לה״‬ר כצ׳‬ל:
Metzora:8	מלמד שהיו צריכין מים. פי׳‬ שהיו בעלי קריין:
Metzora:9	תורת לבית עולמים. פי׳‬ שנוהג דווקא בזמן שבהמ״‬ק קיים. לא כר״‬ע שסובר לקמן ומטהרין אף שלא בפני הבית:
Metzora:10	אע״‬פ שחלוקין בטומאות. בת״‬כ הגי׳‬ לפי שמצאנו שחילק הכתוב בטומאותיהם ובשבועותיהן יכול אף נחלוק בקרבנן ת״‬ל תורת המצורע וגו׳‬:
Metzora:11	שלא ישהה. פי׳‬ תירף כשנתרפא מצרעתו מביא הקרבן ואינו ממתין ז׳‬ ימים כמו שמסיים:
Metzora:12	אע״‬פ שהיה מונבז דן לפני ר״‬ע כצ״‬ל. וכ״‬ה בת״‬כ:
Metzora:13	אין לי אלא כלם מנין אף מקצתן ת״‬ל מן הנגע אפילו מקצת שער לבן אפילו מקצת מן המחיה. מן המצורע להביא את שפרחה בכולו שיטעון צפרים. וכ״‬ה בת״‬כ. ובכאן ערבובי דברים:
Metzora:14	לשם מטהר. היינו שאינו צריך ליקח לשם איש פרטי המצורע רק לשם מטהר סתמא בין איש בין אשה כדמסיים מכאן אמרו וכו׳‬:
Metzora:15	שיהיו שוות. היינו במראה ובקומה ובדמים. ובת״‬כ מסיים מנין אע״‬פ שאינן שוות כשרות ת״‬ל צפור צפור ריבה:
Metzora:16	חיות בריאות. בת״‬כ ליתא ומיותר הוא כי הוא בכלל ולא טרפות:
Metzora:17	שהוא של ברות. ברות הוא מין ארז (עיין ב״‬ב פ׳‬:):
Metzora:18	ובראשה טרף. פי׳‬ מין עלה:
Metzora:19	ועוביה טפה., בת״‬כ וכן בנגעים פי״‬ד מ״‬ו ועביה כרביע כרעי המטה ואולי טפח הוא שיעור זה:
Metzora:20	השני שבתולעת. עיין ת״‬כ ותפש דעת יוחנן בן דהבאי. ופי׳‬ השני כו׳‬ שלא נצרך מראה הראשון. כי אף מראה שני שדומה לתולעת שאינו אדום ג״‬כ כשר:
Metzora:21	ולא אזוב יון. עיין ת״‬כ. והכוונה רק מה שנקרא אזוב סתם בלי שם לווי:
Metzora:22	שאם חזר לאיסורו כצ״‬ל. היינו שחטא עוד הפעם. וזה הוא הסימן מה שמשלח רק אחת. ועיין בתרגום המיוחס ליונתן בן עוזיאל דבר פלאי בזה:
Metzora:23	שאין לו מי שיביאנו. ע״‬כ דורש והובא מעצמו. ובת״‬כ ליתא דרשה זו:
Metzora:24	וכתיב כי פרוע הוא. ודורש כמו ראשו יהיה פרוע גבי מצורע כדלעיל:
Metzora:25	דברי ר׳‬ יוסי בר׳‬ יהודה. ת״‬כ הגי׳‬ ר׳‬ יהודה בר׳‬ יוסי:
Metzora:26	ושחט את הצפור האחת הברורה שבשתים. כ״‬ה הגירסא בת״‬כ. ומה״‬א דהאחת קדריש. והכוונה שבעת השחיטה יברר מקודם את שתהיה לשם שחיטה. ועיין בק״‬א:
Metzora:27	ולא מנטפין. פי׳‬ שיורד טיפין טיפין יחסר עוד ולא מים מכזבין ועיין ת״‬כ:
Metzora:28	מה מים שלא נעשה בהם מלאכה. כי נצרך ליקח חדשים מהמעין אף כלי וכו׳‬:
Metzora:29	זו בכלי. בכאן חסר ועי׳‬ בת״‬כ. והכוונה כי הכלי יהיה פיילי של כלי חרם. ומקיף להם ראשי גפיים וראש הזנב משל שניה כצ״‬ל. ונ״‬ה בת״‬כ. ובנגעים פי״‬ד. ומשל שניה הכוונה הצפור החיה:
Metzora:30	ולא ג׳‬ וז׳‬. פי׳‬ דה״‬א לילף מטמא מת שצריך הזאה ג׳‬ וז׳‬ עיין ת״‬כ:
Metzora:31	וטהרו בדברים שבגופו. לפי הגי׳‬ דהכא יש לפרש שהכהן יגיד לו דברי כבושין שיטיב מעשיו שהנגעים באים על חטא אולם בת״‬כ גירסא אחרת בזה ע״‬ש.
Metzora:32	שלא יעמוד ביפו וכו׳‬. עיין ת״‬כ (וקדושין נ״‬ז):
Metzora:33	אם שלחה וחזרה וכו׳‬. בקדושין שם דורש מקרא על פני השדה מה שדה מותרת אף זו מותרת וכו׳‬ ע״‬ש:
Metzora:34	לא שלה טהור. בת״‬כ ליתא וצ״‬ע:
Metzora:35	טהור מלטמא מו״‬מ. עיין בת״‬כ וכן בנגעים פי״‬ד. כי אחר טבילה הראשונה טהור מלטמא בביאה:
Metzora:36	במי מקווה. שאינו טעון ביאה מים חיים כמו זב ועיין בת״‬כ בארוכה:
Metzora:37	ולא ז׳‬ ימי חלוטו. שמותר בתשמיש המטה.
Metzora:38	מ״‬ט עוזיהו וכו׳‬. עיין (מ״‬ק ז׳‬:) ובתוס׳‬ ד״‬ה יוחם החשבון ומה שהביאו ג״‬כ מפירש״‬י וכן מסדר עולם ובכאן קצת דברים מעורבבים:
Metzora:39	שהראש אסור במספריים כמו בתער שנאמר לא תקיפו פאת ראשם כצ״‬ל. ובכאן הגירסא משובש ע״‬כ הסגרתי במוסגר:
Metzora:40	הראש מותר בכל אדם. היינו הקפת כל הראש כדמסיים:<br>מ. ליתן אחרית לתגלחת. פי׳‬ ששאר הימים משלמים בעדו אם לא גילח בז׳‬ יגלח בשאר הימים וכו׳‬ (ק״‬א):
Metzora:41	שיהיו שוים במראה ובקומה ובדמים. ובת״‬כ מסיים מנין אע״‬פ שאינן שוין כשרים ת״‬ל כבש כבש ריבה:
Metzora:42	שמביא אחת על נגעים הרבה. דאם נתנגע ונתרפא ובימי ספרו חזר הנגע ונרפא עוד הפעם כיון דלא יצא בשעה שהיה ראוי להביאה שהרי בימי ספרו חזר הנגע מביא אחת על כולן (ק״‬א) אפי׳‬ לג׳‬ עשרונים חסר בכאן איזה תיבות ולא ידיעתי כוונתו בזה. וצ״‬ע ועי׳‬ ת״‬כ:
Metzora:43	שכולן טעונים העמדה. היינו המצורע והג׳‬ כבשים:
Metzora:44	בשערי ניקנור. ולא בעזרה עצמה שהוא עדיין מחוסר כפורים:
Metzora:45	תנופה באחת. פי׳‬ האשם והלוג שמן יניף כאחת:
Metzora:46	תנופה ולא תנופות. האשם צריך תנופה אבל הכבשים אינם טיעונים תנופה עיין בת״‬כ:
Metzora:47	יכול על טבעתן. מקום הטבעות היו כ״‬ד אמות ברוח צפונית:
Metzora:48	מה חטאת מן החולין וכו׳‬. עיין בת״‬כ ובק״‬א כל הדרשות הללו:
Metzora:49	שני כהנים  וכו׳‬. עיין בת״‬כ יליף מקראי.
Metzora:50	טבל בלשכת המצורעים: עיין ת״‬כ. וזה דלא כר״‬י שסובר שאינו צריך טבילה שכבר טבל מבערב:
Metzora:51	ולא מספוג. היינו מקנח בשעת הזיה:
Metzora:52	אין הדם גורם אלא המקום. פי׳‬ אם אין שם דם היינו שנתקנח הדם אעפ״‬כ יתן מן השמן:
Metzora:53	מכאן א״‬ר אליעזר. דורש מקרא אל מקום דם האשם. ובת״‬כ הוא מימרא בפ״‬ע. ואם גירסא דהכא מדוייקת סרו דברי התוס׳‬ (סנהדרין מ״‬ה:) ד״‬ה ר״‬א אומר שכתבו הך מתניתא איפכא בפ׳‬ ג׳‬ מינין ע״‬ש. ומכאן ראיה שהגירסא דהכא וכן בסנהרין טרוייקת:<br>נג. אם נתן כיפר. הפס רעת ר״‬ע ועיין בת״‬כ:
Metzora:54	מטומאתו ולא מזובו. שאם היה זב ומנוגע והיום ג׳‬׳‬כ יום ח׳‬ לטהרה זיבתו אין קרבן זה עולה לו לטהרו ג״‬כ מזובו:
Metzora:55	שירצה הפרקליט. פי׳‬ החטאת הוא הפרקליט. ואח״‬כ העולה הוא הדורן:
Metzora:56	שזה מביא בהשיג יד. פי׳‬ שקרבנותיו חלוקים מעשיר לעני:
Metzora:57	שהרי מטמא מקדש וכו׳‬. פי׳‬ מה שמטמא מקדש דבמקום כשבה או שעירה שמביא לחטאת בהיותו עשיר העני מביא שתי תורים וכן א׳‬ לחטאת ואחד לעולה אף כאן גבי מצורע. הא׳‬ הב׳‬ תורים יהיה במקום כשב דחטאת אבל הכבת לעולה יהיה עדיין עליו חובה ויביא תחתיהם עוד ב׳‬ תורים וכו׳‬. ועיין כ״‬ז בק״‬א שכוון כמו דברי המחבר דהכא:
Metzora:58	כאלו לא כיפר. (זבחים ז׳‬.) מסיים כאלו לא כיפר וכיפר. ופי׳‬ כיפר גברא על חטא שבידו וניצל מן היסורין אבל לא כיפר קמיה שמיא לנחת רוח לקונו שלא עשה מצוה מן המובחר:
Metzora:59	דברי. ר׳‬ נחמיה ר׳‬ אליעזר בן יעקב וכו׳‬ כצ״‬ל:
Metzora:60	מאשר תשיג ידו. את אשר תשיג ידו. והוא סוף פסוק כ״‬ט והתחלת פסוק ל׳‬:
Metzora:61	ולמעלה אמר אשר תשיג ידו. הוא פסוק כ״‬ב. ועיין ת״‬כ ושם ט״‬ס. והפסוקים דהכא מדוייקים ועיין אדרת אליהו להגר״‬א ז״‬ל:
Metzora:62	יכול יביא כדין העשיר היינו שני כבשים לחטאת ולעולה. אבל סוף לשונו אינו מדוקדק שסיים חצי קרבנו עשיר וכו׳‬ הרי האשם העני והעשיר שוים בזה ששניהם מביאים כבש. ועיין בת״‬כ. ועיין ג״‬כ בבלי (ערכין י״‬ז:) דרשה אחרת שדרשו רק מקרא אשר לא תשיג ידו בטהרתו ע״‬ש:
Metzora:63	יכול. אף עשיר וכו׳‬ ת״‬ל זאת אשר בו וכו׳‬ ודורש זאת מעוטה הוא כצ״‬ל וכ״‬ה בת״‬כ:
Metzora:64	אדם מביא קרבן עשיר על אשתו כצ״‬ל. ועיין (ב״‬מ ק״‬ד) והוא דעת ר׳‬ יהודה ועיין בת״‬כ וק״‬א:
Metzora:65	זה. אחד מי״‬ג דברים וכו׳‬ כצ״‬ל. עיין ספרי ויקרא אליו למעט את אהרן. אר״‬י י״‬ג דברים נאמרו בתורה למשה ולאהרן וכנגדם י״‬ג מיעוטים. ובהם י׳‬ דברות (היינו מה שנאמר בהם וידבר) וג׳‬ מאמרות מה שנאמר בהם ויאמר וע״‬ז קאי טוביה וכו׳‬ נתן בהם סימנים אמירה מה שנאמר בהם ויאמר הוא נ׳‬ פעמים גבי הני קראי מופ״‬ת (שמות ג׳‬) תנו לכם מופת. חפניכ״‬ם (שמות ט׳‬) קחו לכם מלא חפניכם פיח כבשן. החוד״‬ש (שמות י״‬ב)החודש הזה לכם וכו׳‬ דיבור הוא עשרה פעמים שנאמר לשון וידבר ויצו״‬ם (שמות ו) ויצום אל בני ישראל. החי״‬ה, (ויקרא יא) זאת החיה אשר תאכלו. אר״‬ץ קרא דהכא כי תבואו אל ארץ כנען אחוזתכ״‬ם (ויקרא י״‬ד) ונתתי נגע צרעת בבית ארץ אחוזתכם. ז״‬ב (שם ט״‬ו) איש איש כי יהיה זב מבשרו נשי״‬א (במדבר ד׳‬) נשא את ראש בני קהת. אל תכריה״‬ו (שם) אל תכריתו אה שבט הקהתי. עד מת״‬י (במדבר י״‬ד) עד מתי לעדה הרעה. הבדל״‬ו (שם י״‬ז) הבדלו מתוך העדה. פר״‬ה (שם י״‬ט) פרשת פרה:
Metzora:66	אל הארץ המיוחדת. היינו א״‬י ולא בעבר הירדן עיין ת״‬כ:
Metzora:67	אשר אני נותן וכו׳‬. פרט לעמון וכו׳‬. בכאן הלשון אינו מדוקדק. וה״‬ג בת״‬כ יכול משבאו לעמון ומואב ת״‬ל אשר אני נותן וכו׳‬. ופי׳‬ דה״‬א כשבאו לעמון ומואב שנתקרבו יותר לא״‬י יתחייבו במעשרות:
Metzora:68	בבשורה הוא נותן לכם. דורש ונתתי לשון מתנה. כי האומרים מטמינין כספיהם בקירות הבית וע״‬י הנגעים יותץ הבית. וימצאו המטמונות
Metzora:69	נגעי רוחות וכו׳‬. הוא דברי המחבר והוא דעת ר׳‬ פפא (הוריות י׳‬) אפילו הוא זקן או חולה ט״‬ס כי זקן או חולה יכול לשלוח שליח ועיין ת״‬כ:
Metzora:70	מי שמיחד ביתו לו. ויק”ר פ׳‬ י״‬ז:
Metzora:71	בבית להוציא את היציע וכו׳‬. בת״‬כ ה״‬ג להביא אח העליה. ופשוט הוא כי גם העליה מטמא בנגעים ואולי כוונת המחבר אם נמצא הנגע בבית אזי העליה טיהורה עיין נגעים פ׳‬ י״‬י מ״‬ג וכ״‬ה לקמן בדברי המחבר:
Metzora:72	לראות. את הנגע לראות את הפנוי כצ״‬ל וכ״‬ה בת״‬כ והוא כמו שאמר למעלה שיפנו כל הכלים מהבית וישאר הבית ריק:
Metzora:73	אלא בשני גריסי. דורש הנגע הנגע בשתי פעמים:
Metzora:74	מכאן אמרו. לשון הש״‬ס (ב״‬ב קס״‬ד) וכצ״‬ל. בית עגול וכו׳‬ אינו מטמא טטריגין מטמא בנגעים והוא בית מרובע מטמא דווקא
Metzora:75	שקועות במראיהן לא שיהיו שקועות בגושיהן
Metzora:76	ירוק שבירוקין. הוא מראה ראשונה ועיין בת״‬כ פ׳‬ תזריע:
Metzora:77	ואפילו על אבן אחת. תפס המחבר כת״‬ק ולא כר״‬א בר״‬ש:
Metzora:78	האמור באדם. היינו בנגעי האדם:
Metzora:79	ולא האבוס. דכולן לא מקרי בית:
Metzora:80	מלמד ששניהם חולצין. פי׳‬ אם הקיר הוא ג״‬כ לבית חבירו:
Metzora:81	אלא מחוץ לעיר. בכאן חסר וט״‬ס וכצ״‬ל ולא אדם המצורע אלא חוץ למוקף חומה. ועיין באדרת אליהו להגר״‬א ז״‬ל. וכן הוא הפי׳‬ ג״‬כ בת״‬כ. והיינו אדם מצורע נשלח חוץ לעיר בעיר מוקפת חומה. ונגעי בתים חולץ חוץ לעיר אף בעירות שאינם מוקפות חומה:
Metzora:82	שיהיה מקומן טמא. עיין ברש״‬י בחומש ובק״‬א גם בא״‬א להגר״‬א ז״‬ל. ורי׳‬ל בעודן במקומן מטמאין את הטהרות:
Metzora:83	שלא ימול מצר זה. דורש אבנים אחרות:
Metzora:84	במראיו אם נאמר בחליצה וכו׳‬. חסר סיום המאמר ועיין בת״‬כ:
Metzora:85	[]
Metzora:86	משונה כיבוס זה וכו׳‬. הכוונה כי כיבוס בגדים האמור בטומאת נבילות או טמא מת הוא להחמיר כי בשם מטמא בגדים לאלתר ובכאן להקל דאם בגדים לבושים הם מציל עז שישהה בכדיי אכילת פרס:
Metzora:87	בבעה״‬ב הכתוב מדבר. היינו השני צפרים ועץ ארז וכו׳‬. הנל יהיה משל בעה״‬ב:
Metzora:88	וכה״‬א. גבי פסח על הבתים כצ״‬ל. כמו שמסיים הקרא והגעתם אל המשקוף.׳‬
Metzora:89	והבית. אינו צריך קרבן חסר ועיין בת״‬כ וכצ״‬ל. ויש בבתים מה שאין במצורע שבבית אין לו טהרה עולמית (היינו בית מוחלט) ומצורע מוחלט יש שהרה לעומאתו ע״‬כ צריך לכתוב גבי שניהם עטרתם:
Metzora:90	צריך שיורנו רב. פי׳‬ אף שבקי בנגעים אעפ״‬כ נצרך לו ללמוד מרב ואח״‬כ יראה את הנגעים:
Metzora:91	זה אחד מעשרה מקומות כצ״‬ל עיין לעיל. והיינו מה שנאמר בלשון דבור:
Metzora:92	ואין וכו׳‬. (שבת פג.) אבל חכמים נזרו שיהיה כזבים לכל דבריהם. ועיין בת״‬כ:
Metzora:93	פרט לפני הדבור. היינו אם ראה ראיה ראשונה קורם מ״‬ת אין מצטרף עם ראיה שראה אחר מ״‬ת ועיין בת״‬כ בארוכה:
Metzora:94	ולא מחמת ד ״‬א. היינו מחמת אונס כדמפדש:
Metzora:95	אין הדם וכו׳‬. טמא הוא מיעוטא הוא כי אינו מטמא באודם עיין ת״‬כ (נדה נ״‬ו):
Metzora:96	מנה הכתוב וכו׳‬ הסר. ואולי צ״‬ל הדרשה שלש לקרבן (מגילה ז׳‬:) וכמו שמסיים קטן. אבל סוף המאמר זובו טמא לקריו וכו׳‬ לא יכולתי להבין כלל ע״‬כ הסגרתי במוסגר:
Metzora:97	מימי רגליו ורוקו שמטמאיןובת״‬כ לומד מק״‬ו:
Metzora:98	אפילו כ״‬ש עיין (נדה מ״‬ג) סובר שמואל דזב צריך כפתיחת פי האמה. וכל שהוא הנאמר במתניתין שם (וכן הכא) דווקא בבעל קרי. ע״‬ש:
Metzora:99	שאם נשבר. היינו המשכב טהור:
Metzora:100	דאתי ק״‬ו. מכלי חרס ששבירתן היא טהרתן:
Metzora:101	אבן מטמא. היינו שנתן על המושב אבן. ואבן מטמא כלישנא דקרא (דניאל ו׳‬) והתית אבן חדא ושמת על פום נובא:
Metzora:102	לרבות. כיחו וניעו כיחו היוצא וכו׳‬ כצ״‬ל:
Metzora:103	תחתיו של זב. פי׳‬ אף דקרא זה הוא אחר קרא דוכל המרכב ה״‬א פגם מרכב מטמא כל אשר תחתיו משום מושב. ע״‬כ מפרש כי קרא זה וכל הנוגע אשר יהיה תחתיו קאי אקרא על מושב ולא על מרכב שאינו מטמא מה שתחתיו. ועיין בת״‬כ:
Metzora:104	לרבות את המשכב וכו׳‬. עיין בת״‬כ. וכ״‬ה בפירש״‬י בחומש וכן הביא הגר״‬א ז״‬ל והנושא אותם שיכול אין מטמא במשא אלא אילו בלבד מנין זובו של זב ורוקו ומימי רגליו ושכבת זרעו ת״‬ל והנושא אותם לרבות את כל האמור בענין:
Metzora:105	ולא בצואה שעליה ולא בשום דבר וכו׳‬ כצ״‬ל. ומל׳‬ בו קדריש שיגע דווקא בעצמו של זב:
Metzora:106	אם לא רחץ. היינו שלאחר ימי ספרו אם לא טבל אפילו עד מאה שנים. טמא שטהרתו תלויה דווקא בטבילתו:
Metzora:107	לרבות כלי חרס. דורש מן וא״‬ו וכלי חרס עיין ת״‬כ:
Metzora:108	לכשיפסיק. מזונו. מזובו ולא מזובו ונגעו כצ״‬ל:
Metzora:109	וספר לו לעצמו. פי׳‬ דלא בעי למבדק בעצמו בכל יום אלא ספירה בעלמא. ובת״‬כ מסיים מכאן אמרו הזב והזבה שבדקו עצמן ביום הראשון ומצאו טהורים ביום הז׳‬ ומצאו טהורים ושאר הימים לא בדקו הרי הם בחזקת טהרה. והם דברי ר״‬א שם:
Metzora:110	שיהיה טהרתן אתת. היינו ז׳‬ נקיים יהיה סמוכין ולא מפוזרין:
Metzora:111	אף בגדיו בנקיות הא למדנו שחוצצין בכלים כצ״‬ל וכ״‬ה בת״‬כ והיינו שגם טבילת כלים יש דיני חציצה כמו גבי אדם:
Metzora:112	ולא בגדיו. היינו במי מקוה ואינו צריך מים חיים:
Metzora:113	טהור מלטמא כלי חרס בהסט כצ״‬ל וכן הוא הגי׳‬ (במגילה ח׳‬) וכן הביא הגר״‬א ז״‬ל. אולם בת״‬כ הגי׳‬ טהור מלטמא כ״‬ח במשא ועיין בק״‬א שהאריך בפיסקא א׳‬:
Metzora:114	השיב בן עזאי. עיין בת״‬כ ובאורו בק״‬א:
Metzora:115	ובא לפני ה׳‬. חסר כל הדרשא. ועיי: בת״‬כ מנין שהוא טובל מבעוד יום ת״‬ל ובא לפני ה׳‬ אל פתח אוה״‬מ. כיצד הוא בא פתח אוה״‬מ. אא״‬כ היה מעורבי שמש מלמד שהוא טובל מבעו״‬י:
Metzora:116	מלמד שאין הקינין וכו׳‬. חסר ג״‬כ ועיין בת״‬כ וכצ״‬ל ועשה אותם הכהן אחד לחטאת וא׳‬ לעולה שיפרשם הכהן א׳‬ לחטאת וא׳‬ לעולה. מנין שאם הפרישם הוא (היינו הבעלים) ת״‬ל אחד לחטאת ואחד לעולה ונתנם אל הכהן:
Metzora:117	ש״‬ז פרט למערה כצ״‬ל. וכ״‬ה בת״‬כ אף כשמערה כבר נקרע הש״‬ז מגופו אבל עדין לא יצא לחוץ אינו מטמא עיין (נדה ר״‬פ יוצא דופן):
Metzora:118	שהיא מטמאה בפנים כבחוץ. פי׳‬ אחר שיצא הדם מן המקור לפרוזדור וכותלי בית הרחם העמידוהו אעפ״‬כ טמאה:
Metzora:119	בנדתה תהיה עד שתיטבול. בת״‬כ ליתא דרשה זו ולא ידעתי לכוונת מאי בעי לרבות וצ״‬ע. ואולי כוונתו שאינה טובלת ביום עיין ת״‬כ:
Metzora:120	ומושב. שאינו מיוחד לישיבה כצ״‬ל:
Metzora:121	תשובה בא ללמדנו. עיין במס׳‬ זבים פ״‬ר משנה ה׳‬ ובפי׳‬ הר״‬ש שם:
Metzora:122	לרבות שתי שכיבות. כררכה ושלא כדרכה:
Metzora:123	איש פרט לקטן. היינו פחות מבן תשע שאין ביאתו ביאה:
Metzora:124	בל אשה שאין לה וסת. (נידה י״‬ב.):
Metzora:125	והן תיקוניה כצ״‬ל:
Metzora:126	ווסתות של ימים אמרו חכמים כצ״‬ל. (נדה סג:)
Metzora:127	נשים בבתוליהן כגפנים כצ״‬ל. וכ״‬ה לשון המשנה נדה פ״‬ט בסופו:
Metzora:128	ומותבינן נדה י״‬ג ע״‬ש:
Metzora:129	ומתרצינן כצ״‬ל שם:
Metzora:130	תנן במס׳‬ ערכין ח׳‬ כצ״‬ל:
Metzora:131	שלשה ימים. טמא ראיתי פתחה י״‬ז ד׳‬ ימים טמא ראיתי פתחה ט״‬ז ה׳‬. פתחה ט״‬ו ו׳‬ ימים. פתחה י״‬ד כצ״‬ל. ובכאן חסר שורה שלימה ועיין שם בעירכין:
Metzora:132	אית להו דרך נדה וכו׳‬ כצ״‬ל:
Metzora:133	ואמר בת״‬כ אין לי אלא מופלג מנדתה יום אחד. ת״‬ל ואשה כי תזוב מנין לרבות מופלג ב׳‬ ג׳‬ ד׳‬ ה׳‬ ו׳‬ וכו׳‬ כצ״‬ל. וכ״‬ה בנדה ע״‬ג ע״‬ש בפירש״‬י:
Metzora:134	מה מצינו ברביעי וכו׳‬. ע״‬ש בפירש״‬י בנדה שהוא ראוי לספירת נקיים אם ראתה א׳‬ ב׳‬ ג׳‬ ופסקה וראוי לזיבה לצרף עם ב׳‬ ג׳‬ ד׳‬ אם לא ראתה בא׳‬ דהא אתרבאי מופלג יום א׳‬ מקרא דאו כי תזוב דהיינו ב׳‬ ג׳‬ ד׳‬ אף אני מרבה כל אלו עד י׳‬ וי׳‬ בכלל שהם ראוין לספירה אם ראתה ג׳‬ הראשונים משני ז׳‬ נקיים עד שיהיו ראוין לזיבה באיזה מהם שתראה ג׳‬ רצופין עכ״‬ל רש״‬י. ודע כי זה דעת רש״‬י אבל הרמב״‬ם יש לו דרך אחרת בימי נדות וזיבות. ואכמ״‬ל:
Metzora:135	לפי שמרבה אני י״‬ד שהיא סופרת בלא עת נדתה. דהיינו שהימים עדיין מימי זיבה ומוציא אני י״‬ב שאינו בספירת בלא עת נדתה. היינו שמתחילין ז׳‬ ימי נדה. ובת״‬כ ובנדה ל״‬ו ה״‬ג מרבת אני י״‬א שהוא בספירת או כי הזוב ומוציא אני י״‬ב שאינו בספירת או כי חזוב. הלשון יותר מתוקן ע״‬ש בפירש״‬י אבל כוונת המחבר כמו התם:
Metzora:136	ואע״‬ג דעיקרי כל הכלי. דבריו אינם מובנים. וכפי הנראה חסר כאן הרבה ועיין ת״‬כ וז״‬ל מנין שהיא משמרת יום א׳‬ (היינו זבה שראתה יום א׳‬) ה״‬ל טמא יהיה. (והיינו קרא כל הכלי אשר השב עליו טמא יהיה) יכול כשם שהיא משמרת א׳‬ לאחד כך תשמר ב׳‬ לב׳‬ (היינו אם ראתה שני ימים נצרך לה שני ימי טהרה) ת״‬ל יהיה לה. (והוא רישא דקרא כל המשכב וכו׳‬ כמשכב נדתה יהיה לה) ומדכתיב יהיה לה לשון יחיד ולא יהיו לה. אין לה אלא יום אחד. ואפשר כי ע״‬ז קאי דברי המחבר דהכא. ואע״‬ג דעיקר הקרא כל הכלי כתוב אח״‬כ ואינו מדבר בטומאת זבה בעצמה רק מטומאת כלים שיושבת עליה: אעפ״‬כ דורש לה נגד זבה בעצמה שלא יטמא רק יום א׳‬ כנ״‬ל קצת נפרש דבריו הסתומים. וכן יש לפרש ג״‬כ דבריו בפסיקתא השניה שכתב כבר מפורש לעיל דעיקרא על הכלי מדבר:
Metzora:137	תהיה טומאתו בו וכו׳‬. ט״‬ס וכצ״‬ל כימי נדתה טמאה היא לרבות את בועלה (היינו גבי נדה) והיא למעט שזבה אינה מטמא את בועלה. עיין בת״‬כ ומסיים שם אלא שדברו חכמים בלשון נקיה. הכוונה מדכתיב הוא בלשון זכר לרבות בועל נדה ועיין בק״‬א שפירש באופן אחר:
Metzora:138	ולא בימי זיבתה כצ״‬ל. ולידתה ט״‬ס. והיינו שזבה אינה מטמאה את בועלה. עיין ת״‬כ:
Metzora:139	לזכר כל שהוא וכו׳‬. בין גדול בין קטן כי תנוק בן יומו מטמא בזיבה:
Achrei Mot:1	מכריז ר״‬א. (ע״‬ז י״‬ט) כנוף ואתי וכו׳‬ כצ״‬ל:
Achrei Mot:2	התם אמרי. ויקרא פ׳‬ ט״‬ז והוא מעשה אחד:
Achrei Mot:3	סימנים הרבה. היינו התורה שמארכת ימים:
Achrei Mot:4	שמיתת וכו׳‬. בת״‬כ ה״‬ג כשם שעבירת שניהם שוה כך מיתה שניהם שוה. וע״‬ש בק״‬א:
Achrei Mot:5	שעל הקריבה מתו. היינו מה לק״‬ק ולא על ההקרבה שהקריבו קטורת:
Achrei Mot:6	והדבור הראשון מה נאמר לו. פי׳‬ מדכתיב בהתחלת הפרשה וידבר ה׳‬ אל משה אחרי מות כו׳‬. ויאמר ה׳‬ אל משה דבר אל אהרן. ולא נתפרש: מה נאמר לו בדבור הראשון. ע״‬כ אמר ששני פעמים אמר לו זה רק בדבור האחרון זירזו יותר מן הראשון כמו המשל. ועיין במזרחי בחומש:
Achrei Mot:7	ואל יבוא. זה יו״‬כ פי׳‬ ביו״‬כ הורשה לבוא רק עם קרבנות אלו כדמסיים הקרא. ובת״‬כ מוסיף עוד אל הקודש לרבות שאר ימות השנה. ואולי יהיה הכוונה כמו שכתב הרד״‬ל בשם הגר״‬א ז״‬ל. כי אהרן הותר לבוא ג״‬כ בכל השנה עם קרבנות אלו:
Achrei Mot:8	שהרי אין דמו של איל במקום דמו של פר. שדם הפר נכנס לפני ולפנים:
Achrei Mot:9	בד. שיהיו כפולין היינו החוטים כפול ששה:
Achrei Mot:10	שיהיו משל קודש. היינו מתרומת הלשכה:
Achrei Mot:11	כולן בטבילה אחת. היינו שבין בגד לבגד אינו צריך טבילה:
Achrei Mot:12	עד. שיתכפר בשל שם כצ״‬ל והיינו מתן דמו:
Achrei Mot:13	וכפר בעדו. זה וידוי דברים פעמים היה מתוודה וכו׳‬ כצ״‬ל. ומה שכתוב בנתיים הוא מיותר ע״‬כ הסגרתי במוסגר. והיינו פעם הראשון עליו ועל ביתו ובפעם ב׳‬ ג״‬כ על אחיו הכהנים שנקראים ביתו שנאמר בית אהרן:
Achrei Mot:14	אר״‬י זה סימן כל הנוטל מבחוץ וכו׳‬. פי׳‬ הניטל ממזבח החיצון לכנס לפנים אינו נוטל אלא ממקום הסמוך יותר לפנים:
Achrei Mot:15	שיהיו כל סמניה לתוכה. בתוך הכף:
Achrei Mot:16	אמרו להן לחכמים כצ״‬ל (יומא י״‬ט):
Achrei Mot:17	או. שחיסר וכו׳‬ כצ״‬ל. וכ״‬ה בת״‬כ הא אם לא נתן בה מעלה עשן או שחיסר א׳‬ משמניה חייב מיתה:
Achrei Mot:18	אמר ר״‬י (כמנגדא כצ״‬ל):
Achrei Mot:19	ולא שבע טיפים. פי׳‬ מדכתיב יזה שבע פעמים משמע שבכל פעם נצרך להיות שיעור הזיה ולא טיפה:
Achrei Mot:20	ומפשעיהם אלו המרדים. הוא מאמר בפני עצמו:
Achrei Mot:21	לרבות אפילו ביציאה. מדכתיב עד צאתו ולא בצאתו משמע דווקא כשיצא לגמרי אז הותר לכנס להיכל:
Achrei Mot:22	היכן היה עומר. היינו מדכתיב ויצא:
Achrei Mot:23	בפרה שהיא בגופו. היינו מתן דמים שהוא בגופו של מזבח:
Achrei Mot:24	וטהרו לשעבר. מטומאת העבר וישאר קדוש לעתיד:
Achrei Mot:25	דההוא. דנחית קמיה דרבה כצ״‬ל (יומא ל״‬ח):
Achrei Mot:26	ואין שעירי עבודת כוכבים טעונין סמיכה. היינו הכהן אבל הזקנים סומכין כדכתיב בהדיא:
Achrei Mot:27	אונסיהם. פי׳‬ דפשעים ועונות וחטאים. ספיקותיהם. ספק חטא ספק לא חטא. שגגותיהם ספק שגג ספק לא שגג:
Achrei Mot:28	ונתן אותם לא חייבי חטאות וכו׳‬ בכאן חסר ומשובש וכצ״‬ל. וכ״‬ה בת״‬כ יכול אף חייבי חטאות ואשמות עמהם (פי׳‬ שהשעיר המשתלח יכפר ע״‬ז). ת״‬ל ונתן אותה על ראש השעיר (ואותם מיעוטא הוא) אותם על ראש השעיר ואין חייבי חטאות ואשמות על ראש השעיר. מכאן אמרו חייבי חטאות ואשמות וודאים שעבר עליהם יו״‬כ חייב להביא אחר יו״‬כ. וחייבי אשמות תלויין פטורין כי הם נתכפרו בשעיר המשתלח
Achrei Mot:29	ונשא השעיר עליו. עליו הוא נושא ואין שאר שעירים עמו. ועל מה שאר שעירים מכפרים על טומאת מקדש וקדשיו כצ״‬ל:
Achrei Mot:30	ולא המשלח את המשלח. פי׳‬ יקירי ירושלים שהיו מלוין אותו:
Achrei Mot:31	ורחץ. בשרו במים חסר וכצ״‬ל. ורחן בשרו יכול יהיה גזירת המלך. היינו שהתורה צותה לו טבילה זו. ת״‬ל ואחר יבוא אל המחנה מה ואחר האמור להלן גבי מצורע כתיב ג״‬כ ואחר יבוא אל המחנה מה להלן מפני הטומאה אף כאן מפני הטומאה:
Achrei Mot:32	נאמר כאן עור ובשר ופרש. ונאמר להלן היינו בפר כהן משיח עור ובשר ופרש מה להלן ע״‬י ניתוח היינו בלא הפשט אף כאן:
Achrei Mot:33	ולא המצית את האליתא. והיינו בשעת סידור המערכה:
Achrei Mot:34	המסייע בשעת השריפה. היינו בשעה ששורף את הפרים קודם שנעשו אפר:
Achrei Mot:35	מלאכה חשובה: היינו גבי משכן כתיב מלאכת מחשבת:
Achrei Mot:36	בתוככם. לרבות העבדים כן הגיה הגר״‬א ז״‬ל באדרת אליהו. כי נשים ריבה מהאזרח:
Achrei Mot:37	בקרבנות. ומנין אע״‬פ שאין קרבנות ואין שעיר היינו בזמן הגלות ת״‬ל כי ביום הזה יכפר כו׳‬ כצ״‬ל. ופי׳‬ עצומו של יום מכפר:
Achrei Mot:38	בנין אב לכל בוץ. פי׳‬ מדקרי להו בגדי הקדש:
Achrei Mot:39	לרבות כלים אחרים כו׳‬. והלשון שהולך בהם לביתו. ט״‬ס כי לביתו הלך בבגדי עצמו אלא פירושו של בין הערבים:
Achrei Mot:40	ואת לרבות ט״‬ס וצ״‬ל וכפר לרבות העזרות.
Achrei Mot:41	יכפר לרבות הלוים. היינו וכפר השני דסוף פסוק:
Achrei Mot:42	להוציא שאר יו״‬ט. והכוונה כי שעירי הרגלים ג״‬כ מכפרים אבל אם אינם מקריבים אותם אינם מכפרים:
Achrei Mot:43	ולא העובדי כוכבים שאינם מוזהרין על שחוטי חוץ. ומסיים בת״‬כ אלא שהעובדי כוכבים מותרים לעשות במה בכ״‬מ ולהעלות לשם:
Achrei Mot:44	מה ת“ל זה הדבר לג״‬ש כצ״‬ל. והיינו שפרשה זו משחוטי חוץ ג״‬כ בראשי המטות כמו שמסיים. ועיין (נדרים ע״‬ח.) למנ״‬ה שיש שאלה בהקדש:
Achrei Mot:45	מלמד שהפרשה נאמר. חסר וכצ״‬ל זה הדבר אשר צוה ה׳‬. מלמד שהפרשה נאמר בכה אמר בנין אב וכו׳‬. ועיין בת״‬כ ובק״‬א שפי׳‬ הכוונת שכמו ששמע משה מפי ה׳‬ כן אמר. ולא שנאמר לו הכלל והוא היה מסדר סגנון ודברים. אלא הדברים כמו ששמע כן אמרם. וזה יורה הלשון זה הדבר. וכן כה אמר ע״‬ש בק״‬א שהאריך:
Achrei Mot:46	לרבות את העוף שחייב משום שחוטי חוץ. דוקא תורים ובני יונה שהם ראוים לקרבן:
Achrei Mot:47	אחד ששחט חייב וכו׳‬ כצ״‬ל. כמו שמסיים לפי שלא נעשה שחיטה אלא ע״‬י אחד. ולא כן גבי העלה אברים בחוץ אף שנים שהעלו חייבין:
Achrei Mot:48	כגון אחר הקמח המשכן וכו׳‬ כצ״‬ל:
Achrei Mot:49	כזובח בשדה. עיין (ע״‬ז י״‬א:). פירש״‬י כזובח ע״‬פ השדה לעבודת כוכבים:
Achrei Mot:50	ואין ריח נחוח בבמה. ד״‬א מששה דברים שהזבח נזבח הוא לריח ניחוח לאפוקי אברים שצלאן והעלן שאין בהם משום ריח ניחוח. ובבמת יחיד לא חיישינן לזה:
Achrei Mot:51	זאת להם ואין חייבין כרת. עיין (זבחים ק״‬ו:) זאת להם ואין אחרת להם.
Achrei Mot:52	לרבות בל הזבחים. היינו אמורי חטאת ואשם כו׳‬. עיין ת״‬כ:
Achrei Mot:53	להביא כל הראוי לבא. פי׳‬ שראוי לבא בפנים אז חייבים עליו משום שחוטי חוץ:
Achrei Mot:54	אחד שהעלה חייב. הוא דלא כר׳‬ ישמעאל דלעיל עיין ת״‬כ:
Achrei Mot:55	להביא ולד ישראל מן הכנעני וכו׳‬. עיין (יבמות מ״‬ה) עובד כוכבים ועבד הבא על בת ישראל הולד כשר ודינו כישראל לענין זה:
Achrei Mot:56	להביא דם התמצית כו׳‬. עיין ת״‬כ כי חכמים פליגי ולא חייב כרת רק על דם הנפש:
Achrei Mot:57	לא על קרקעו של מזבח. שהדם ניתן מחוט הסקרא ולמעלה:
Achrei Mot:58	אמרו לו והלא כו׳‬: עיין (חולין פז:). והכוונה דאהדרי לר׳‬ יהודה חיה או עוף לחלק ע״‬ש:
Achrei Mot:59	פרט לחרטום. שאינו בר אכילה:
Achrei Mot:60	לא בתוך מעיו. כי הוא מטמא בבית הבליעה. ואם טבל אחר בליעתו. אע״‬פ שעדיין במעיו שלא נתאכל עלתה לו טבילה:
Achrei Mot:61	פסוק זה נאמר. עיין בת״‬כ וזה שמסיים מה קרבן שחייב להלן ע״‬י טומאה. היינו לעיל בפ׳‬ ויקרא או נפש אשר תגע בכל דבר טמא וקאי על טומאת מקדש וקודשיו:
Achrei Mot:62	אלו מצות הדעת. היינו מה שהשכל מחייבן. רק הגירסא צ״‬ל מהופכת חוקת אלו שעובדי כוכבים משיבין עליהם ואת משפטי אלו מצות הדעת שכ״‬ה בכמה מקומות:
Achrei Mot:63	איש איש. להביא הכנעני (סנהדרין נז:):
Achrei Mot:64	עולא אמר. (שבת י״‬ג) ופליגא דידיה אדידיה:
Achrei Mot:65	ואלו הן העריות וכו׳‬. עיין ריש כריתות וחשיב ג״‬כ חייבי מיתות ב״‬ד:
Achrei Mot:66	ואשת אחי האב מן האב כצ״‬ל. כי מן האם הוא רק מן השניות כמו שמנה המחבר לקמן משום אמו וכו׳‬ דברי ר׳‬ יהודה עיין (סנהדרין י״‬ג:) והוא דברי ר׳‬ יהודה בברייתא.
Achrei Mot:67	והוא פירוש על בת אביך כצ״‬ל. והכוונה בת אביו שלא בת אמך שלא נולדה באותו בית וקודם שנשאה אביו נולדה לו בת מאשתו הראשונה:
Achrei Mot:68	אבל בת אשת אביו שלא בת אביו מותרת לו. היינו חורגתו:
Achrei Mot:69	במס׳‬ (סנהדרין כ״‬ח:):
Achrei Mot:70	לשמת אחיו בלא בן. והרי היא עולה ליבום:
Achrei Mot:71	שיש לה אישות. כי אם אנס אשה מותר בבתה:
Achrei Mot:72	ושאמר שתי נשים וכו׳‬. היינו הכופרים בתורה שבע״‬פ:
Achrei Mot:73	אמרו רבותינו. (יבמות נד:):
Achrei Mot:74	בין שחוטין בין חיים. אולי כוונתו רק מחמת מאיסותא. עיין (ע״‬ז כ״‬ב:) גבי עבורת כוכבים לא פסקה זהומתן מביא עלה מערבי א׳‬ שקנה ירך רבעה צלאה ואכלה ע״‬ש:
Achrei Mot:75	הנבעלת באונס. היינו א״‬א שנאנסה. ולכהן אסורה:
Achrei Mot:76	העושות ולא הקריבות. עי׳‬ ת״‬כ לפי שנאמר לא תקרבו לגלות ערוה יכול יהיו חייבים כרת על ההקרבה כו׳‬. וכן הכוונה הכא:
Achrei Mot:77	פתח בהם בי״‬ה. שהתחלת הפרשה בשם הוי״‬ה וכן בסופו שהוא רחמן:
Kedoshim:1	אמרו רבותינו. (ברכות ס״‬א.):
Kedoshim:2	אמר ר״‬א אשרי איש כו׳‬. (ע״‬א י״‬ח).
Kedoshim:3	ולא מכריעו. אם אביו וחכם אמר חלוקין בדבר הלכה לא יאמר נראין דברי פלוני:
Kedoshim:4	אשרים שהם מתאשרין מאחרים. פי׳‬ שאין להם שום אישור מחמת עצמן רק הפתאים העובדים מאשרים אותם. ולזה נקראים אשרים בריבוי י״‬ס ולא אשור לשון יחיד:
Kedoshim:5	מה בא זה ללמדנו. בכאן נשתבש קצת ב׳‬ פסקות. וכצ״‬ל. מה זה בא ללמדנו והלא הורה השלמים וכו׳‬ אלא ביום זבחכם וממחרת בא ללמד שתחילת הזביחה היינו השחיטה לא תהי׳‬ אלא ע״‬מ לאכול לשני ימים וכ״‬ה בת״‬כ וברש״‬י בחומש. ואח״‬כ צ״‬ל לרצונכם על דעתיכם זבוחו וכו׳‬ והוא דרשה בפ״‬ע והיא כתובה (זבחים מ״‬ז.) וכן בסוף מנחות מנין למתעסק בקדשים שהוא פסול. פי׳‬ שלא נתכוון לשם שחיטה ת״‬ל לרצונכם תזבחו לדעתכם זבוחו. והיינו שיתכוון לשם שחיטה וכן הוא כוונת המחבר הכא:
Kedoshim:6	זה בנין אב כל שהוא קודש ונעשה נותר חייבין עליו כרת כצ״‬ל. כי האי קרא בנותר קמיירי וכ״‬ה (זבחים כח:) (כריתות ה׳‬.) וכן פרש״‬י בחומש:
Kedoshim:7	אין פאה אלא מחמת הכלוי וכו׳‬. פי׳‬ אין להקרא פאה שיפטור ממעשר עד שכבר קצר וכילה לשדהו וקרא שם להנוחר פאה. וטעמו של דבר עיין בת״‬כ:
Kedoshim:8	שדך ולא שדה של אחרים היינו של כנעני:
Kedoshim:9	לא תסייע את העני. עיין (גיטין י״‬ב).
Kedoshim:10	וכה״‬א אל תסיג גבול עולם. בירושלמי פאה אי׳‬ עולים אלו שירדו מנכסיהם שכן לסמיא קורין סגי נהורא.
Kedoshim:11	הנח לפניהם. קאי על סיפא דקרא תעזוב אותם ע״‬ז אמר הנח לפניהם וכו׳‬:
Kedoshim:12	אזהרה לגנב. עיין ת״‬כ לפי שנאמר גבי גנבה שנים ישלם למדנו עונש אזהרה מנין ת״‬ל לא תגנבו וקרא דלא תגנוב גבי עשרת הדברות קאי על גונב נפשות:
Kedoshim:13	שלא תראה גונב כצ״‬ל. וכ״‬ה בת״‬כ. והיינו אם תוכל לגנוב את שלך מגנב בל העשה כן שלא תקנה לך מדת הגנבה רק קח את שלך ביד חזקה:
Kedoshim:14	אפילו כ״‬ש. בת״‬כ ליתא דרשה זו. ועיין ח״‬מ שמ“ח אסור לגנוב אפילו כ״‬ש דבר תורה. וע״‬ש בטור כי דין פחות משוה פרוטה כמו חצי שיעור באיסורין:
Kedoshim:15	אלה אבלה הארץ. וסיפא דקרא ונשאר אנוש מזער כי החיות יהרגו אותם:
Kedoshim:16	אתך בזמן שתבעו. עיין (ב״‬מ קי״‬ב.) דורש אתך לדעתך:
Kedoshim:17	ושלא ליתן כוס יין לנזיר. עיין (פסחים כ״‬ב:):
Kedoshim:18	ונקרא עול. עיין ת״‬כ שח׳‬ שמות יש לו וחד מנייהו עול:
Kedoshim:19	שלא תהא רך  וכו׳‬. דורש ג״‬כ לגבי דין מסמיכת הקרא אחר בצדק תשפוט וכו׳‬:
Kedoshim:20	בשנאה שבלב וכו׳‬. עיין לקמן בפ׳‬ נצבים בפסוק ונתן ה׳‬ את האלות האלה על אויביך החילוק ששונא הוא בסתר. ואויב הוא בגלוי. ע״‬כ אומר כאן על תשנא בשנאה שבלב היינו בסתר:
Kedoshim:21	תמה אני כו׳‬. דורש הוכח תוכיח הוכח לעצמך ואח״‬כ תוכיח לאחרים:
Kedoshim:22	אמר ריב״‬נ וכו׳‬ (עורכין טז:):
Kedoshim:23	עד היכן תוכחה. שם.
Kedoshim:24	אבל נוקם אתה ונוטר לאחרים כצ״‬ל. ןקאי על לא תקום ולא תטור. וכ״‬ה בת״‬כ:
Kedoshim:25	מכאן אמר הלל הזקן כצ״‬ל (שבת לא.) ע״‬ש:
Kedoshim:26	חקים שנחקקו כבר (סנהדרין ס׳‬.) וע״‬ש בפרש״‬י ותוס׳‬:
Kedoshim:27	ואיש פרט לקטן. היינו פחות מבן תשע שאין ביאתו ביאה. עיין ת״‬כ:
Kedoshim:28	המיוחדת פי׳‬ א״‬י ולהוציא עבר הירדן ועיין ת״‬כ:
Kedoshim:29	לא יאכל. צ״‬ל ערלים לא יאכל אפי׳‬ בהנאה ונ״‬ה בת״‬כ (פסחים כ״‬ב:) כי ממלת וערלתם ערלתו ערלים לא יאכל קדריש ע״‬ש:
Kedoshim:30	להביא ל׳‬ יום לפני ר״‬ה,. דריש ובשנה מן ו׳‬ הנוסף כן פי׳‬ הגר״‬א ז״‬ל באדרת אליהו:
Kedoshim:31	עובר בל״‬ת (סנהדרין ס״‬ג) ואעפ״‬כ לא היה לוקין דהוי לאו שבכללות ע״‬ש:
Kedoshim:32	לנפש על כל מת ומת. היינו אס שרט שריטה אחת על הרבה מתים חייב על כל מת ומת וזה דריש מלנפש על כל נפש ועיין בת״‬כ:
Kedoshim:33	אינו חייב עד שיכתוב את השם. (מכות כ״‬א) ע״‬ש:
Kedoshim:34	אין מעשה יחידי כלום. עיין ת״‬כ. ופי׳‬ שיכול גם על עבירות מעשה יחידי תזנה הארץ לפירות ה״‬ל ומלאה הארץ זימה. ועיין ברמב״‬ן על התורה:
Kedoshim:35	מתוך שהוא בא וכו׳‬. עיין (יבמות לז:): פסיקתא פרשת קדושים זוטרתא נה
Kedoshim:36	והנשאל בהם וכו׳‬(סנהדרין ס״‬ג.) ע״‬ש בתוס׳‬ ד״‬ה והנשאל:
Kedoshim:37	ריה״‬ג אומר כו׳‬. זה שקנה חכמה שנאמר ה׳‬ קנני ראשית דרכו כצ״‬ל (קדושין לב:) ופי׳‬ שפליג אפילו יניק וחכם חייב לעמוד מפניו:
Kedoshim:38	שלא יעצים עיניו ת״‬ל תקום ויראת מאלהיך והוא דבר המסור ללב כצ״‬ל:
Kedoshim:39	יכול יקבלנו. פי׳‬ ליתן לו בת ישראל לאשה ה״‬ל אתך במוחזק לך. עיין ת״‬כ בארוכה:
Kedoshim:40	אינו גר. היינו אין מקבלים אותם:
Kedoshim:41	מנפשכם. שנס אתם הייתם גרים במצרים:
Kedoshim:42	פירשו רבותינו בתלמוד (ב״‬ב פט:).
Kedoshim:43	של צמרים וכו׳‬ בכאן משובש. ועיין (ב״‬ב פ״‬ט:) וכצ״‬ל כאן:
Kedoshim:44	ת״‬ר אין עושים. ב״‬ב שם:
Kedoshim:45	מדה חסרה או יתירה בתוך ביתו כצ״‬ל וכ״‬ה שם:
Kedoshim:46	מלמד שיעמיד אגרדמים (ב״‬ב שם) פי׳‬ ממונה להלקות למי שעושה מדור, שקרים:
Kedoshim:47	ולא על השערים. פי׳‬ שלא יומכר ביוקר. כי אם ירצה למכור ביוקר ממילא לא יקנו מאתו ולא ?צרך ממונים ע״‬ז. (רשב״‬ם שם):
Kedoshim:48	נופל במקום שיש ח״‬כ. עיין לעיל פ׳‬ צו צו זה זירוז מיד ולדורות במקום שיש ח״‬כ:
Kedoshim:49	כל שהמליכו עליו וכו׳‬ (סנהדרין ס״‬ד.) כל שהמליכו עליהם אפי׳‬ צרור אפילו קיסם וכן הכוונה הכא:
Kedoshim:50	באיש ולא בצבור שאין כרת בצבור:
Kedoshim:51	ההוא ולא אנוס וכו׳‬. נראה דדורש האיש ההוא היינו שיודע בשעת עשיה שעשה הדיבר הזה ברצונו ולא אנוס ושוגג ומוטעה כי לא האיש ההוא ברעתו עשה:
Kedoshim:52	שאם העלימו בדבר אחד. דורש מלות כפולות העלם יעלימו
Kedoshim:53	וכן מתרגם וכי׳‬. פי׳‬ על ובמשפחתו תרגם אונקלוס ובסעדוהי:
Kedoshim:54	אביו הוודאי ולא הספק. כגון שנשאת בחוך נ׳‬ חדשים למיתת או לגירושין הבעל וילדיה לז׳‬ שהולד ספק בן ט׳‬ לראשון או בן ז׳‬ לאחרון:
Kedoshim:55	אמו הוודאי ולא הספק. כגון שחי נשים שילדו במחבא ולא ידוע האמות.
Kedoshim:56	העוקף אחר המנאף. שמרגיל לו נשים לעבירה:
Kedoshim:57	שנכנסה לחופה ולא נבעלה דינה ג״‬כ בחנק ולא כארוסא שהיא בסקילה כדמסיים:
Kedoshim:58	מה מיתה האמורה בידי שמים מיתה שאין בה רושם. עיין (סנהדרין נב.) דיליף מיתה בידי שמים מבני אהרן או מעדת קרח שהיה מיתה שאין בה רושם ע״‬ש:
Kedoshim:59	פרט לאשת אחרים. היינו כנעני שג״‬כ אין קידושין תופשין:
Kedoshim:60	ודומה לו עד תכליתם כו׳‬. לשון בילבול שבלבלו זרע הבן וזרע האב:
Kedoshim:61	לא נתחייבה אשתו שריפה. כי עניה זו מה חטאה:
Kedoshim:62	אמו בראיה (סנהדרין מ:) אמר עולא מנין להתראה מן התורה כו׳‬:
Kedoshim:63	ולמה יצאת כו׳‬ (יבמות נ״‬ה):
Kedoshim:64	ואת שומרת יום כנגד יום. בת״‬כ ליתא וכאן הכוונה כי שומרת יום טובלת כעלות החמה ואח״‬כ אם לא ראתה כל היום מותרת לבעלה לערב. אם בעל אותה אחר טבילתה ואח״‬כ ראתה בו ביום אזי חייב כרת על הבעילה למפרע. עיין בפי׳‬ הרמב״‬ם סוף נדה וכן בגמרא שם:
Kedoshim:65	ערירים יהיו שאין זוכין לבנים. ולעיל פי׳‬ ערירים ימותו שאם יש לו בנים קוברן. עיין (יבמות נ״‬ה) כתיב ערירים יהיו וכתיב ערירים ימותו הא כיצד יש לו בנים קוברן. אין לו בנים הולך ערירי ואצטריך למכתב תרווייהו ע״‬ש:
Kedoshim:66	אני איני מביא אתכם אלא ע״‬מ לירש. לא ככנענים שהיו שומרי המקום סד שתבאו כצ״‬ל. וכ״‬ה בת״‬כ וכאן חסר ומשובש:
Kedoshim:67	מצוה זו עליכם לטמא ולאסור. היינו ע״‬י שחיטה. עיין בת״‬כ ובק״‬א:
Kedoshim:68	מנין ל״‬י ימים. כי התורה נתנה במ׳‬ יום שהיה משה בהר:
Kedoshim:69	עצם ידוע. מחיה ששמה ידוע:
Emor:1	רבותינו אמרו. (שבת קנ״‬א:):
Emor:2	וספרי המוכסים. לפנינו במשנה שם הגי׳‬ וספרי מירוס אינם מיטמאין. ופי׳‬ הרב ספרי מירוס ספרי מינים והוא מירם היוני הידוע בספריהם:
Emor:3	לפי שישראל מטמאין למתים. פי׳‬ כי מצוה הוא על ישראל לטמא למתים כי זה ג״‬ח של אמת:
Emor:4	בזמן שעמיו שם. היינו שיש לו קוברין ואינו מת מצוה כדמסיים:
Emor:5	יש שנטמא ואינו לוקה. היינו בשוגג:
Emor:6	וכה״‬א שאר אביך וכו׳‬. וזה ראיה כי שאר קאי על הנקבות וכן הבא שארו זו אשתו:
Emor:7	וא״‬ת הקרוב לשון זכר וכו׳‬. כל המאמר הזה המוסגר נכתב שלא במקומו שדורש הקרוב ולא הארוסה. וע״‬ז שייך הקושיא וא״‬ת:
Emor:8	ודומה לו אותו ואת בנו משום אותה ואת בנה היא כצ״‬ל. שי׳‬ כי האיסור הוא רק הנקבה ובנה ובתורה כתוב ובנו. וכן הכא משום שארו שהוא לשון זכר שקאי על הבעל שהאשה קרובה אליו אמר ג״‬כ הקרוב לשון זכר:
Emor:9	וחולץ. היינו חליצת כתפיו שנוהגין גבי מת משום אבילות:
Emor:10	לפיכך הקדים הבן לבת. בת״‬כ מוסיף עוד לפי שיש בבת מה שאין בבן שהבת אביה זכאי במציאתה במעשה ידיה ובהפרת נדריה (כמו שמסיים המחבר לקמן) לפיכך צריך לומר לבנו וצריך לומר ולבתו:
Emor:11	שהיא עדיין קרובה לו וכו׳‬. כוונתו כמו שהוא בירושלמי פרק הבא על יבמתו שמקשה תמן אמרין (היינו גבי קרא כי אם לשארו הקרוב אליו) למעט את הארוסה והכא (גבי ולאחותו הקרובה) מרבינן ארוסה א״‬ר הילא כל מדרש בענינו אחותו לעולם היא בפנים עד שתצא לחוץ ארוסתו לעולם היא בחון עד שתכנס לפנים. וזה כוונת המחבר הכא גבי אחותו הקרובה מרבינן ארוסתו שהרי היא עדיין קרובה לו ע״‬כ אין הבעל מטמא לה ואינו יורשה לפיכך היא קרובה עדיין לאח אבל לגבי בעל ממעטי: ארוסה שעדיין בחוץ היא נגד הבעל שהרי אינו יורשה ועדיין אינה קרובה כ״‬כ עם הארוס שלה עד אחר הנישואין:
Emor:12	ואינו מטמא על הספק. היינו שהיא אחותו מספק כנון ספק בן ט׳‬ לראשון או בן ז׳‬ לאהרון וכדומה:
Emor:13	ואינו מטמא לאבריה. פי אם נחסר מהגוף אבר אינו מטמא לה. ודע דזה הדין לאו דווקא גבי אחותו רק זה גבי כל הז׳‬ מתים שהכהן מטמא. מטמא רק למת שלם ולא חסר עיין בת״‬כ שדורש זה ג״‬כ גבי אביו ועיין (נזיר מג:) נקטע ראשו של אביו אינו מטמא דכתיב ולאביו בזמן שהוא שלם וכו׳‬. ועיין (סוטה נ׳‬) תוס׳‬ ד״‬ה ור״‬ע מה שהקשו ע״‬ז וצ״‬ע. ועיין באדרת אליהו להגר״‬א שמתרץ קושית התוס׳‬:
Emor:14	בעמיו של בעל שלמעלה וכו׳‬. כוונתו כי אם לשארו הקרוב מרבינן לעיל שארו זו אשתו שמטמא לה. ע״‬ז מסיים ואינו מטמא לאשתו הפסולה. והנה כתיב כאן שני פעמים בעמיו ויש ע״‬ז ג׳‬ דרשות (א) בעמיו להוציא מת מצוה שמטמא (ב) שאינו מסמא לאשתו הפסולה (ג) שאינו מטמא לקרובין שאינם עושין מעשה עמך. וע״‬ז אמר המחבר בעמיו של בעל. ומנין שנאמר בעמיו בזמן שהוא עושה מעשה עמך ע״‬כ אינו מטמא לה. והוא בכלל דרשא הא אם פירשו מדרכי צבור אינו מטמא להם. ואף שלא הוזהרו פסולות להנשא לכשרים עיין (יבמות) אעפ״‬כ אין עושין מעשה עמך קרינן ליה. ועיין בת״‬כ. אולם רש״‬י ז״‬ל כתב ובאיזה שאר אמרתי באותו שהיא להחלו להתחלל הוא מכהונתו עכ״‬ל. ומשמע מלשון להחלו קדריש שאינו מטמא לאשתו הפסולה. וכבר עמד בזה המזרחי ע״‬ש.
Emor:15	יטמא כה״‬ג. היינו אפילו כ״‬ג ופשיטא כהן הדיוט:
Emor:16	שאינו מטמא לנשיא. בת״‬כ ליתא ולא ידעתי רמז לדרשא זו מקרא. ואולי יפרש כמו שהית כתוב לבעל בעמיו. והיינו הנשיא שהוא גדול בעמו. וכעין זה עיין ברמב״‬ן בפירושו שפי׳‬ לענין דבר אחר. כי בעל בעמיו קאי על הגדולים ע״‬ש:
Emor:17	בזמן שהוא מתעסק בו וכו׳‬. עיין בת״‬כ הגי׳‬ להחלו נהג מנהג כזה (וקאי על שפירשו מדרכי צבור) הרי הם חולין יכול יהיו חולין לעולם ת״‬ל בעמיו בזמן שהוא עמו היינו שעדיין העבירה בידו פירש הרי הוא בקדושתו. ואולי כצ״‬ל הכא:
Emor:18	פירש וטבל והזה. הלשון אינו מדוקדק ובת״‬כ ליתא רק הכוונה שפירש מעבירה שבידו:
Emor:19	שאם סך וכוי. עי׳‬ (מכות כ:) והיינו התראה אחת וחייב ה׳‬ מלקות:
Emor:20	לפי שנאמר לא תתגודדו. היינו גבי ישראל:
Emor:21	ונאמר. להלן לא תתגודדו וכו׳‬ למת אף כאן לא יקרחו קרחה גבי כהנים למת כצ״‬ל. וכ״‬ה בת״‬כ:<br>כא. על כרחן. דורש מדכתיב קדושים יהיו ולא כתיב קדושים הם ע״‬כ יהיו קאי על ב״‬ד שיקדישו אותם בע״‬כ:
Emor:22	ואח״‬כ בא בעלה. אע״‬פ שנתן לה האחרון גט לא פסלה מן הכהונה שנאמר אשה גרושה מאישה ולא מאיש שאינו אשה כצ״‬ל. וכ״‬ה בת״‬כ וכן (יבמות צ״‬ב.) בשם ר׳‬ אליעזר ב״‬ר מתיה ע״‬ש:
Emor:23	שאף האשה מוזהרת ע״‬י האיש. פי׳‬ שאף שלא הוזהרו כשרות להנשא לפסולים (יבמות פה:) אעפ״‬כ היא מוזהרת שהעבירה עליו ועיין בת״‬כ ובק״‬א שהאריך בזה:
Emor:24	שאם היו נוהגין וכו׳‬. (סנהדרין נ״‬ב.) ע״‬ש:
Emor:25	דר׳‬ פנחס. עיין ויקרא רבה פ׳‬ כ״‬ו הגי׳‬ פנחס הסתת. ופי׳‬ שהיה חוצב אבנים. ובת״‬כ גי׳‬ אחרת:
Emor:26	ומלא את ידו ללבוש אח הבגדים אפילו יום אחד אפילו שעה אחת כצ״‬ל. ועיין בת״‬כ והוא ג“כ כה״‬ג אחר שנגנז שמן המשחה:
Emor:27	כיצד כה״‬ג וכו׳‬. עיין (הוריות יב:) פלוגתא בזה:
Emor:28	חסר ו׳‬ וכו׳‬. בת״‬כ גירסא אחרת שנאמר ועל כל נפשות (הוא לשון רבים) מת (הוא לשון יחיד) מכאן לרביעית דם שיצא מב׳‬ מתים שהוא טמא:
Emor:29	לא יבא. וכתיב אח״‬כ לא יטמא. מכאן שהוא חייב בבל יבא ובבל יטמא והיינו ב׳‬ לאוין ועיין בת״‬כ:
Emor:30	דברי ר״‬ם. ועיין בת״‬כ שר״‬י פליג ע״‬ז וכ״‬ה (סנהדרין י״‬ח.) ע״‬ש:
Emor:31	ולא יחלל את אלהיו. ומנין שאם עבד עבודתו כשרה ת״‬ל ולא יחלל את מקדש אלהיו הא כהן הדיוט שעבד אין עבודתו פסולה כצ״‬ל וכ״‬ה בת״‬כ.
Emor:32	כי שמן וכו׳‬ לרבות מרובה בגדים. בכאן אין הגי׳‬ מכוונת. וגם בת״‬כ ג״‬כ קשה הגי׳‬ עיין בק״‬א ויותר נכון הגירסא עיין (הוריות י״‬ב:) והכהן הגדול מאחיו זה כ״‬ג. אשר יוצק על ראשו שמן המשחה זה משוח מלחמה. ומלא את ידו ללבוש את הבגדים זה מרובה בגדים. על כולן הוא אומר את ראשו לא יפרע וכו׳‬ וכו׳‬ יכול יהיו כולם מקריבים אוננים ת״‬ל כי נזר שמן משחת אלהיו עליו ולא על חבירו וממעטין רק משוח מלחמה שאינו מקריב אונן ע״‬ש בפירש״‬י. אבל כ״‬ג הן שנמשח בשמן המשחה הן מרובה בגדים מקריבים אוננים. וכן הוא כוונת המחבר הכא:
Emor:33	והוא לרבות כהן משוח מלחמה. שמצווה על הבתולה. עיין הוריות שם:
Emor:34	ואיזה הוא. זו יתירה על י״‬ב שנה שלא אמר בתולה אלא בבתוליה כצ״‬ל ועיין (יבמות נ״‬ט.) שדורש מב׳‬ יתירה ע״‬ש:
Emor:35	ולפי שהותרה וכו׳‬. עיין כ״‬ז בת״‬כ בארוכה:
Emor:36	אין זרעו מן הנדה חולין, עיין (יבמות ס׳‬.) ובתוס׳‬ שם מה שמקשה ע״‬ז:
Emor:37	להביא בת גיורת עמונית שתהא כשרה לכהונה כצ״‬ל דדרשינן עמוני ולא עמונית:
Emor:38	יקה אשה ולא יבמה. אלא כה״‬ג חולץ ולא מיבם:
Emor:39	להביא האשה שמתחללת וכו׳‬. שאם נשאה אח״‬כ כהן הדיוט לוקה:
Emor:40	תינוק פסול. דכתיב איש מזרע אהרן עד שיהיה גדול כצ״‬ל וכ״‬ה בת״‬כ:
Emor:41	עד שיהיה בן ב׳‬. כן הוא ג״‬כ בת״‬כ והוא כדברי רבי (חולין כ״‬ד) ע״‬ש:
Emor:42	ומנין לרבות שאר הקרבנות ת״‬ל שוב להם. פי׳‬ שני פעמים כתיב לחם בפרשה לא יקרב להקריב לחם אלהיו. ובסופו את לחם אלהיו לא יגש להקריב מנין לרבות את הדם ת״‬ל להקריב:
Emor:43	ובה״‬א ויקריבו בני אהרן את הדם כצ״‬ל הרי שדם נקרא הקרבה:
Emor:44	מה לחם שהוא מיוחד וכו׳‬. חסר כאן כל הדרשה ועיין בת״‬כ וכצ״‬ל מנין הקומץ והלבונה והקטורת ומנחת כהנים וכו׳‬ ה״‬ל לא יגש להקריב. יכול יהיו חייבים על כולם ת״‬ל לחם מה לחם מיוחד שהיא משום עבודה יצאו אלו שאינו משום עבודה וכצ״‬ל הכא:
Emor:45	חוטמו בלום. פי׳‬ שנסתמו נקבי האף:
Emor:46	חוטמו סולד. שהוא קצור בארכו שנדמה שניטל ראש החוטם עיין (בכורות מ״‬ד.) וברש״‬י שם:
Emor:47	חוטמו נוטף. ארוך ותלוי למטה משפתו:
Emor:48	ושתי שזרות. היינו כעין שתי שדרות עיין (בכורות מ״‬ג) כי שתי שדרות ממש אינו חי:
Emor:49	הקצת ט״‬ס וכצ״‬ל או דק זו דוק שבעין עיין רש״‬י בכורות שם דוק כמו הנוטה כדוק שמים:
Emor:50	שרוח באשכיו. היינ שביציו נפוחים:
Emor:51	זה שמראיו חשוכים היינו שמראות הפנים שלו שחורים ולא קאי אביצים:
Emor:52	כל איש אשר בו מום לרבות שארי מומין. ובת״‬כ למד מדכתיב ב׳‬ פעמים מום ע״‬ש.:
Emor:53	מום בו פרט לשעבר מומו. מבו קדריש רק שהמום בו
Emor:54	לא יגש כו׳‬ כו׳ ג׳ פעמים וכו׳ כצ״‬ל:
Emor:55	ולא יחלל וכו׳. שאם עבר ועבד עבודתו כשירה אלא שחילל. ופליאה היא שבת״‬כ הגי׳ עבודתו פסולה. וכן הדין בעל מום פוסל עבודה. ואפשר קצת לדחוק. דהמחבר קאי על מומי עוברין עיין (בכורות מ״ג:) מאי איכא בין מומא. ולשאינו שוה בזרעו של אהרן (דהיינו כילון וליפתן) איכא משום אחולי עבודה מומא מחיל עבודה דכתיב מום בו ולא יחלל. שאינו שוה בזרעו של אהרן לא מחיל עבודה. מאי איכא בין שאינו שוה בזרעו של אהרן ומשום מראית העין א״ב עשה שאינו שוה עובר בעשה. ויהיה כוונת המחבר על מומין עוברין אף שעבודתו כשירה אעפ״כ חילל היינו שעבר בעשה. כנ״ל לפרש. ועדיין לא הונח לי והבוחר יבחר:
Emor:56	מלמד שאין חייבין על קדשי עבודת כוכבים. כ״ה ג״כ בת״כ. ועיין (זבחים פ״ו:) אלא למעט עובד כוכבים השתא ציץ לא מרצה וכו׳ היפוך כמו שאמר הכא ע״ש בתוס׳:
Emor:57	מלמד שהשם מתקדש וכו׳. אולי הכוונה כי אצל קרבן נכתב רק שם הוי״‬ה וכאשר מחלל הקרבן כביכול ששם הקודש מתחלל:
Emor:58	אשר הם מקדישים. להביא קדשי כהנים עצמם ממלת הם דריש:
Emor:59	עד שיקריבו מתיריו. מלישנא דקרא אשר יקרב שאינו חייב כרת בטומאת הגוף עד שיקרבו מתיריו:
Emor:60	מכל מקום שילך. הכוונה כמו שהוא בת״‬כ יכול מצד זה לצד זה ת״‬ל מלפני כו׳‬.
Emor:61	איש איש בין גדול בין קטן. בת״‬כ ליתא דרשה זו הן אמת כי קטן זב או צרוע אסור לאכול בתרומה. אבל לא מצאנו דרשה זו. ועיין (יבמות ע׳‬.) מרבה מאיש איש ישראל ערל:
Emor:62	אוכלין הם במעשר. פי׳‬ מעשר שני בירושלים:
Emor:63	אלא מגע. היינו שנגע באדם שנטמא במת הוא ראשון לטומאה:
Emor:64	לרבות את הנבלה. בכל שרץ רבויא הוא:
Emor:65	ולא אבר אבר. בת״‬כ יליף ובא השמש מה ביאת שמשו כולן כאחת אף מים כולן כאחת:
Emor:66	שהיא מטמאה עד שלא יאכלנה. ולא שייך בה טומאה בבית הבליעה דהרי כיון שנגע בה נטמא. ועיין בת״‬כ הגי׳‬ יותר מבוארת:
Emor:67	בקדשי הגבול. היינו תרומה ותרומת מעשר:
Emor:68	נאמר כאן תושב וכו׳‬. הוא דרשה בפני עצמה:
Emor:69	שאינו שוה בסף. שהרי יוצא בשש ואינו קרוי קנין כספו:
Emor:70	פרט לחציו עבד וחציו בן חורין. כי החצי שהוא בן חורין אינו כספו. ועיין בת״‬כ:
Emor:71	אע״‬פ שאינו שוה כלום. היינו בשעה שנולד אין לו דמים:
Emor:72	בלחמו לא תאכל הבהמה. היינו משום הפסד תרומה שאין לבהמה מאכל אדם:
Emor:73	אבל היא תאכל כרשיני תרומה כצ״‬ל כי זה מאכל בהמה. ומרבינן בהמה מן כי יקנה נפש ונפש בהמה ג״‬כ בכלל ועיין ת״‬כ:
Emor:74	מפני שהוא זר אצלה שאינו מאכיל כצ״‬ל לדעתי. ועי׳‬ בת״‬כ הגי׳‬ ת״‬ל כי תהיה לאיש המאכיל. והכוונה אף שהוא כהן אבל הוא זר אצלה שנשאה בעבירה ע״‬כ:
Emor:75	אבל אמה אוכלת. בשביל בתה:
Emor:76	מכאן אמרו. (יבמות ס״‬ט:):
Emor:77	בקדשי הגבול. היינו תרומה ותרומת מעשר אבל לא תאכל בחזה ושוק עי׳‬ (יבמות ס״‬ח:):
Emor:78	על המורם מהם חייבין. (חומש) ואינם חייבין על התרומות שבטבל:
Emor:79	[]
Emor:80	מלמד שאף על הטבל כו׳‬. (סנהדרין פ״‬ג) והדרשה הוא מקרא דלפניו ולא יחללו וגו׳‬ את אשר ירימו לה׳‬ קאי על הטבל אשר עתיד לתרום ממנו תרומה. וזה את אשר ירימו לה׳‬ וע״‬ז אמר והשיאו אותם עון אשמה היינו שחייבין על טבל מיתה. ועי׳‬ בק״‬א שנדחק בחנם בדרשה זו:
Emor:81	פרט לזורע ולמטמא. היינו דווקא על אכילה חייב מיתה אבל להפסיד תרומה איכא רק איסור:
Emor:82	להביא את הערום כצ״‬ל וכ״‬ה בת״‬כ:
Emor:83	תמים זכר בבקר וכו׳‬ המות וזכרות בבהמה וכו׳‬כצ״‬ל:
Emor:84	לרבות מום עובר. בו מום דריש כל זמן שיש בו המום פסול:
Emor:85	אפי׳‬ לא תקדישום כי המקדיש בעל מום עובר בה׳‬ לאוין עי׳‬ ת״‬כ:
Emor:86	לפלא נדר לרבות את הנזירות. כי גבי נזיר כתיב ג״‬כ לשון כי יפליא:
Emor:87	שלא יגרום בו מום. היינו בבכור ובמוקדשין:
Emor:88	את שנעבדה בה עבודה. עיין (סוטה מ״‬ו) דה״‬א לילף מעגלה ערופה. ואפי׳‬ עבודת איסור כגון עשה אתה מלאכה בשבת או הנהיגה כלאים כשור וחמור אינו פוסל כקדשים:
Emor:89	לרבות שעיר המשתלח. שנפסל במום:
Emor:90	ושור ושה שרוע וקלוע. שרוע שנשמטה יריכו וקלוע שפרסותיו וכו׳‬ כצ״‬ל:
Emor:91	אפילו תרנגול. שאינו ראוי למזבח. ואפילו כלב שגם חליפיו אסורים למזבח (עיין חגיגה י״‬ד:) ובתוס׳‬ שם אעפ״‬כ אסורים בסירוס:
Emor:92	מכאן שאין בקבלין וכו׳‬. חסר הקרא וכצ״‬ל ומיד כן נכר לא תקריבו את לחם אלהיכם מכאן שאי: מקבלין שקלים מן הכנענים שמהם היו מקריבין תמידין ותמידין נקרא לחם דכתיב את קרבני לחמי:
Emor:93	לא שהמום וכו׳‬. ט״‬ס וכצ״‬ל וקאי על הקרא כי משחתם בהם מום בם כל שהמום פוסל כו דבר ערוה ועבודת כוכבים פוסלת בו וכל שאין כו׳‬. ונ״‬מ לבהמת מעשר שאין מום פוסל כו עיין (בכורות נ״‬ז.) ע״‬ש:
Emor:94	פרט לכלאים. חסר וכצ״‬ל שור או כשב פרט לכלאים (פי׳‬ שדורש שור או כשב שיהיה או ממין שור או ממין כשב. וכלאים הוא משור וכשב) או עז פרע לנדמה (נדמה שאמו רחל והוא דומה לעז) כי יולד פרע ליוצא דופן. וכ״‬ה (בכורות נ״‬ז.):
Emor:95	פרט ליתום. פי׳‬ כל שמתה או שנשחטה אמו קודם שילדו ע״‬ש בבכורות:
Emor:96	ומצאנו אנו למדיי וכו׳‬ כצ״‬ל:
Emor:97	אותו ואת אמו מנין ת״‬ל לא תשחטו ביום אחד להביא שנים ששחטו כו׳‬ כצ״‬ל. הכוונה כי מזה מוכח דגם אותו ואת אמו אסורה. כי אחרי שמרבינן שנים ששחטו והנה הראשון ששחט שחט כהיתר. והנה אחרי שמרבינן שנים ששחטו מוכרחין אנו לומר שאחד שחט אמה והשני בתה הרי שגם אותו ואת אמו אסור:
Emor:98	להביא השוחט לעבודת כוכבים ולכלבים כצ״‬ל. והיינו הראשון נשחט לעבודת כוכבים או לכלבים חייב על השני משום אותו ואת בנו עי׳‬ (חולין פ״‬א ע״‬ב):
Emor:99	שאף תחלת זביחתן. היינו שחיטתו. ועיין ברש״‬י בחומש:
Emor:100	אני ה׳‬ דברים שבלב. היינו ה׳‬ היודע נסתרות הוא. יעיד עליו שלא חשב בשעת תחלת זביחתו לאכול ביום מחר כמו שאומר מקודם:
Emor:101	במרובין. היינו כעשרה מישראל:
Emor:102	שכן מצאנו בחמו״‬ע וכו׳‬. דבר זה מבואר היטב בשה״‬ש רבה פסוק זאת קומתך כי הם שאלו ליחזקאל הנביא אם ימסרו עצמם על קידוש השם ע״‬ש באריכות ואחרי שאמר להם יחזקאל כי השי״‬ת אמר לו כי לא יציל אותם אמרו לנכוכדנצר והן להוי ידיע לך מלכא בין מציל בין לא מציל ע״‬ש באריכות וזה הכוונה ג״‬כ כאן:
Emor:103	כשנתנו יד יושבי הארץ. הוא מלחמת הצלב הידוע (קריין ציגע):
Emor:104	שיהיו ישראל מקדשין וכו׳‬. כי זה תלוי בב״‬ד:
Emor:105	תניא כיצד ארשב״‬ג. (סנהדרין י׳‬:) ע״‬ש:
Emor:106	פי׳‬ על האביב שאם ראו ישראל וכו׳‬. (שם י״‬א:) וע״‬ש בפירש״‬י שדחה פירוש זה:
Emor:107	והיינו פלוגתא דר׳‬ יהודה ור׳‬ יוסי. ע״‬ש (סנהדרין י״‬א:) פלוגתתם אם יום תקופה מתחיל או גומר:
Emor:108	בדרך דת הישמעאלים. שאין להם שום עיבור וחדשם תמיד שלשים יום:
Emor:109	אפילו בח״‬ל. אסור כעשיית מלאכה בקידוש ב״‬ד. אשר תקראו אותם כמו אתם וקאי על ב״‬ד:<br>קט. וראשון לרגלים. לענין בל תאחר עיין (ר״‬ה ד׳‬.):
Emor:110	ואין חג הסכות טעון מצה. עי׳‬ בת״‬כ דה“א לילף מק״‬ו מפסח:
Emor:111	אין מצות קצירה בכהן. דריש ליה מסיפא דקרא והבאתם אח עומר ראשית קצירכם אל הכהן דמצות כהונה רק מהבאה ואילך:
Emor:112	והבאתם את עומר מצוה לקצור ולהביא. דורש ראשית קצירכם שיהיה נקצר לשם העומר (מנחות ע״‬א.) דרשה אחרת בזה:
Emor:113	קצירבם ולא קצירנו. לא ידעתי לכוון כוונתו בזה ובת״‬כ ליתא. וידידי הר״‬מ פינקלשטיין מבריסק רצה להגיה קצירכם ולא קציר כנעני. והנה (בר״‬ה י״‬ג.) אם תאמר דעייל ביד כנעני קצירכם אמר רחמנא ולא קציר כנעני (ע״‬ש בתוס׳‬ ד״‬ה ולא קציר כנעני). אעפ״‬כ מפשטות לשון הגמרא נראה שאין זה דרשת הת״‬כ או תוספתא וא״‬ל כי המחבר העתיק משם. ומה גם אין קנין לכנעני בא״‬י להפקיע מתומ״‬ע וצ״‬ע (ואולי היה כתוב כאן קצירכם ולא קציר של מצוה עיין (מנחות ע״‬ב.) קוצרין מפני הנטיעות ומפני בית האבל ומפני ביה המדרש. ודריש זה קצירכם ולא קציר של מצוה ע״‬ש):
Emor:114	ולא של בית השלחין. מפני שהם מפסידין מהר. ועוד דרעות הם ואין בהם איסור בקצירה:
Emor:115	קצירכם ולא הקטניות. שאין קציר רק בה׳‬ מיני תבואה:
Emor:116	שלשה שמות יש לו. עומר שבלים עומר תנופה עומר שמו (פי׳‬ סתם עומר) כ״‬ה הגי׳‬ בת״‬כ וגי׳‬ דהכא לא ידעתי לפרשו הרי הכל אחד:
Emor:117	וכתיב הניפכם. לשון רבים וקאי על כל ישראל:
Emor:118	ולא שנה למנין עולם. היינו שהכבש נצרך להיות בן שנה מיום ליום:
Emor:119	יכול לא יכפול יינו. שאין היין נבלל עם הסולת אבל יכפול שמנו שהרי השמן נבלל עם הסולת ת״‬ל ונסכו יין רביעית ההין כל נסכיו רביעית כצ״‬ל. וכ״‬ה בת״‬כ:
Emor:120	לכך כתיב בה״‬א וכו׳‬. פי׳‬ כתיב ונסכ״‬ה יין וקרינן ונסכו:
Emor:121	היה מביא אותו מן הקרוב. פי׳‬ בכדי שיהיה רך ומל שלא נתייבשו עדיין השבלים:
Emor:122	ותנן כיצד וכו׳‬ עי׳‬ כ״‬ז (מנחות ס״‬ה:):
Emor:123	מגל זו אומר הן. ג״‬כ ג׳‬ פעמים:
Emor:124	נתניהו באבוב. כלי של נחושת וכך שמו:
Emor:125	דתנן ואלו מנחות. (מנחות ע״‬ב:):
Emor:126	ת״‬ל וקלי וכרמל כצ״‬ל וכ״‬ה בת״‬כ. ופי׳‬ דדריש סיפא דקרא וקלי וכרמל להוסיף עוד כ׳‬ מינין והיינו כוסמין מין חיטין וש׳‬ש ושיפון מין שעורים:
Emor:127	חוקת עולם לבית עולמים. לדורותיכם שינהוג הדבר לדורות בכל מושבותיכם בארץ ובח״‬ל כצ״‬ל וכ״‬ה בת״‬כ:
Emor:128	כל או״‬א מחוייב לספור בפ״‬ע. לא כשמיטה ויובלות שתלוי בב״‬ד:
Emor:129	אף כאן רגל ותחילת רגל כצ״‬ל. וכ״‬ה בת״‬כ פי׳‬ אחר יום ט״‬ו שהוא רגל של פסח מתחיל ספירת העומר שהוא תחלת ספירת רגל לשבועות:
Emor:130	הא כיצד מצה וכו׳‬. הרי שמתחיל למנות מיום י״‬ו כניסן ויאכל ששה ימים מצה מן החדש:
Emor:131	ת״‬ל מהחל חרמש וכו׳‬ דהיינו קודם הבאה תחל לספור וזה בי״‬ו בניסן:
Emor:132	מיום הביאכם חסר וכצ״‬ל אי מהחל חרמש תחל לספור יכול יקצור ויספור ואימתי שירצה יביא ת״‬ל מיום הביאכם. ועיין (מנחות ס״‬ו.):
Emor:133	זו תשובה וכו׳‬. (מנחות ס״‬ה):
Emor:134	והוא שאמר ר׳‬ יוסי בר׳‬ יהודה. עיין (מנחות ס״‬ה:) והוא כמו שאומר בפסקא שלמעלה והתורה אמרה חמשים ולא אחד וחמשים וכו׳‬ ע״‬ש:
Emor:135	כגון מילה וציצית. עיין יו״‬ד סי׳‬ רס״‬ה ס״‬א האב והבן כשמברכים צריכים לעמוד. וציין הגר״‬א ז״‬ל דכתיב ימול לכם כמ״‬ש בא״‬ח רס״‬ח בהלכות ציצית ע״‬ש:
Emor:136	שתהא ראשונה לכל המנחות. כי עד עתה אסור להקריב למזבח תבואה חדשה:
Emor:137	שתים שני עשרונים שיהיו שוות כצ״‬ל ונ״‬ה בת״‬כ פי׳‬ החלות יהיו גדלן שוות:
Emor:138	השאור בודה להן. פי׳‬ בודה מוציא מלשון אשר בדה מלבו והיינו שמוציא הקמח מתוך העשרון ועושהו שאור ומחזירו לתוכו:
Emor:139	וכך אמרו. (מנחות מ״‬ה):
Emor:140	ת״‬ר והניף. (שם ס״‬ב.):
Emor:141	נשתקל הכתוב כצ״‬ל. ופי׳‬ השווה שני דינים בפסוק זה דתרתי שמעינן מיניה ולא ידעינן בתר הי אזלינן (רש״‬י מנחות שם):
Emor:142	להוציא ז׳‬ היינו הז׳‬ כבשים של חובת היום האמורין בפ׳‬ פנחס אין טעונין תנופה עם הלחם:
Emor:143	לא שמן ולא לבונה כדין מנחת חוטא כצ״‬ל:
Emor:144	ת״‬ר זבחי שלמי צבור. טעונין תנופה לאחר שחיטה (מנחות ס״‬ב.) שם מאמר ארוך ובכאן הביא רק ההתחלה וג״‬כ בשיבוש:
Emor:145	מוציא פרי לג׳‬ יום משיוציא ניצו כצ״‬ל נ צו פי׳‬ פרחו עיין (שבת פ״‬ח.) למה נמשלו ישראל לתפוח:
Emor:146	למצוה, הזאת. לקט שכחה ופאה:
Emor:147	והוא מקריב קרבנותיו לתוכו. וכל מי שאינו מוציא לקט שכחה ופאה ומעשר עני מעלה עליו כאלו בהמ״‬ק קיים ואינו מקריב קרבנותיו לתוכו כ״‬ה הגירסא בר״‬ר ובכאן חסר י
Emor:148	הנח לפניהם. פי׳‬ והם ילקטו ואין לך לסייע א׳‬ מהם:
Emor:149	וסימנך ב״‬ש. פי׳‬ יום ב׳‬ של פסח באותו יום נופל חג השבועות:
Emor:150	יום כפורים. אע׳‬׳‬פ שאין קרבנות עצמו של יום מכפר:
Emor:151	ר״‬ל אמר מנין כו׳‬. (יומא ע״‬ו.) ע״‬ש:
Emor:152	חג הסוכות מה חג אסור בהנאה. קאי על חגיגה. ועיין דרשה זו (סוכה ט׳‬.) מנין לעצי סוכה שאסורין כל שבעה וכו׳‬:
Emor:153	שהרי זה הפסוק של עזרא. קאי על ר״‬ה:
Emor:154	מלמד שהעולה קודמת למנחה. בת״‬כ הגי׳‬ אם אין עולה אין מנחה שתקדם עולה למנחה שאם קדמה עולה למנחה פסולה. וקאי מנחה על מנחת נסכים שמביא עם העולה:
Emor:155	מלמד שמוספי שבת קריבין עם אימורי הרגלים. עיין בת״‬כ והכוונה שצריך להביא ג״‬כ מוספי שבת ביו״‬ ט ולא יפטור עם מוספי הרגל (הגר״‬א באדרת אליהו) שכל קרבנות היחיד היינו הקבוע להם זמן:
Emor:156	ב׳‬ש וכו׳‬. בכאן משובש וכצ׳‬ל. וכ״‬ה בת״‬כ. יכול יחוג אדם (היינו קרבן חגיגה) ביו”ט ת״‬ל אך במועד אתה חוגג (היינו בחוש״‬מ) ואי אתה חוגג ביו״‬ט. ב״‬ה אומרים יכול יחוג אדם בשבח ת״‬ל אך ביו״‬ט אתה חוגג ואי אתה חוגג בשבת כצ״‬ל. ובכאן הרכיבו דברי ב״‬ש וב״‬ה ביחד:
Emor:157	שיש לו תשלומין כל שבעה כצ״‬ל:
Emor:158	וערבי נחל שיהיו דליות כצ״‬ל. ופי׳‬ דליות אפילו קטומים (סוכה ל״‬ד:) והיינו כר׳‬ טרפון:
Emor:159	לדורותיכם. לבית עולמים. פי׳‬ אף שנכתב לדורותיכם אעפ״‬כ אין נוהג דין קרבנות רק בזמן שבהמ״‬ק קייב:
Emor:160	בסכת. (כצ״‬ל והיינו חסר ו׳‬) מכאן אמרו ולא כסוכה. שתחת הבית וכו׳‬ כצ״‬ל:
Emor:161	וקורא בסוכה. היינו שלומד כסוכה:
Emor:162	מכאן אמרו י״‬ד סעודות. (סוכה כז.):
Emor:163	רא״‬א סוכות ממש וכו׳‬ ר״‬ע אומר ענני הכבוד וכו׳‬ כ״‬ה הגי׳‬ בת״‬כ. אולם (בסוכה י״‬א) להיפך ע״‬ש:
Emor:164	לפי שנאמר בהם במועדו כצ״‬ל:
Emor:165	קבע מועד לכולם כצ״‬ל. והכוונה וידבר משה את מועדי ה׳‬ לרבות העומר והקרב עמו שתי הלחם וכו׳‬:
Emor:166	אין צו אלא זירוז מיד כצ״‬ל. וכ״‬ה בת״‬כ. ומוסיף עוד שם אר״‬ש ביותר צריך זירוז במקום שיש חסרון כיס:
Emor:167	אתה גזבר לדבר. ויקחו אליך דריש:
Emor:168	מצאו שכבה. היינו לאחר שמת שמעון הצדיק ע״‬ש בסוף פ״‬ג דתמיד:
Emor:169	עדות לכל באי עולם. עיין (מנחות פו:) העדות הוא נר מערבי שנותנין בה שמן כמדת חברותיה וממנה היה מתחיל להדליק ובה היה מסיים:
Emor:170	שלא תהא להם עבודה מערב עד בקר אלא היא. היינו שתהיה כשרה מערב עד בקר. עיין (מנחות פ״‬ט.) וע״‬ש בפירש״‬י שתהא כשרה אחר תמיד של בין הערבים ואחר כל העבודות אלא זו בלבד. וכן אברים ופדרים שמצותן בלילה מתחיל המצוה מן המובחר אחר שקיעת החמה דוקא:
Emor:171	בקסמים ובצרורות. פי׳‬ שלא יפסק עמהם בין הנרות והמנורה:
Emor:172	תמיד כתיב כאן וכו׳‬. פי׳‬ ג׳‬ פעמים תמיד כתיב כפרשה זו. ודורש תמיד אף בשבת. תמיד אף בטומאה תמיד אף למחתה. והנה הדרשה תמיד אף למחתה לא נמצא בת״‬כ. וכוונת המחבר תמיד אף למחתה לענין קטורת שדוחה שבת וטומאה:
Emor:173	סולת מן החטים ט״‬ס וכצ״‬ל. סולת ואפית אותו מלמד שנקחה סולת. ומנין שאפילו מן החטים (היינו בדיעבד) ת״‬ל ולקחת מ״‬מ כצ״‬ל. וכ״‬ה (מנחות עו:) וכ״‬ה בת״‬כ:
Emor:174	כדמפורש במם׳‬ מנחות. דף צ״‬ד:
Emor:175	שני עשרונים יהיה החלה האחת שיהיו שוות כצ״‬ל. פי׳‬ מקודם דריש י״‬ב חלות שיהיו שוות. פי׳‬ שבכולם יהיה סולת ואפוי כתנור. ואח״‬כ דריש שני עשרונים וכו׳‬ שיהיו שוות. פי׳‬ שאיכות שני עשרונים יהיה מסוג אחד לא אחד דק ביותר והשני אינו כן או כשאר שינוי האיכות. עיין אדרת אליהו להגר״‬א ז״‬ל:
Emor:176	לטיפס. היינו לדפוס (פארמע) שאופין בהם. ועיין שם כמנחות בתוס׳‬ ד״‬ה ובדפוס היה עושה. ודריש זה מלשון ושמת ולא אמר ועשית. והיינו ושמת שיעשה כמין דפוס לזה:
Emor:177	יכול שש ושש ושש. פי׳‬ דהוי דרשינן שתים מערכות (של שש) ואח״‬כ סיפא דקרא שש המערכת. וה״‬א ג׳‬ פעמים שש. ועיין בת״‬כ וכן (מנחות צ״‬ח.):
Emor:178	ונתת על המערכת לבונה זכה שתהא ברורה כצ״‬ל. ופי׳‬ הלבונה נצרך להיות ברורה וזכה:
Emor:179	חובה ללחם. שהלבונה היא המתרת את הלחם. והוא במקום קומץ כמו גבי שאר מנחות:
Emor:180	בזיכין שיש להן שולים ונתנן על גבי השולחן בכדי שלא יבצעו את הלחם כצ״‬ל:
Emor:181	קומץ לסדר הזה וקומץ לסדר הזה כצ״‬ל. והיינו על גבי שתי המערכות שתי קומצין:
Emor:182	סדורן של לחם הפנים החדש. ושנים היו נוטלין הישנים משבת שעברה וזהו תמיד וכו׳‬:
Emor:183	לאהרון שלא במחלוקת וכו׳‬ כצ״‬ל. כי כה״‬ג נוטל חלק בראש ולבניו כהנים הדיוטים במחלוקת לכאו״‬א חלקו:
Emor:184	קודש קדשים וכו׳‬. וכמו שדורש למעלה שקאי על החולקין על הכהונה:
Emor:185	מקלל זהו נוקב. ולא המקלל את הדיין:
Emor:186	ועמד וגידף. עיין בפ׳‬ פנחס משפחת החנוכי. ע״‬ש ברש״‬י לפי שהי ו העובדי כוכבים מונין אותם מה אלו מתייחסין על שבטיהן סבורין הם שלא שלטו המצרים באמותיהן אס בגופן היו מושלין ק״‬ו בנשותיהן לפיכך הטיל הקב״‬ה שמו עליהם ה׳‬ מצד זה ויו״‬ד מצד זה (החנוכין מעיד אני עליהם שהם בני אבותיהם וכן אמר דוד (תהלים קכ״‬ב) שבטי יה עדות לישראל וכו׳‬ ע״‬ש. והנה המקלל הזה אחרי שהיה ממזר אזי שם הוי״‬ה אינו מעיד עליו לפיכך עמד וגידף. והבן:
Emor:187	שמצותם. פי׳‬ מחלקוהם:
Emor:188	וכנגדו לשבח. ג׳‬׳‬כ מאותו שבע דן:
Emor:189	ואמרו רבותינו. (סנהדרין מ״‬ב:):
Emor:190	כל השומעים אלו העדים כל אלו הדיינים. הגר״‬א בא״‬א מפרש הא דצריכי השומעים והדיינים סמיכה כמו גבי קרבן דבעי סמיכה כדי שישא עונו עליו וכן גבי שעיר המשתלח וסמך אהרן את שתי ידיו כו׳‬ ונשא השעיר עליו את כל עונותיהם וה״‬נ העדים והדיינים עשו עבירה בשבילו. העדים שאמרו ג״‬כ (כמו שאומר למעלה שלא הרגו בכנוי) והדיינים ששמעו מהעדים. לכך סומכין עליו שישא הוא את עונותיהם. ונכון מאוד:
Emor:191	ערום היה נסקל. דכתיב אותו ולא כסותו עי׳‬ (סוטה כ״‬ג:):
Emor:192	ולא האשה. אותו ולא אותה:
Emor:193	להביא כנענים וכו׳‬. היינו בסייף כדין בן נח.
Emor:194	אף כאן בכרת. והיינו על הכנויים שאומר לעיל באזהרה והיינו כרת:
Emor:195	בעלי דבב לו. פי׳‬ כל העדה יהיו לו שונאים. דכתיב רגום ירגמו אותו כל העדה ואי אפשר לכל העדה שירגמו איש א׳‬:
Emor:196	ק׳‬ וב׳‬ עיקר המלה. ששרשו ק״‬ב:
Emor:197	הרי זה חייב. היינו האחרון עיין (סנהדרין ע״‬ח.) והוא כר״‬י בן בתירא:
Emor:198	הכל לפי מה שהזיק. וזה פי׳‬ נפש תחת נפש לפי שוויה ישלם:
Emor:199	להביא צרם אוזנו  וכו׳‬. דורש מן כאשר עשה כל מה שעשה לחבירו חייב לשלם ולא מום דווקא:
Emor:200	אלא להקיש וכו׳‬. כל המאמר משובש בכאן ועיין (כתובות ל״‬ה:) תנא דבי חזקיה מכה אדם ומכה בהמה מה מכה בהמה לא חלקת בו בין שוגג למזיד בין מתכוין לאינו מתכון לפוטרו ממון אלא לחייבו ממון אף מכה אדם לא תחלוק כו׳‬ לחייבו ממון אלא לפוטרו ממון. וע״‬ש בפירש״‬י דגבי בהמה לעולם חייב דאמרינן (ב״‬ק כ״‬ז) פצע תחת פצע לחייב על השוגג כמזיד כו׳‬. וכצ״‬ל הכא:
Emor:201	ומה בהמה עד שיעשה חבורה. היינו שיזיקנה כי אין בושת שייך בבהמה:
Emor:202	ג׳‬ שמות יש בפסוק זה. לא יכולתי לכוון כי בקרא יש רק שני שמות אני ה׳‬ אלהיכם וצ״‬ע. ונכדי החכם חיים נחמן שי׳‬ תירץ כי כוונתו כי אני ג״‬כ שם הוא עיין (סוכה מ״‬ה.) אני והו הושיעה נא וע״‬ש ברש״‬י בארוכה. והרמב״‬ם בפי׳‬ המשניות שרמז לשם אני מקרא ראו עתה כי אני אני הוא שזה הפסוק בא בשמירת ישראל וישועתם. וכן נראה מהמחבר שכתב אני ה׳‬ המתוועד בסוד ב״‬ד שלכם והוא נכון מאד:
Emor:203	אוי להם לרשעים וכו׳‬. בילקוט מסיים בעוה״‬ז. בעונות היו נמסרין למיתה אבל לעוה״‬ב בלע המות לנצח דכתיב ואתם הדבקים בה׳‬ אלהיכם חיים כלכם היום. וברוך ה׳‬ שעזרני לפרש הפרשה הארוכה הזאת. כן יזכני לגמור אי״‬ה בכי טוב:
Behar:1	כי מי יוכל לשפוט את עמך הכבד הזה כצ״‬ל וע״‬ז קאי דברי המחבר וזהו הכובד וכו׳‬:
Behar:2	לפי שלבות בני האדם וכו׳‬. הכוונה כי גם המושכלות הראשונות אינם שוים בכל אדם:
Behar:3	כל ימי השמה וכו׳‬. כי ע׳‬ שמיטות קלקלו וכנגדן גלות בבל ע׳‬ שנה:
Behar:4	אל הארץ המיוחדת. עיין ת״‬כ הגי׳‬ כי תבואו אל הארץ יכול משכהו לעבר הירדן (שזה נקרא החלת ביאה) ת״‬ל אל הארץ. המיוחדת והיינו א״‬י:
Behar:5	ולא עמון ומואב. שזה לא נתן להם השי״‬ת כדכתיב (דברים כ׳‬) אל תתגר בם מלחמה:
Behar:6	כאו״‬א מכיר את כרמו. וזהו שדך לא תזרע שיהיה ניכר שיהיה שדך:
Behar:7	לס״‬ד שנים עשו יובל. והיינו אחר י״‬ד שנים שכבשו וחלקו. וכגירסא דהכא הוא ג״‬כ בת״‬כ. אולם הגאון ז״‬ל כאדרת אליהו הביא הגי׳‬ לכ״‬א עשו שמטה ולס״‬ג עשו יובל. ומפרש דהיינו בסוף ס״‬ג התחילה שנת היובל. והא דאמרינן לס״‬ג עשו שמטה היינו סוף שנת השמטה משום דשמטה משמט כסופו ויובל בהתחלתו עכ״‬ל.
Behar:8	שאם הביאה התבואה שליש מלפני ר״‬ה אתה כונסה בשביעית כצ״‬ל וכ״‬ה בת״‬כ ופי׳‬ שנתבשלה שליש בשולה לפני ר״‬ה נהשבת התבואה משנה שעברה:
Behar:9	והם חייבין ביעור כפירות שביעית כצ״‬ל דבתר חנטה אזלינן וחניטתן היתה בשביעית.׳‬
Behar:10	ושאר מלאכות של בית דין מותרים. תמוה ואולי צ״‬ל של בית הבדדין מותרים והיינו לתקן בית הבדין בשביעית. וכמו שאומר כל שאינו צורך השדה והכרם מותרין שנצרך דווקא שניהם ביחד לאסור:
Behar:11	לבודדיה. בית הבד קטן כמו עריבה:
Behar:12	להביא פירות שביעית וכו׳‬. אבל להאילן בעצמו מותר לעשות עבודה משיצאה שביעית וזה שנת שבתון יהיה לארץ דווקא. עיין בת״‬כ:
Behar:13	ולא להביא ממנה מנחות ונסכים. שמביא משל אשתקד. אבל העומר ושתי הלחם מביא משל שביעית עיין (מנהות פ״‬ד.) ובתוס׳‬ שם ד״‬ה רחמנא וכן (בכורות י״‬ב:) ע״‬ש:
Behar:14	שאין העשירים אוכלים וכו׳‬. והוא כדברי ר׳‬ יהודה. עיין בת״‬כ:
Behar:15	לרבות את האכסנים. היינו חיל המלך המושל על העיר לפרנסם:
Behar:16	שלא יהיו מעונין. חסר בכאן וכצ״‬ל שלא תאמר שלא יהיו מעונין ביעור אלא פירות הראוין לאדם אבל מאכל בהמה מותר לאצרם וכו׳‬ כצ״‬ל:
Behar:17	ולא שתוציא לח״‬ל. היינו אם יש לך עבדים בח״‬ל לא תוציא פירות שמה להאכילם:
Behar:18	ולא לעשות ממנה זילוף וכו׳‬. כי אסור להפסיד פירות שביעית:
Behar:19	ומשרה וכביסה. כן הוא ג״‬כ בת״‬כ. ועיין (סוכה מ׳‬.) דר׳‬ יוסי פליג ע״‬ז ע״‬ש:
Behar:20	בב״‬ד הדבר תלוי. היינו הסופרים הם ב״‬ד הגדול שבירושלים שהם יספרו בכל שנה ושנה. ולא כל יחיד ויחיד:
Behar:21	יכול השבתות וכו׳‬. פי׳‬ מדכתיב שבע שבתות שנים שה״‬א שקאי על כל שבת ושבת. שיספור עם שנים (כמו שהן) ליובל:
Behar:22	ובה״‬א ויהיו כל ימי האדם אשר חי וכו׳‬. הרי ימיהם שנים:
Behar:23	מלמד שסופר שני היובל. וקאי על הקרא תשע וארבעים שנה. וזה שאומר שסופר שני היובל:
Behar:24	ת״‬ל תרועה שיתקע בשופר תרועה יבבא כצ״‬ל ומה שבנתיים מיותר ע״‬כ הסגרתי במוסגר:<br>כד. שנא׳‬ בעשור לחודש ואפילו בשבת. עיין רש״‬י בחומש ממשמע שנאמר ביוה״‬כ איני יודע שהוא בעשור לחודש אלא שדוחה אה השבת:
Behar:25	מה ת״‬ל שנה וכו׳‬. בכאן הלשון משובש ועיין בת״‬כ וכצ״‬ל וקדשתם את שנת החמשים שנה מה ה״‬ל לפי שנאמר בעשור לחודש וגו׳‬ שיכול אין שנה מתקדשת אלא ביו״‬ד לחודש וכשהוא אומר וקדשתם אח שנה החמשים שנה מלמד שהיא מתקדשת בתחלתה. וע״‬ז קאי מכאן אמר י״‬י בן ברוקה מר״‬ה עד יום הכפורים היו עבדים יושבין וכו׳‬.
Behar:26	יובל היא מ״‬מ. היא מעוטא הוא:
Behar:27	פלוגתא דר״‬י ור׳‬ יהודה ורבנן. עי׳‬ בת״‬כ ועיין (ר״‬ה ט׳‬) הובא דברי רבנן:
Behar:28	הוא שב לשררה שהיה בה. עיין בת״‬כ וכן (מכות י״‬ג.) שזה דברי ר״‬מ ור״‬י פליג ע״‬ז וכן הוא שם פלוגתתם גבי רוצח השב במיתת כה״‬ג מן הגולה. ועיין לקמן בפ׳‬ מסעי בדברי המחבר:
Behar:29	לא שתהא נמשכת וכו׳‬. עיין בת״‬כ שיכול בכניסתה תהי׳‬ מקודשת מר״‬ה וביציאתה תהי׳‬ מושכת והולכת עד יו״‬כ שכן מוסיפין מחול על הקודש (ומה גם בכניסתה עבדים יוצאים רק ביו״‬כ) ת״‬ל יובל היא שנת החמשים שנה תהיה לכם (ולכם מיעוטא הוא) אין קדושתם רק עד ר״‬ה. ועי׳‬ באדרת אליהו:
Behar:30	אע״‬פ שכלה מן השדה מין א׳‬ מהם וכו׳‬ כצ״‬ל. ועי׳‬ בת״‬כ פלוגתא דר״‬א ור״‬י ור״‬ג בזה:
Behar:31	ואי: שביעית מוציאה הנרצעים. דה״‬א ללמוד מק״‬ו עיין ת״‬כ:
Behar:32	שתחזור לאביו ביובל. דה״‬א דאצל בנו נקראת אחוזתו אחרי שהוא יורש את אביו:
Behar:33	אל תונו איש את אחיו או קנה מיד עמיתך דבר הנקנה מיד ליד מכאן אמרו אלו דברים שאין להם אונאה הקרקעות וכו׳‬ כצ״‬ל. ומה שבנתיים מיותר ע״‬כ הסגרתי במוסגר:
Behar:34	לבשם. היינו לצור בהם בשמים שגופו של נייר קנה לו:
Behar:35	כך אונאה לתגר. עיין (ב״‬מ נ״‬א.) בתגר ספסר קאי שקונה ומוכר תמיד שאין אצלו אונאה וע״‬ש כי ר״‬י פליג וסובר שאין אונאה לתגר:
Behar:36	לא שנת שדפון. דכתיב במספר שני תבואות שנים שיש בהם תבואה:
Behar:37	להודיע מה גרם. פי׳‬ כי כל המכירה רק במספר שני התבואה. ולשון להודיע מה גרם תמצא הרבה בדברי המחבר ולפעמים קשה לפרשו:
Behar:38	ולא תונו וכו׳‬ אם היה בעל תשובה וכו׳‬. פי׳‬ כי זה הקרא ולא תונו קאי על אונאת דברים כי אונאת ממון כתיב לעיל אל תונו איש אח אחיו. עיין בת״‬כ:
Behar:39	וישבתם על הארן ולא גולים לבטח ולא מופחדים כצ״‬ל וכ״‬ה כת״‬כ ומלת עליה ט״‬ס מפסוק שלאחריו לכאן:
Behar:40	עתידים אתם לומר. עיין בת״‬כ מכאן סמכו חכמים שיהיו הספיחים אסורים בשביעית מד״‬ת ע״‬ש.
Behar:41	וצויתי את ברכתי לכם בשנה הששית לשביעית ויובל ולמוצאי יובל כסיפא דקרא ועשת התבואה לשלש השנים:
Behar:42	זו תשיעית של אחר היובל. היינו שנת השמטה ואח״‬כ יובל ואח״‬כ תזרעו בתשיעית של אחר היובל. וזמן האסיף הוא בסוכות שלאחר, תשיעית תאכלו הכל מן שנה ששית וזה שמסיים בסופו שתי פעמים ישן זה ישן נושן בן ג׳‬ שנים:
Behar:43	לרבות בתים וע״‬ע. והיינו שיהיו נגאלין בקרובים עיין (קדושין כ״‬א:) בארוכה:
Behar:44	זהו שאמרו וחוטא וכו׳‬. ע״‬כ סמך פרשה זו למעלה:
Behar:45	ולא בל אחוזתו. מאחוזתו מיעוטא הוא למדה תורה ד״‬א שלא ימכור בתחלה כל שדהו אלא מקצתו:
Behar:46	לרבות את הנותן מתנה. את ממכר אחיו את רבויא הוא והיינו שנפדה בקרובים והיינו שנצרך לשום דמי שויה של השדה כמו שהיתה שוה למכירה ולפי השנים שהיתה ביד המקבל מתנה יגרע לו מן הדמים עד יובל:
Behar:47	אלא אין לו קרוב שיכול לגאול כצ״‬ל. והיינו שאין לו קרוב עשיר:
Behar:48	ומכר הראשון לשני במאתים מנין שאינו מחשב אלא עם הראשון וכו׳‬ כצ״‬ל והשאר נמחק:
Behar:49	מנין שאינו מחשב אלא עם האחרון. ת״‬ל לאיש כלומר לאיש שהוא בתוכה דהיינו האחרון כצ״‬ל ובכאן חסר:
Behar:50	דכתיב ושב לאחוזתו לא דברתי וכו׳‬ כל המאמר משובש ועיין בת״‬כ. וכצ״‬ל מכרה לו במנה והשביחה והרי היא יפה מאתים מנין שאינו מחשב אלא מנה ת״‬ל את העודף העודף שבידו (פי׳‬ מה שלקח בשבילה ולא מה ששוה עכשיו) ובערכין ל׳‬ מוסיף עוד מכרה לו במאתים והכסיפה ועמדה על מנה מנין שאינו מחשב אלא מנה ת״‬ל והשיב העודף. העודף הנשאר בקרקע (פי׳‬ מתחלה מדייק מאת העודף דמשמע העודף הידוע. דהיינו במה שלקח. והשתא מדייק מהעודף בלא תיבת את דמשמע מהעודף מה ששוה מהיום עד היובל) כן הוא בת״‬כ ולפי מה שפירש בא״‬א דברי הת״‬כ. וע״‬ז מסיים ושב לאחוזתו יכול אף מוכר ראשון יגאל משני (היינו כסדר הזה) (היינו שיהיה תמיד ידו על העליונה) ע״‬ז מסיים ת״‬ל ושב לאחוזתו בבעל אחוזה הכתוב מדבר ולא במוכר למוכר כצ״‬ל עיין הסוף בת״‬כ. ובכאן משובש ונלקה בחסר ויתיר:
Behar:51	והיה ממכרו וכו׳‬ בכאן חסר וכצ״‬ל והיה ממכרו ביד הקונה אותו עד שנת היובל לא בהקדש עד שנת היובל. אלא מוכר ברחוק וגואל בקרוב ברע וגואל ביפה ולוה וגואל לחצאין וע״‬ז קאי אמר ר״‬ש מה טעם. פי׳‬ דתמיד מצאנו שיפה כח הקדש מכח הדיוט ובכאן הורע כח הקדש בזה. ע״‬ז מתרץ לפי שבהדיוט אם הגיע וכו׳‬ פי׳‬ אחרי כי בהדיוט אם הגיע יובל חוזרת השדה לבעלים אף אם לא פדה אותה ע״‬כ מחמרינן על הבעלים קודם הפדיה שאינו יכול לגאול עד שיהיה כל התנאים הללו שלא ימכור ברחוק וכו׳‬. משא״‬כ גבי הקדש אם הגיע יובל ולא פדה אזי השדה חלוטה להקדש ע״‬כ מקילינן נגד זה לבעלים שיכול לפדות אף בלא תנאים הללו. וכ״‬ה בת״‬כ:
Behar:52	שלא יכניס בה כלום. פי/בהתחלת היובל תיכף בר״‬ה תצא השדה לבעלים לא כמו גבי שמטה שמשמטת בסופה:
Behar:53	ויצא ביובל אף מן ההקדש. פי׳‬ שיוצא ביובל מן ההקדש לכהנים שבאותו משמר כדין שדה חרמים. וכ״‬ה בת״‬כ בהדיא אולם הגר״‬א ז״‬ל באדרת אליהו הגיה ויצא ביובל אף מן הגואל ופי׳‬ אף אם גאלה אחד מן הקרובים כשהגיע יובל יוצאת לבעלים וגירסתו יותר נכונה שבזה מדויק סוף הפסוק ושב לאחוזתו שקאי על הבעלים:
Behar:54	ושב לאחוזתו לרבות את האשה. שאם מכרה שדה אחוזתה חוזרת לה כיובל שדינה כדין האיש לענין זה:
Behar:55	כמס׳‬ ערכין דף ל״‬ב ע״‬א כצ״‬ל:
Behar:56	שאם מכרה לראשון ועמד ומכרה לשני. ואינו ידוע אם שנה לראשון או שנה לאחרון (פי׳‬ דלא ידוע לנו כוונת הקרא שנ״‬ה אם לחשוב לראשון או לאחרון) כשהוא אומר עד מלאת לו שנה הוי שנה לראשון ולא לאחרון כצ״‬ל וכ״‬ה בת״‬כ:
Behar:57	תמימה שס״‬ה ימים. מלת תמימה דריש:
Behar:58	נתעברה לו. היינו למוכר ולא נחלט הבית חומה לקונה עד שיעבור שנה ועיבורו:
Behar:59	הבית הראויה לדירה יצא שדה כצ״‬ל והוא כדברי ר׳‬ יהודה:
Behar:60	אשר לו חומה. (ערכין ל״‬ב.) ועיין מה שכתב ע״‬ז הרב בעל מנחת שי:
Behar:61	יוצא ביובל ובגדעון כסף כצ״‬ל. ופי׳‬ כי יש לו שלש מעלות כשדה אחוזה שיוצא ביובל ובגרעון כסף ויש להם ג״‬כ מעלה של בתי ערי חומה שנפדה לפני ב׳‬ שנים עיין ת״‬כ גם (ערכין ל״‬ג.)ע״‬ש:
Behar:62	ולא גאולת שנים. שאינם כמו בתי ערי חומה שנחלט אחר ב׳‬ שנים. אבל הלוים גואלים לעולם:
Behar:63	כמו לנתין ולממזר. היינו אם בן לוי הוא נתין או ממזר אין דינו כדין הלוים.
Behar:64	ולא עבדים ומטלטלין. כי בזה אין דינם כמו לוי רק בקרקעות גאולת עולם ללוים:
Behar:65	שלא לשנות. היינו שדה מגרש ומגרש שדה כמו שמסיים:
Behar:66	לא ימכר ממכר עולם. חסר הדרשא. ועיין בת״‬כ וברש״‬י בחומש. שאם הקדיש בן לוי שדהו ומכרה גזבר אינה יוצאה לכהנים ביובל כמו גבי ישראל אבל בן לוי גואל לעולם:
Behar:67	נפל לארץ אין מעמידין אותו לכך נאמר והחזקת בו כצ״‬ל:
Behar:68	והעדים וחכ״‬א אף הסופר כצ״‬ל:
Behar:69	את כספך וכו׳‬. (ב״‬מ ס׳‬ וס״‬א.):
Behar:70	תני ר׳‬ ישמעאל בן אלעזר וכו׳‬. (ב״‬מ ע״‬ה) ושם הגי׳‬ ר׳‬ שמעון:
Behar:71	תניא רשב״‬א אומר וכו׳‬. (ב״‬מ ע״‬א.):
Behar:72	הללו מתמומטין ועולין. חסר כאן וע״‬ש בב״‬מ דקא מקשי והא חזינן דלא מוזפי ברבית וקא מתמוטטין ומשני הללו מתמוטטין ועולין והללו כיון שנחמוטטו שוב אינם עולים וכצ״‬ל הכא:
Behar:73	בשכר אגר נטר. עיין כ״‬ז (ב״‬מ ס״‬ה):
Behar:74	כל המקבל עליו עול רבית. היינו שלא להלוות ברבית.
Behar:75	ונמכר לך לך הוא נמכר בתחלה כצ״‬ל ועיין ת״‬כ:
Behar:76	אע״‬פ שנתמכמך. פי׳‬ שהעני.
Behar:77	אבל בבן חורין וכו׳‬. היינו שנשכר לך למלאכה יכול אתה לשכרו לכל מלאכה שתרצה:
Behar:78	אף זה ביומו תתן שכרו. קשה גבי עבד הנקנה מאי שייך גביה ביומו תתן שכרו הרי בעת שנמכר כבר קיבל דמיו. ועפרש״‬י על התורה שפי׳‬ עבודת קרקע ומלאכת אומנת כשאר שכירים התנהג בו. והכוונה שאף שנמכר לו לעבד אבל מלאכת עבודה קרקע ושארי אומנות אינו נצרך לעשות לו. ואם עושה אלו מלאכות חייב ליתן לו שכרו ע״‬ז. וע״‬ז קאי כיומו תתן שכרו. ועיין בק״‬א שהביא בשם רבינו הלל שקאי על שעת שלוחו דכתיב הענק תעניק לו מה שכיר ביומו תתן שכרו אף זה ביום השילוח הענק תעניק לו:
Behar:79	שלא תמסור אומנתו לאחר. פי׳‬ שאם היה האדון בלן או ספר לרבים לא תמסור אומנתך לו שיכול לומר לך לך נמכרתי ולא לאחרים (הגר״‬א בא״‬א) ועיין בת״‬כ. והנה הק״‬א מביא פי׳‬ מרבינו הלל. שפי׳‬ לא תמסור אומנתו לאחרים שאם היה מלומד כאיזה אומנות בל תכפיהו שילמד אומנתו לאחרים והק״‬א דחה דבריו אבל לי נראה דבריו נכונים ופי׳‬ המחבר הזה ג״‬כ כך והראיה שסיים ע״‬ז מכאן אמר רבי אסור לירד לאומנת חבירו:
Behar:80	אף אשתו ובניו. היינו שהיה לו אשה ובנים מכבר. או שנשא אשה מדעת רבו:
Behar:81	זה שנמכר שנה וכו׳‬. עיין בת״‬כ אראב״‬י כמי הוא מדבר (היינו קרא דהכא) אם בנרצע הרי אמור ואם במוכר עצמו הרי אמור הא אינו מדבר אלא במכרוהו ב״‬ד שנה או שנתים לפני היובל שהיובל מוציאו. וכן הכוונה הכא אלא שחסר:
Behar:82	ישוב לרבות את האשה. בת״‬כ ליתא. כי מכרוהו ב״‬ד לא שייך באשה כי אינה נמכרת בגניבתה. ולפי גירסא דהכא צ״‬ל כשמכרה אביה בעודה קטנה. ובהגיע יובל תצא מרשות האדון. ובאדרת אליהו גורס ישוב לרבות הרוצח והוא לעניו שאינו שב לאותו שררה,. ולא ידעתי כוונתו כי גבי רוצח כתיב קרא אחריני בפרשת מסעי ושב אל משפחתו וצ״‬ע:
Behar:83	מגיד לך הכתוב שתזכה וכו׳‬. בת״‬כ הגי׳‬ שמא תאמר הואיל ואסרת לנו כל אלה במה נשתמש ת״‬ל ועבדך ואמתך אשר יהיו לך מאת הגויה וגו׳‬ וכן כוונה דהכא:
Behar:84	מה אמה אין לה קדושין. דכתיב האשה וילדיה תהיה לאדוניה ואינה צריכה גט מהעבד כשיוצא לחירות:
Behar:85	אף עבד אין לו קדושין. היינו עבד כנעני:
Behar:86	להביא א׳‬ מן הכנענים וכו׳‬ שאתה מותר לקנותו וכו׳‬. כגי׳‬ דהכא הוא ג״‬כ בת״‬כ אולם (יבמות ע״‬ח:) (סוטה ג׳‬:) (קדושין ס״‬ז:) הגירסא אסור אתה לקנותו וצ״‬ע:
Behar:87	אף עבדים. היינו עבד כנעני:<br>פז. והיא עצמה מנין. היינו קרקעות:
Behar:88	אבל אתה רודה בבן חורין. היינו שכיר מותר לעבדו בכל עבודת עבד:
Behar:89	לרבות כל הגאולות כצ״‬ל והיינו קרוב קרוב קודם:
Behar:90	והשב עם קונהו ידקדק עמו כצ״‬ל שיעשה עמו חשבון צדק:
Behar:91	ואינו מחשב עם היורשים. כי כמיתת האדון הגוי יוצא לחירות.
Behar:92	והיה כסף ממכרו. ככסף הוא נגאל ואינו נגאל בתבואה וכלים. כגי׳‬ דהכא כ״‬ה ג״‬כ בת״‬כ. וכ״‬ה בא״‬א ג״‬כ. ועיין (קדושין ח׳‬.) דורש מקרא דלהבא מכסף מקנתו בכסף הוא נקנה ואינו נקנה בתבואה וכלים. ועיין בילקוט מביא גי׳‬ הת״‬כ והיה כסף ממכרו בכסף הוא נמכר ואינו נמכר בתבואה וכלים. ועיין שם בקדושין שמקשה אילימא לא מקני כלל הא כתיב ישיב גאולתו אפילו שוה כסף. וע״‬ש שמסיק שקאי על קנין חליפין או על פחות משוה פרוטה. ועכ״‬פ על גירסא שלנו הרבה צ״‬ע יש א׳‬ מה שמשני שמביא הקרא מכסף ממכרו ולא מכסף מקנתו כמו שהוא בקדושין. ועוד יותר ככסף הוא נגאל ואינו נגאל בתבואה וכלים הלא ישאר קושיית הגמ׳‬ ישיב לרבות אפילו שוה כסף אם לא שנאמר שט״‬ס נפל בת״‬כ וכן בדכרי המחבר וצ״‬ל בכסף הוא נמכר כמו שהוא בילקוט:
Behar:93	ולענין לפיהן וכו׳‬ מכסף מקנתו אף שכיר האמור בישראל כשהוא גואל ידו על העליונה כדמפורש למעלה כצ״‬ל:
Behar:94	ור״‬ע אומר חילוף הדברים. במסכת קדושין ט״‬ו ע״‬ב ע״‬ש:
Behar:95	אין זה מדבר וכו׳‬. בכאן חסר ועי׳‬ (קדושין ט״‬ו ט״‬ז) וכ״‬ה בת״‬כ ויצא בשנת היובל הוא ובניז עמו ככנעני שתחת ידך הכתוב מדבר (כי כיון שגלו בטלו היובלות) א״‬כ החמירה התורה על גזילו של כנעני וכו׳‬ כצ״‬ל ובכאן חסר:
Bechukotai:1	מלמד שהקב״‬ה מתאוה וכו׳‬. דורש אם בחוקותי כמו שהיה כתוב מי יתן אם בחוקתי תלכו:
Bechukotai:2	ברביעית. היינו בלילי רביעית שאין בני אדם בדרכים עיין (פסחים קי״‬ב:) לא יצא יחידי בלילה בליל רביעית ובלילי שבתות:
Bechukotai:3	בארץ ובח״‬ל. בת״‬כ הגי׳‬ בארצכם אתם יושבים לבטח ואי אתם יושבים לבטח בח״‬ל:
Bechukotai:4	שיהיו נופלין איש בחרב רעהו. דורש ונפלו לפניכם לחרב היינו לפני קודם שתלחמו יפלו איש,בחרב רעהו:
Bechukotai:5	אפנה מכל האומות. היינו לשלם להם שכר מועט עבור מע״‬ט מועטים שעשו:
Bechukotai:6	מלמד שכל המתיישן. בת״‬כ מסיים עוד אין לי אלא יין שדרכו בכך (שישן טוב מן החדש) מנין לרבות כל המתיישנים ת״‬ל ישן נושן:
Bechukotai:7	יכול שיהיו עבדים לעבדים. חסר ועיין בת״‬כ וכצ״‬ל לפי שנאמר ויפדך מבית עבדים יכול שהיו עבדים לעבדים. ת״‬ל מהיות להם עבדים עכדים היו למלכים ולא עבדים לעבדים:
Bechukotai:8	למדרש חכמים. היינו תורה שבע״‬פ שע״‬ז שייך לשון שמיעה:
Bechukotai:9	וסוף שהוא מונע את האחרים וכו׳‬. דורש לבלתי עשות שימנע אחרים מלעשות:
Bechukotai:10	ואם מוציאין המת לקברו. עיין ברש״‬י בחומש. כי בירושלים אינם מלינים המתים. וזה שסמך ושלחתי דבר בתוככם (ונצרך להם להוציא המת חוץ לירושלים לקברו) ועי״‬ז ונתתם ביד אויב:
Bechukotai:11	ומשקלו בדעתו. דורש במשקל שמשקל בדעתו איזה דבר יכול לקנות ויהיה שבע:
Bechukotai:12	להביא בנים וכו׳‬. תאכלו דריש כי יתר הוא:
Bechukotai:13	לרבות דרכים ומחוזות כצ״‬ל:
Bechukotai:14	והשמותי את מקדשיכם. בת״‬כ לרבות בתי כנסיות ובתי מדרשות:
Bechukotai:15	לטובתן של ישראל. עיין (ע״‬ג י׳‬:) גבי מעשה דקטיעה בר שלום:
Bechukotai:16	כנגד ימים שעברתם וכו׳‬. כי ע׳‬ שנים גלות של בבל כנגד שנות השמטה והיובלות שבטלו ישראל. עיין בא״‬א להגר״‬א ז״‬ל מאריך בזה החשבון:
Bechukotai:17	בימי ר׳‬ יהושע בן יהודה. כת״‬כ הגי׳‬ ר״‬י בן קרחה. פעם א׳‬ היינו יושבין בין האילנות ונשבה הרוח ועמדנו ורצנו ואמרנו אוי לנו שמא ידבקנו הפרשים לאחר זמן נפנינו לאחריו ראינו שאין בריה אחרינו וכו׳‬ ובכינו ואמרנו שנתקיים בנו הקרא ורדף אתכם קול עלה נדף:
Bechukotai:18	והעולה על רוחכם. וסיפא דקרא אם לא כיד חזקה אמלוך עליכם:
Bechukotai:19	שנאמר אם בחקותי. מתחיל באל״‬ף ומסיים קוממיות בתי״‬ו:
Bechukotai:20	והאלות הם ח׳‬ אותיות. מן ו׳‬ ואם לא תשמעו. וסוף והם ירצו אה עונם במ״‬ם:
Bechukotai:21	והאלות הם כ״‬ב. היינו כל האלפ״‬א בית“א וי״‬ו עד ה״‬א לחשוב למפרע הא״‬ב:
Bechukotai:22	בני ישראל מעריכין ולא הכנענים מעריכין יכול לא יהו נערכין ת״‬ל איש לרבות דברי ר״‬מ כצ״‬ל. ופי׳‬ אם הכנעני אמר ערך ישראל עלי לא חל עליו תורת ערכין ואם ישראל אמר ערך פלוני כנעני עלי חל עליו תורת ערכין:
Bechukotai:23	ואינו נותן ערך אבריו. היינו באבר שאין הנשמה תלויה בו:
Bechukotai:24	שאם העריך מאה נפשות. היינו אפי׳‬ בדבור אחד וזה נפשות לשון רבים:
Bechukotai:25	ד״‬א נפשות להביא את האשה שיכולה להעריך כמו איש כצ״‬ל:
Bechukotai:26	במס׳‬ ערכין. (דף ב׳‬):
Bechukotai:27	מה שנת ששים כלמטה הימנה. דכתיב בהדיא בקרא ואם מבן ששים ומעלה:
Bechukotai:28	תנן התם אין בערכין. (ערכין ז׳‬:) ואע״‬פ שהוא לקולא שערכו פחות:
Bechukotai:29	נותן ערך דמיו. היינו כעבד הנמכר בשוק (ערכין ה׳‬.) ואין שם פלוגתא בזה:
Bechukotai:30	פרט למת. בת״‬כ ממעט ג ״‬כ הגוסס שאינו בכלל העמדה והערכה:
Bechukotai:31	המטלטלין בשלשה. היינו הערכין המטלטלין (ערכין ט״‬ו).
Bechukotai:32	ואם הביא ב׳‬ שערות קודם הזמן הזה הוי שומא בעלמא ואינו סימן גדלות כצ״‬ל:
Bechukotai:33	אם אמר רגלה וכו׳‬. (תמורה י״‬א):
Bechukotai:34	ה״‬ד אי הקדיש וכו׳‬. עיין כ״‬ז (תמורה ט׳‬):
Bechukotai:35	ובאמר אותו אחר. היינו מי שהקרבן שלו.
Bechukotai:36	ומאי משמע דלא יחליפנו  וכו׳‬. עיין ברש״‬י שם בתמורה:
Bechukotai:37	תרווייהו מיותרין כצ״‬ל:
Bechukotai:38	ואביי אמר משיב ק״‬ו וכו׳‬. חסר בכאן דברי רבא. וע״‬ש בתמורה כי רבא סובר בין טוב ברע ובין רע בטוב עושה תמורה גם דברי אביי אינם מכוונים בכאן ע״‬ש בתמורה ובכאן אינו מדוקדק:
Bechukotai:39	אלא אחד באחד שנא׳‬ והיה הוא ותמורתו יהיה קודש מה הוא מיוחד אף תמורתו מיוחדת כצ״‬ל:
Bechukotai:40	אלא שאם הימר מומר וסופג את הארבעים כצ״‬ל:
Bechukotai:41	לרבות את המתה. פי׳‬ שהקדיש אותה לאחר מיתתה הרי היא קדושה לדמיה ותפדה כשאר מטלטלין:
Bechukotai:42	אין לו עריכה. שאין פודין את הקדשים להאכילן לכלבים אבל גבי קדשי ב״‬ה סובר ר״‬ש אם מתו יפדו עיין (ערכין ל״‬ב):
Bechukotai:43	לרבות האשה כו׳‬ לרבות היורש. פי׳‬ שגם הם מוסיפין חומש:
Bechukotai:44	מה מצאנו בגאולות האמורות למטה כצ״‬ל היינו גבי מקדיש ביתו הבעלים מוסיפין חומש:
Bechukotai:45	ואיש כי יקדיש את ביתו קודש יכול דווקא בבית דירה הכתוב מדבר אבל לא שאר נכסיו כשהוא אומר לקמן ואם המקדיש יגאל את ביתו הרי ביתו אמור הא מה אני מקיים כצ״‬ל:
Bechukotai:46	מלמד שסתם הקדשות לבדק הבית. פי׳‬ מדכתיב קודש לה׳‬ הוא הקדש ב״‬ה שכולו לה׳‬ לא כן קדשי מזבח שיש מהם שנאכל לכהנים:
Bechukotai:47	הבעלים נותנים כו׳‬. היינו כ״‬א שאמר האחר וה׳‬ שמוסיף חומש על מה שנתן בעצמו עשרים. ויהיה ביאור הכתוב כאשר יעריך אותו הכהן היינו איש אחר לפני הכהן כן יקום על הבעלים (הגר״‬א ז״‬ל בא״‬א) ועיין (ערכין כ״‬ז ע״‬ב):
Bechukotai:48	ואם לאו אינו שלו. פי׳‬ דהקדש נקנה דוקא בכסף ולא במשיכה:<br>מח. שהוא חצי מעה. היינו פונדיון א׳‬ ומשקלה ששה שעורים כסף עיין שקלים פ״‬א וברע״‬ב שם:
Bechukotai:49	שאם הקדישו מופלג מן היובל. פי׳‬ בקרא כתיב אחר היובל משמע סמוך ליובל וכשכתב ואם אחר היובל הוי״‬ו בא לרבות מופלג מן היובל:
Bechukotai:50	וכן לענין מקח וממכר כצ״‬ל. עיין (ב״‬ב ק״‬ב:) גבי בית כור עפר אני מוכר לך ג״‬כ דינא הכי דנקעים י׳‬ טפחים נמדדין עמה:
Bechukotai:51	שאין מחשבין חדשים להקדש. עיין בת״‬כ וכן (ערכין כ״‬ה.) שאם בא לגואלה חמש שנים וחצי לפני היובל אין מחשבין החדשים לחצי שנה אלא משלם עבור ששה שנים שלמים ו׳‬ סלעים וגם ו׳‬ פונדיות ע״‬ש ברש״‬י אבל הקדש מחשב חדשים. דהיינו אם היה עד היובל רק שנה וששה חדשים אינו נחשב כמו ב׳‬ שנים שיפדה בשני סלעים ושני פונדיונות אלא דינו כמו פחות משתי שנים שאינו יוצא בגרוע ונצרך לו לשלם הכל כל זרע בית חומר בחמשים שקל:
Bechukotai:52	ונגרע מערכך אף מן ההקדש שאם אכלה ההקדש שנה או שנתים לפני היובל או לא אכלה מנכה סלע ופונדיון בכל שנה ושנה כצ״‬ל וכ״‬ה בת״‬כ והכוונה דלא תאמר מה שמגרע לפי ערך. היינו מה שהיתה השדה בידו אבל השנים שהיתה ביד ההקדש אינו מגרע ובפרט אם הובירה הגזבר ת״‬ל ונגרע מערכך אף השנים שהיתה ביד ההקדש ינכה סלע ופונדיון לכל שנה:
Bechukotai:53	בא לרבות בית לתך. דורש שדה מ״‬מ אף שדה קטנה:
Bechukotai:54	אם נתן הכסף. כדלעיל דגבי הקדש דוקא כסף קונה ולא משיכה:
Bechukotai:55	ליעידה ועבד עברי. פי׳‬ האמה יכול ליעדה לבנו ואינו צריך כסף קדושין אלא באותו כסף שנתן אביו בשעה שקנאה. ועבד עברי עובד רק את הבן ולא את הבת והאח ושאר יורשין:
Bechukotai:56	וקשה אדרבה. זו קושיית הגמ׳‬ בערכין שם:
Bechukotai:57	מכלל דבן עדיף. ע״‬ש בתוס׳‬ ד״‬ה כלום יש יבום:
Bechukotai:58	לכמות שהיתה אינה נגאלת. היינו כמו שדה אחוזה. וזה דריש מלא יגאל עוד שתהיה לפניו כשדה אחוזה שאינה יוצאת ביובל אבל יכול ללוקחה מיד הגזבר שתהיה כשדה מקנה ותצא ביובל:<br>נח. והיא נקראת שדה רטושין עד היובל השני הגיע היובל השני ולא נגאלה נקראת רטושי רטושין עד היובל השלישי לעולם אין הכהנים נכנסין לתוכה עד שיגאלה אחר כצ״‬ל וכ״‬ה בת״‬כ וטעם פלוגתם עי׳‬ (ערכין כ״‬ה:) דבר שאינו שלו שיוצאת ביובל לבעלים הראשונים:
Bechukotai:59	ובמה שויו כענין האמור למעלה. עיין בת״‬כ שזה דברי ר״‬א אבל חכמים פליגי וסוברים שוויה ממש:
Bechukotai:60	מלמד שלא ישהה. ביום ההוא דריש שימכור תיכף עי׳‬ (ערכין כ״‬ד:):
Bechukotai:61	לאשר קנהו מאתו. והיינו הכהנים שהם כעת הבעלים:
Bechukotai:62	אין בערכין פחות מסלע. פי׳‬ שאם לא נתן סלע שלם לא יצא ידי נדרו ואם העשיר חייב לשלם הכל (ערכין ז׳‬:):
Bechukotai:63	למדך כמה הוא סלע. היינו שלא יהיה פחות מכ׳‬ גרה. ועיין בת״‬כ אם הגדיל הסלע יותר מכ׳‬ גרה נותן כפי שהוא:
Bechukotai:64	בבהמה וכו׳‬. לא הבעלים ולא אחרים. עיין בת״‬כ וכן (תמורה כ״‬ה.) אילו נאמר בכור לא יקדיש הייתי אומר בכור לא יקדיש הקדשות ת״‬ל לא יקדיש איש אותו אותו אי אתה מקדיש אבל מקדיש אדם בכור הקדשות (פי׳‬ דאך בכור קאי על הבהמה ולא על אדם בכור) ועדיין אני אומר הוא לא יקדיש אכל יקדשהו אחרים (פי׳‬ דה״‬א דווקא בכור אדם אינו יכול להקדיש בכור בהמה אבל אחרים שאינם בכורים יכולים להקדיש בכור בהמה) ת״‬ל בבהמה וכו׳‬ ע״‬ש וכן יהיה כוונת המחבר הכא שאמר לא הבעלים ולא אחרים:
Bechukotai:65	שאין משנין כו׳‬. כגון מן חטאת עולה ולהיפך:
Bechukotai:66	כגון הקדש מזבח. תפס הקדש מזבח דווקא אינו חל עליו אבל הקדש עילוי היינו הקדש בדק הבית חל עליו והוא כדברי ר״‬י (ערכין כ״‬ט.):
Bechukotai:67	שנאמר את דמם תזרוק. גבי בכור כתיב:
Bechukotai:68	וכי יהיה בו מום. דריש ג״‬כ האי קרא מדברים גבי בכור הכא:
Bechukotai:69	ונמכר בערכך לכל אדם. היינו לאחרים אם אין הבעלים פודין:
Bechukotai:70	ומבהמה ולא כל בהמה. עיין בערכין שם דבהמה מגלה לנו הקרא כמו בהמה שיש לו רשות למוכרה תמיד כי גופה קנוי לו. כך אדם דווקא עבד כנעני שגופו קנוי לו.׳‬
Bechukotai:71	ומשדה ולא כל שדה. היינו שדה מקנה אינו יכול להחרים שאינו שלו שיוצאת לבעלים ביובל:
Bechukotai:72	לא ימכר לגזבר ולא יגאל לבעלים. אלא הכל לכהן שסובר שסתם חרמים לכהן:
Bechukotai:73	אמר ריב״‬ב מכאן וכו׳‬. פליג אלמעלה וסובר שסתם חרמים לבדק הבית (ערכין כ״‬ח:):
Bechukotai:74	ר׳‬ חנניה בן עקביא אומר כצ״‬ל:
Bechukotai:75	לרבות זרע השום וכו׳‬. שחייבין במעשר שני:
Bechukotai:76	לרבות כל פירות האילן. דה״‬א כי לא נתחייב במעשר רק דגן תירוש ויצהר כדכתיב בפ׳‬ ראה:
Bechukotai:77	לרבות האשה והיורש. שגם הם מוסיפין חומש:
Bechukotai:78	ולא מעשר חבירו. הפודה מע״‬ש של חבירו אינו מוסיף חומש:
Bechukotai:79	שנכנס לירושלים ויצא. דשוב אין לו פדיון. אלא מכניסן עוד הפעם ואוכלן שם:<br>עט. פרט לטריפה שאינה עוברת. עיין (בכורות נ״‬ז) פרש״‬י דבהמה שנחתכו רגליה מן הארכובה ולמעלה וזו אחת מי״‬ח טרפות ואינה עוברת ברגליה. וכ״‬ה כרש״‬י (חולין קל״‬ו: ובמנחות ו׳‬.) פירש״‬י שאינה עוברת שאינה חיה. ול״‬נ פרט לטרפה שאינה עוברת הכוונה שאינה נעשה מעוברת כי טרפה לא ילדה עיין (חולין נ״‬ז:) ודריש כל אשר יעבור כמו עובר:
Bechukotai:80	אמרו משום ר׳‬ מאיר כצ״‬ל. פי׳‬ רבי שסידר המשנה כתב אמרו משום ר׳‬ מאיר וע״‬ז שייך המאמר אפילו רבי דענוותן הוה וכו׳‬:
Bechukotai:81	אילו היה תמורה לא היה קרב. דתמורת מעשר לא קרבה עיין (בכורות ס׳‬):
Bechukotai:82	יכול יהיה מחפש ומוציא היפה. פי׳‬ דה״‬א שיצמצם שהעשירי של מעשר יהיה היפה ת״‬ל לא יבקר בין טוב לרע שאינו נצרך לבקר:
Bechukotai:83	למדנו שאם המיר. חסר וכצ״‬ל ולא ימירנו למדנו שאם המיר סופג מ׳‬ ולא הוי לאו הניתק לעשה עיין תמורה ד׳‬ ע״‬ב:
Bechukotai:84	בבכור הוא אומר לא תפדה כצ״‬ל בפ׳‬ קרח אך בכור שור וגו׳‬ לא תפדה אבל נמכר פי׳‬ הכהן יכול למכרו לאחר והוא יאכלנו בקדושת בכור כשיומם או בזמן שהבית קיים יקריבנו אבל במעשר אסור אף למכור כדמסיים:
Bechukotai:85	מכאן שמעשר בהמה וכו׳‬. פי׳‬ דלא מצאנו בהדיא בקרא בחיוב שיעשר הבהמות אלא אמר וכל מעשר בקר וצאן וכו׳‬. וע״‬ז קאי דברי רבי אלה המצות וכו׳‬ מכאן שמעשר בהמה בעמוד ועשר קאי. ועי׳‬ בת״‬כ עוד דרשות כזה ולומד ג״‬כ ממלת עשר תעשר אחד מעשר בהמה ואחד מעשר תבואה. וה׳‬ ימן שיקוים בנו עשר תעשר עשר בשביל שתתעשר: זכני ה׳‬ לסיים הביאור על ויקרא על פסיקתא זוטרותא. והנני מחנן ומבקש מהשי״‬ת שיזכני ג״‬כ לגמור על סדרים הבאים ולא אכשל בדבר הלכה. ויקויים בי מקרא ואני זאת בריתי וגו׳‬ לא ימושו מפיך ומפי זרעך וגו׳‬ מעתה ועד עולם. יום ד׳‬ כ״‬ד מנחם אב שנת כה׳‬ תברכ״‬ו את בני ישראל, פה בריסק דליטא.