Yeriot Shlomo on Torah, Bereshit 1	@11בד"ה ומה טעם כו' ולפי זה כו' @22נ"ב ולי נראה דה"ק אפילו אם ת"ל שמחוייב להתחיל בספירת האבו' ותולדותיהן איך נתייחסו ולספר כל מקרה שלהן וכל גילגוליהן עד שקבלו התורה ס"ס מ"ט פתח בבראשית ודוק מהרש"ל 	Mizrachi, Genesis 1:1:3
Yeriot Shlomo on Torah, Bereshit 2	@11בד"ה משום כח כו' הוא משכר כו' @22נ"ב ולי נראה דאם ירושת הארץ היתה גזילה ובמול ח"ו א"כ תפול התורה וישראל בכללה ודוק מהרש"ל. 	Mizrachi, Genesis 1:1:4
Yeriot Shlomo on Torah, Bereshit 3	@11בד"ה בראשית כו' אפשר לפרש @22נ"ב ונ"ל דה"ק אף אם תרצה לדרוש אחר פשוטו מ"מ מוכרח אתה להודו' מה שדרשו רבותינו דאם לא כן למה לא כתבה התורה כפשוטה או לא היה לו לכתוב אלא בבריאת אלהים את השמים ואת הארץ כו' ודוק מהרש"ל. 	Mizrachi, Genesis 1:1:8
Yeriot Shlomo on Torah, Bereshit 4	@11בד"ה ה"ג בראשית כו' ואחר זה יבאר @22נ"ב ואני קבלתי דה"פ תחילת בריאת של שמים וארץ כלומר צורך ותיקון שלהם כאשר היותם תהו ובהו כו' מה היתה תחילת הבריאה אור כלומר דרך משל אם החדר בנוי כל ד' דפנות ועדיין לא בנוי מבפנים מה תחילת בניינו החלונות ומשום הכי כתב ויאמר הקב"ה שהוא הבנאי האמיתי יהי אור ודוק מהרש"ל:	Mizrachi, Genesis 1:1:10
Yeriot Shlomo on Torah, Bereshit 5	@11בד"ה בראשי' כו' והרי"ש בחולם @22נ"ב גם בנוסחא שלנו אינו כן מהרש"ל:	NULL
Yeriot Shlomo on Torah, Bereshit 6	@11בד"ה ולא נאמר כו' שאמר בסוף @22נ"ב ותימה א"כ מה היינו דקאמר רש"י אחר כך ודוק לכן נ"ל דה"ק ע"כ לא ברא את העולם במדת הדין דא"כ כבר היה העולם כלה ולא היה ארך אפים ושום ריצוי אלא ע"כ בהכרח ברא השם במדת הרחמי' א"כ למה לא נאמר ברא יי' ודוק מהרש"ל:	Mizrachi, Genesis 1:1:17
Yeriot Shlomo on Torah, Bereshit 7	@11בד"ה תהו שאדם כו' אינו פי' של מלת ובהו כו' @22נ"ב אבל לי נראה שודאי רש"י פי' אחר דקדוק לשון הקודש ואל תשגיח בדברי אונקלוס או בדברי ב"ר שהם מפרשים לפי תואר הענין ובעבור זה פי' רש"י ריקות וצדות כלומר להודיע שלשון צידות שפי' התרגום על תהו אינו לפי דקדוק לשון הקודש אלא אף הוא משמש בבהו אבל תהו לשון המתאה את האדם ומשמם אותו בבלבול הדעת ואינו כלשון שממה שנופל עליו ריקות ודוק מהרש"ל:	Mizrachi, Genesis 1:2:1
Yeriot Shlomo on Torah, Bereshit 8	@11בד"ה כסא הכבוד כו' שלא יתכן לפרש כו' @22נ"ב ולי נראה שעל הרוח ממש של הקב"ה אינו שייך לו יחוד מקום וגבול מה שאין כן בכסא הכבוד לפי דעת המקובלים ואל תשגיח בדעת הפילוסוף ודוק והעיקר נראה בעיני שאין שייך לומר רוח אצל השם אם לא כשמשפיע על האדם אבל לא שיהיה עומד בעצמו כמו כאן ורוח אלהים מרחפת על פני המים דאם כן הוה מורכב הוא והרוח שבו ודוק הטיב מהרש"ל:	Mizrachi, Genesis 1:2:3
Yeriot Shlomo on Torah, Bereshit 9	@11בד"ה לפי סדר כו' בב"ר אמרו כו' @22נ"ב פי' מאחר שלא כתב שני ימים ג' ימים ודוק מהרש"ל:	Mizrachi, Genesis 1:5:1
Yeriot Shlomo on Torah, Bereshit 10	@11בד"ה שאף על פי כו' ברא את @22נ"ב אין צורך לפי מה שפרשתי לעיל מהרש"ל:	Mizrachi, Genesis 1:6:1
Yeriot Shlomo on Torah, Bereshit 11	@11בד"ה בתוך המים כו' איננו באמצע כו' @22נ"ב ואני אומר לשם נמי היו באמצע דאל'כ היו יורדין עד התהום והיו מאריכין בהילוכן זמן רב ודוק ומה שלא פירש התרגום באמצע הים דא"כ הוי משמע אמצעית הים בשטח ארכו ורחבו ודוק מהרש"ל:	Mizrachi, Genesis 1:6:3
Yeriot Shlomo on Torah, Bereshit 12	@11בד"ה כמו ועשתה כו' אין זה סותר נ"ב @22ואני אומר זה תיקון שלה שתהיה אחר כך מותרת לבעלה מהרש"ל:	Mizrachi, Genesis 1:7:2
Yeriot Shlomo on Torah, Bereshit 13	@11בד"ה על הרקיע לא נאמר אלא מעל כו' @22נ"ב דומיא דמתחת לארץ דג"כ לא נא' תחת ודוק מהרש"ל:	Mizrachi, Genesis 1:7:3
Yeriot Shlomo on Torah, Bereshit 14	@11בד"ה ואין זה סותר @22נ"ב וא"ל הלא כבר שמעינן מתוך המים כו' וי"ל דה"א שהוא באמצע דהיינו עובי המים שהיו על השמי' מגיע גובהן לשיעור גבהות השמים מהמים התחתונים ודוק מהרש"ל:	NULL
Yeriot Shlomo on Torah, Bereshit 15	@11בד"ה שלא נגמרה כו' @22נ"ב נ"ל דהכי הקשר ברש"י בשלמא אי הוי המים אשר מעל השמים ממש ולא היו רחוקים מן הרקיע כמו המים אשר מתחת א"כ היה קנאה במעשה בראשית משום הכי לא נאמר כי טוב אבל עכשיו קשה ודוק מהרש"ל:	Mizrachi, Genesis 1:7:4
Yeriot Shlomo on Torah, Bereshit 16	@11בד"ה שא מים כו' ונקרא כן כו' @22נ"ב ונ"ל שכך ההצע' ברש"י שמים אנו קוראין שא מים בקמ"ץ וא"כ הוי פירושו שא מים טעון מים והיינו שם מים כר"י בר חנינא א"נ שא מים פירש אש ומים כתנא דמתני' ושא מתחלף באש כלא באל ודוק מהרש"ל:	Mizrachi, Genesis 1:8:1
Yeriot Shlomo on Torah, Bereshit 17	@11בד"ה אינו דומה כו' מימי בראשית כו' @22נ"ב ולא שנפרש לאו דוקא אוקיינוס קאמר מהרש"ל:	Mizrachi, Genesis 1:10:1
Yeriot Shlomo on Torah, Bereshit 18	@11בד"ה לא דשא כו' שנ"ל שאינה כו' @22נ"ב ולי נראה דלק"מ דכי היכי שכתב מינים שייך נמי לשון דשאים כמו מיני בגדים ודוק מהרש"ל:	Mizrachi, Genesis 1:11:1
Yeriot Shlomo on Torah, Bereshit 19	@11בד"ה שיגדל כו' בסוף הדיבור @22נ"ב יתור מהרש"ל ור"ל כל הדיבור מיותר:	Mizrachi, Genesis 1:11:2
Yeriot Shlomo on Torah, Bereshit 20	@11בד"ה ועץ פרי הוסיף ו' כו' @22נ"ב ולי נרא' שבתחלה אמת בלא ו' כי באמת שניהם היו ראוים להיות שוים ביצירתן שהרי הקלחים של עשבים הם ראוים לאכילה אף עתה כן היה גזירת הש"י על העץ אבל בפעולה לא היו שוים ודוק. ומ"ה כתב למינהו ומ"ה אפש' לא הוציא' דלמד' ק"ו מעשבי' שראוין הקלחין לאכילה ואפ"ה אינו שוה טעמו כו' ק"ו בעצי אילן כו' ואפ"ה נענשה דבהדי כבשי דרחמנא למה לך מהרש"ל:	NULL
Yeriot Shlomo on Torah, Bereshit 21	@11בד"ה נפקדה על עונה כו' @22נ"ב ולי נראה שעיקר קללת האדמה שמוכרחת להוציא גידולין חוץ לטבע ואם כן לפי מעשיה היה לקללה שהוציאה חוץ לטבע בעילוי יותר ולא בגריעו' רק שקללת האדמה גרמה לגריעות ומשום קללת האדם לבד בלא חטאה לא היתה נקלל רק בכינוי אחר כמו שאומרים העולם אבל להיותה נלקית באמת אינו בלא חטא ודוק מהרש"ל:	Mizrachi, Genesis 1:11:4
Yeriot Shlomo on Torah, Bereshit 22	@11בד"ה אבל בשבעה כו' ואין זאת טענה כו' @22נ"ב ואני תמה על תמיהת הרמב"ן כי בודאי רש"י כיון באמרו שבעת ימי בראשית מקצת ימים ולא כולן ודרך בראשי' רבה ומ"ה לא אמר שבעה ימים הראשונים ודוק מהרש"ל:	Mizrachi, Genesis 1:14:5
Yeriot Shlomo on Torah, Bereshit 23	@11בד"ה עוד זאת ישמשו שיאירו כו' @22נ"ב נראה לי לפרש שיאירו לעולם כלומ' לא די שהם העדרת החושך כיום המעונן אלא אפי' יאיר כאלו אדם מאיר בנר לרבים דהיינו בעת זריחתה ומ"ה אמ' לעולם במקום לארץ ודוק מהרש"ל:	Mizrachi, Genesis 1:15:1
Yeriot Shlomo on Torah, Bereshit 24	@11בד"ה נפש חיה כו' לא נפש החיה כו' @22נ"ב ולי נראה שקשה לרש"י דלא תימא שהמים ישרצו ויפעלו נפש חיה כי החיות לא בא אלא מן יוצר הכל ולא מן האדמה ודוק ומה שרש"י פי' בפעם השנית נפש שיש בה חיות היינו משום דדייק לישנא דנפש החיה ה"א המורה כלומר אותו נפש שיש בה חיות ובפעם השלישית גבי אדמה פי' שיש בה חיות ולא אמר שיהא בה חיות אע"פ שגם הוא ציווי נ"ל משום דנפש הוא הגוף בלא חיות ועל המים אמר שיהא כלומר שלא תוציא שום גוף וגוש בלי שיהא בה חיות אבל גבי אדמה שמוציאה כמה גושים וגידולין בלי חיות מוכרח לפרש שיש בה חיות ודוק מהרש"ל:	Mizrachi, Genesis 1:20:1
Yeriot Shlomo on Torah, Bereshit 25	@11בד"ה לפי שמחסרין כו' הוצרכו לברכה כו' @22נ"ב דאל"כ מ"ש הני וק"ל מהרש"ל:	Mizrachi, Genesis 1:22:1
Yeriot Shlomo on Torah, Bereshit 26	@11בד"ה אלא מפני כו' לאקשוי מן החיה @22נ"ב ולי נראה בודאי אינם כ"כ בריבוי כמו הדגים ומה שבירך האדם הוא לרוב מעלתו ומה שהיו במצרים מתרבי' אינו בדרך טבע ודוק מהרש"ל:	Mizrachi, Genesis 1:22:3
Yeriot Shlomo on Torah, Bereshit 27	@11בד"ה תוציא הארץ כו' במקום ישרצו יוציאו @22נ"ב ולי נראה דשריצת המים אינו בכלל תולדות שמים וארץ וכן גידול העשבים אינו בכלל תולדות הארץ אלא גידול הארץ וכחה שהשפיע לה שהרי כל ימיה כך היא נוהגת וכן במים מה שאין כן ביציאת נפש בהמה וחיה שהיא לשעה והוא תולדות הבריאה ואינה תלויה בכחה ובריאת האדם אינו מתולדו' הארץ אלא ממעשה השם בכבודו ובצלמו ודוק מהרש"ל:	Mizrachi, Genesis 1:24:1
Yeriot Shlomo on Torah, Bereshit 28	@11בד"ה תקנם בצביונם כו' קומתן מתחילתן @22נ"ב ולי נראה דקומתן מפיק מויעש כפירש רש"י וצביונם מלשון צבאם או כפירש רש"י שהוא מלשון רצון ובחירה או כפי' הערוך שהוא לשון יופי מלשון צבי ותפארת מהרש"ל:	Mizrachi, Genesis 1:25:1
Yeriot Shlomo on Torah, Bereshit 29	@11בד"ה יש בעליונים כו' @22נ"ב פירש בזה הטענה בא על המלאכים וזה נעשה כו' כלומר ראוי לעשות כך ומ"מ קרוי נטילת רשות וק"ל ומה משמיע לנו הפסוק בזה אלא דרך ארץ כו' כמו שפירש רש"י ודוק מהרש"ל:	Mizrachi, Genesis 1:26:1
Yeriot Shlomo on Torah, Bereshit 30	@11בד"ה בצלמו העשוי לו כו' @22נ"ב נ"ל פירש העשוי לאדם דאי קאי אקב"ה אין נופל הלשון אחר כך בצלם אלהים ודוק מהרש"ל:	Mizrachi, Genesis 1:27:1
Yeriot Shlomo on Torah, Bereshit 31	@11בד"ה ועוד למדך כו' אינו אומר זה כו' @22נ"ב ולי נראה שרש"י תפש שני הדיעות כי כולן אמת דע"כ לאו למעוטי אשה מפריה ורביה לחוד קאתי דא"כ ה"ל לכתוב קרא דוכבשה קודם פרו ורבו ודוק ואי ללמדך שהאיש כובש את אשתו שלא תהא יצאנית לחוד קאתי לא הי' שייך כאן גבי ברכה ויברך אלהים בפרט דלעיל מיניה איירי בברכה פרו ורבו ולבסוף איירי בברכה ורדו בדגת הים וא"כ האי עניינא איך סליק באמצע אלא ע"כ איירי נמי במילי דברכה ודוק מהרש"ל:	Mizrachi, Genesis 1:28:2
Yeriot Shlomo on Torah, Bereshit 32	@11בד"ה השוה להן כו' @22נ"ב ולי נר' כפשוטו כדאיתא בפרק ד"מ אמר רב יהודא אמר רב אדם לא הותר לו לאכול בשר דכתיב לכם יהיה לאכלה ולכל חית הארץ ולא חית הארץ לכם וזהו לשון השוה כלומר שמאכל אחד יהיה לשניהם אבל לא שיהא לאדם מעלה נוספת להמית בריה כו' אבל אין לפרש מה החיה לא הותר לה לאכול רק עשבים דכתיב ורדו בהם ולא הם בכם דהא עינינו רואות שהותר להם וכל דאלים גבר ודוק מהרש"ל:	Mizrachi, Genesis 1:29:1
Yeriot Shlomo on Torah, Bereshit 33	@11בד"ה ברכו במן כו' שאף על פי שקדש כו' @22נ"ב ולי נרא' דבודאי בירך את יום השבת כי ביום הששי ירד שתי עומר ועשו ממנו ד' חלות אחד אכלו ביום הששי בבקר וג' אכלו ביום השבת כי איתא בהדיא בירושלמי והטור הביאו וא"כ שפיר בירך אותו ודוק ויש מקשים דמ"מ זה אינו מברכת השם אלא מציווי שמירת שבת הוא ע"כ נראה בעיני דעיקר הברכה שירד בששי כפל והניחו אותו עד בקר ולא הבאיש ורמה לא היתה בו כמו בשאר ימים וכך היה טבעו ואל תשיבני מצנצנת המן דג"כ בנס היה עומד ע"כ היה ראוי לאפות ולבשל הכל ביום הששי כדי שלא יבאש ואפילו הכי ברכו השם שירד בששי כפל במקום השביעי כאלו ירד בשביעי וקרא מסייע את אשר תאפו אפו כו' ואת כל העודף הניחו לכם למשמרת עד הבקר ויניחו אותו עד הבקר ולא הבאיש ורמה לא היתה בו וזהו עיקר מהרש"ל:	Mizrachi, Genesis 2:3:1
Yeriot Shlomo on Torah, Bereshit 34	@11בד"ה ה' הוא כו' פי' שם העצם נ"ב @22שלא יתרבה ולא יתפעל ודוק הטיב מהרש"ל:	NULL
Yeriot Shlomo on Torah, Bereshit 35	@11בד"ה מקדם במזרחו כו' פליגי אההיא כו' @22נ"ב ולי נראה דלא פליגי אלא מחלק בין גן עדן לשאר מקומות וקרא מסייע ליה מקדם וכן איתא בב"ר ודוק מהרש"ל:	Mizrachi, Genesis 2:8:10
Yeriot Shlomo on Torah, Bereshit 36	@11בד"ה וא"ת הרי כו' אף על פי שמקדם כו' @22נ"ב ולי נראה שכך הקשר אף ע"פ שכמה תנאים דרשי בב"ר מקדם קודם יצירת האדם מ"מ מוכרח אני לפרש לשון מזרח דהרי קשה וא"ת כו' ואי אפשר לתרץ אלא בסיפור מעשיו שסתם כבר אם כן משמע דכל הני מעשי' איירי אחר יצירת האדם ודוק מהרש"ל:	Mizrachi, Genesis 2:8:11
Yeriot Shlomo on Torah, Bereshit 37	@11בד"ה שלא יאמרו כו' לא עוב היות האדם לבדו כו' @22נ"ב פירש מדלא כתיב לא עוב לאדם להיות לבדו מהרש"ל:	Mizrachi, Genesis 2:18:1
Yeriot Shlomo on Torah, Bereshit 38	@11בד"ה ויבן כו' באופן להיות אשה כו' @22ולי נראה לפרש כפשוטו דלכך פירש"י הכי שלא תאמר ויבן את הצלע לאשה הוי כאילו כתיב ויבן את הצלע אל האשה וזה אינו דהא עדיין לא היתה אשה בעולם לכן מפרש לאשה להיות אשה וכן ויעש אותו גדעון לאפוד אין הפי' כמו אל האפוד אלא להיות אפוד ודוק כן נ"ל:	NULL
Yeriot Shlomo on Torah, Bereshit 39	@11בד"ה מצלעותיו כו' הדרך הזאת כו' @22נ"ב ולי נראה לפי האמת דמתרץ תלמודא מקום חתך יכילנא לומר לדברי כולם מקום חתך הוא ושני פרצופין שלימין היו ומחוברין במקצת היו ולא היו צריכין לשום תשלום אלא למקום חתך ומ"ה פירש רש"י הכי אליבא דכ"ע ודוק מהרש"ל:	Mizrachi, Genesis 2:21:1
Yeriot Shlomo on Torah, Bereshit 40	@11בד"ה זאת הפעם כו' אחרים שמש @22נ"ב אף שאין משיבין את הארי מ"מ נ"ל דלאו דוקא שימש אלא בא במחשבה ודוק מהרש"ל:	NULL
Yeriot Shlomo on Torah, Bereshit 41	@11בד"ה מה ענין כו' מאיזה סיבה כו' @22נ"ב יש מקשין מה מלמדינו הלא באותו פעם לא היה לו בושה ונ"ל דבא להשמיענו שאסור לשמש בפני כל חי אף שאין כאן בושת שהרי אדם ששימש נמי במקום שלא היה לו בושה ובא ממנו תקלה ודוק מהרש"ל:	Mizrachi, Genesis 3:1:1
Yeriot Shlomo on Torah, Bereshit 42	@11בא"ד בב"ר בשם ר"י כו' @22נ"ב וק"ל דא"כ למה ואירא כי עירום אנכי או וידעו כי ערומים הם ואפשר למ"ד כציפורן חלקה על בשרו אם כן עדיין היה ערום ודו"ק ול"נ דהכי פי' על כל פנים ויהיו שניה' ערומין כו' והנח' היה ערום כו' לא שייכי אהדדי ואם באת לומר שרצה הכתוב להתחיל בסיפורו של אדם איך הוא ערום מתחילה עד סופו שנתלבש על ידי המקום אם כן היה לו לסמוך מיד ויעש לאדם וגו' דהיינו לסתום ואח"כ יפרש מעשיו והנחש היה ערום עד שלבשו המקום ודוק מהרש"ל:	NULL
Yeriot Shlomo on Torah, Bereshit 43	@11בד"ה אף כי אמר שמא כו' @22נ"ב ונרא' לי דהוי כמו שכתיב כי אף אמר לכם והיינו פי' שמא אף זה אמר לכם ודוק מהרש"ל:	Mizrachi, Genesis 3:1:3
Yeriot Shlomo on Torah, Bereshit 44	@11בד"ה דחפה עד שנגעה כו' @22נ"ב יש מקשין מה סברה חוה בראותה שהנגיעה לא היתה מזקת לה הלא ידעה האמת שהמקו' לא גזר על הנגיע' ונראה לי דלק"מ כי בלא זה קשה למה אמרה לא תגעו בו פן תמותון והקב"ה אמר בודאי תמות אלא הכי אמרה מאחר שציוה הקב"ה מיתה על האכילה מיסתפינא דגם כן אנגיעה הוי עונש מיתה והוא הראה לה שבנגיע' ליכא פחד ועונש ואז הוקל לבה שאף באכילה ליכא חשש והיינו כל המוסיף גורע אע"פ שהוסיפ' לאיסור ודעתה היתה לטובה ודוק מהרש"ל:	Mizrachi, Genesis 3:4:1
Yeriot Shlomo on Torah, Bereshit 45	@11בד"ה ראתה דבריו וה"פ כיון כו' @22נ"ב ולי נראה לפ' דה"ק ראתה דבריו של נחש היינו דכתיב אחריו כי טוב העץ. וכי תאוה הוא לעינים היינו והנאו לה ונחמד העץ להשכיל היינו והאמינתו כו' ודוק מהרש"ל:	NULL
Yeriot Shlomo on Torah, Bereshit 46	@11בד"ה לענין החכמה כו' @22נ"ב ולי נראה דהכי דייק מדכתיב אחר כך וידעו כי ערומי' הם ולא כתי' ותפקחנ' עיניהם ויתבוששו דאין לומר כבר לא ידעו כי ערומים הם מאחר שעיניהם לא נתפקחו הלא אין זה תלוי בראייה שאף הסומא ידע כו' אם כן מה שכתב וידעו כי ערומי' הם היינו שנתערטלו במצוה אחת אם כן ותפקחנה נמי איירי בהאי חכמה ודוק ומ"מ אין המקרא יוצא מידי פשוטו ואף לענין הבושה איירי מדלקחו להם חגורות והא דאמר אחר כך ואירא כי עירום אנכי משום דס"ס הוא ערום וגנאי הוא כלפי מעלה מאחר שאינו מלובש בכתנות וק"ל מהרש"ל:	Mizrachi, Genesis 3:7:1
Yeriot Shlomo on Torah, Bereshit 47	@11בד"ה לאותו רוח שהשמש בא משם כו' @22נ"ב ונ"ל דלא צריך לפי' דשוקעת אלא ה"פ השכינ' היתה במערב והיה לע"ע השכינה ברוח שהשמש באה דהיינו במערב בשעה העשירית ודוק מהרש"ל:	Mizrachi, Genesis 3:8:2
Yeriot Shlomo on Torah, Bereshit 48	@11בד"ה כמו אל כו' מלשון הטעאה כו' @22נ"ב ולי נראה דחד לשון הוא אלא דלשון הסתה הוא בכאן מלשון הטעאה ודוק מהרש"ל:	Mizrachi, Genesis 3:13:2
Yeriot Shlomo on Torah, Bereshit 49	@11בד"ה היה לו להשיב כו' של מסית דקאמר @22נ"ב ושרי ליה מרי שכח מה שכתבו התוס' בפרק זה בורר וז"ל שאני מסית שנצטוה שלא להסית ואם כן כשמסית עובר אבל הנחש לא נצטוה רק שתקלה בא על ידו כו' מהרש"ל:	Mizrachi, Genesis 3:14:1
Yeriot Shlomo on Torah, Bereshit 50	@11בד"ה רגלי' היו כו' הכי הוי @22נ"ב ומה שפי' נתקוצצו משו' שעינינו רואו' שאין לו עתה רגלי' מהרש"ל:	NULL
Yeriot Shlomo on Torah, Bereshit 51	@11בד"ה אתה לא כו' ותשא אשתו @22נ"ב וא"ל ס"ס ידע שהיא נמי תאכל ותמות וי"ל דסב' מאחר שאדם נצטוה מפי הגבורה עצמו ימות מיד והיא שלא נצטוית מפי המקום אלא מפי בעלה לא תמות כ"כ מהר ואם כן להאי שעתא ישגלנה ודוק מהרש"ל:	Mizrachi, Genesis 3:15:1
Yeriot Shlomo on Torah, Bereshit 52	@11בד"ה ואף משם תמיתנו כולו @22נ"ב ואני אומר דמ"ה פירש ואף משם תמיתנו משום דהוא ישופך ראש הוא סיבת על גחונך תלך אבל תשופנו עקב אין לפרש כך דאם היה בעל קומה מכ"ש שהיה נושף בו למעלה אלא אף משם תמיתנו קאמר מהרש"ל:	Mizrachi, Genesis 3:15:3
Yeriot Shlomo on Torah, Bereshit 53	@11בד"ה עצבונך כו' בעל הערוך כו' @22נ"ב ולי נראה לפרש עצבונך צער וסת והרונך כפשועו והיינו שכתב אחריו בעצב תלדי בנים כלומר דאי אפשר לפתיחת קבר בלא דם מהרש"ל. ואין להקשות לפירש רש"י הל"ל בתחילה הרונך ואחר כך עצבונך כסדר משום דגבי חוה הוה צער גידול בנים קודם צער העיבור דהא כבר היה נולד קין כדאיתא בסנהדרין שעה ח' עלו למטה שנים וירדו ארבעה שמעתי:	Mizrachi, Genesis 3:16:1
Yeriot Shlomo on Torah, Bereshit 54	@11בד"ה תשוקתך כו' הכל ממנו כו' @22נ"ב פירש מ"ה אינה יכולה לתבעו שבלתי תאוותו וקישויו א"א לשמש מש"כ בו דכשהוא מתאוה לתשמיש אף על פי שהיא אינה מתאוה יכול לשמש וזהו הכל משלו וממנו ודוק מהרש"ל:	Mizrachi, Genesis 3:16:2
Yeriot Shlomo on Torah, Bereshit 55	@11בד"ה ויש אומרים כו' צמר ארנבת כו' @22נ"ב ול"נ דהוכרח רש"י לפרש זה משום דק"ל למה לא כתב ויעש כתנות עור וילבישם מקודם ויקרא האדם שם אשתו חוה כדי לגמור כל הענין ואחר כך לחזור לעניינו של ראשון אלא ללמדך שלאו משום שהיו ערומים לחוד עשה כתנות עור אלא אף משום הצינה ואפשר אי לא היו חוטאין היה מציל אות' מן הצינה אבל עכשיו שהוכרח לעשות להן כתנות מפני הבושה עשה אותן מצמר ארנבת רך וחם אף לצינה ודוק. ועוד נראה לפרש ועיקר דמכתנות עור דייק דאם לא כן היה לו לכתוב ויעש לו כתנות ותו לא אלא עור של ארנבת ודוק מהרש"ל:	Mizrachi, Genesis 3:21:2
Yeriot Shlomo on Torah, Bereshit 56	@11בד"ה ואל ישעו כו' אל יפנו @22נ"ב ונראה לומר דשפיר גרסינן ליה וה"ג וכן לא ישעה וכו' והוא פסוק שבישעיה לא ישעה אל המזבחות ולא קאי על ואל ישעו בדברי שקר שבפרשת שמות. ספר פענ"ח רז"א:	NULL
Yeriot Shlomo on Torah, Bereshit 57	@11בד"ה דמי אחיך כו' ודם זרעותיו @22נ"ב ומה שפירש עוד שעשה בו הרבה פצעי' כו' היינו משום דכתי' ארור אתה מן האדמה אשר פצתה את פיה לקחת דמי אחיך כו' והנה האדמה לא קבלה דמי זרעותיו אלא אפצעים הרבה קאי וזה לא יתכן שאם כן מהו דמי אחיך צועקים ס"ס אין כאן אלא צעקה אחת אלא אזרעותיו קאי ודוק מהרש"ל:	NULL
Yeriot Shlomo on Torah, Bereshit 58	@11בד"ה ויש אגדה כו' סופן פשתן @22נ"ב ואני אומר אולי מזה סמכי מדכ' מפרי האדמה ולא כתיב פרי האדמה אלא ר"ל מפרי סתם שהוא פרי העץ ועיקרו פרי האדמה דהיינו פשתן שהוא פרי האדמה דלא הדר מפיק גוזא והתורה קראו עץ כדכתיב ותטמנם בפשתי העץ ודוק מהרש"ל:	Mizrachi, Genesis 4:3:2
Yeriot Shlomo on Torah, Bereshit 59	@11בד"ה אתה טוען עליונים ותחתונים @22נ"ב ע"ד כי עמך הסליחה למען תורא כמו שמפרש בספר עיקרי' ודוק מהרש"ל:	Mizrachi, Genesis 4:13:2
Yeriot Shlomo on Torah, Bereshit 60	@11בד"ה חקק לו אות כו' תי"ו על מצחו @22נ"ב ולי נראה דאף הכא נפרש בתי"ו והיינו אות אחת משמו של קין שקראו אמו קניתי את ה' ודוק א"נ הי"א והיינו אות משמו של הקדוש ברוך הוא והי"א רמז לתשובה כדאיתא במנחות ורומז נמי כל הורג קין ודוק מהרש"ל:	Mizrachi, Genesis 4:15:4
Yeriot Shlomo on Torah, Bereshit 61	@11בד"ה תובל קין כו' כי כלי אומנות כו' @22נ"ב ושרי ליה מרי' כי דבריו לא נראין לי כי מה שפירש רש"י כלי אומנות הוא פירש של חרש ואם היה נקוד חרש היה פירושו אומן עצמו ועכשיו פירושו כלי אומנות ודוק מהרש"ל:	Mizrachi, Genesis 4:22:1
Yeriot Shlomo on Torah, Bereshit 62	@11בד"ה ינחמנו כו' עצבון ידינו @22נ"ב מה שדרש בב"ר שתיקן כלי מחרישה ועוד שפסקה הקללה ולא סגי בחד משום דבקרא תרתי רמיזה מעשה ידינו היינו כלי מחרישה שמציל מטורח מעשה ידינו ועצבון ידינו היינו הקללה שהיה לעצבון ומה שפירש"י ינח ממנו את עצבון ידינו ולא הזכיר מעשה ידינו משום שקריאת השם נח לא היה אלא בעבור העצבון שפסק מיד כשהיה נולד לאפוקי תיקן כלי מחרישה היה כשהגדיל ודוק מהרש"ל:	Mizrachi, Genesis 5:29:1
Yeriot Shlomo on Torah, Noach 1	@11בד"ה כדי שלא כו' יפת הגדול @22נ"ב עיין במה שכתבתי בסוף נח מהרש"ל:	NULL
Yeriot Shlomo on Torah, Noach 2	@11בד"ה עלה במחשבה כו' שהיא תחילת דיבור ואינו פירש כצ"ל @22ונ"ב שהרי הזכיר שם המיוחד מהרש"ל:	NULL
Yeriot Shlomo on Torah, Noach 3	@11בד"ה נתאבל על כו' ובשביל הצדיקים @22נ"ב ונ"ל דה"ק זו כתב לתשובת המיני' בשעת חדוה כפי מובן המשל אבל חלילה לדמות הקב"ה לב"ו ששייך עליו לומר בשעת חדוה כי הוא מביט מה שלפניו ולא מה שלאחריו אבל ממ"ה אחרית לפניו כראשית רק שר' יהושיע דחה המין כמו שמצינו כה"ג בתלמוד כמה זימני אבל לפי האמת פירש רש"י מפני הצדיקים וזו היא האמת ודוק מהרש"ל:	NULL
Yeriot Shlomo on Torah, Noach 4	@11בד"ה אף הן השחיתו @22נ"ב ושניהן אמת דאי כפי' הראשון מאדם ל"ל הלא כבר כתיב אמחה את האדם ואי כפי' השני ה"ל למכתב מאדם ובהמה ודוק מהרש"ל:	NULL
Yeriot Shlomo on Torah, Noach 5	@11בד"ה הואיל וסיפר בשבחו כו' @22נ"ב נ"ל מיתורא דנח נח קאתי שמשמע דמדהזכיר נח צריך לומר איש צדיק ודוק ואחר כך ק"ל הלא בלא יתורא דנח נמי שמעינן דאם לא כן קשה פתח בתולדותיו וסיים בשבחיו על כן משני שעיקר הפסוק לד"א קאתי ולפי זה הפירש יהיה לשון תולדות מאורעות ודוק ושני הפירושים בהכרח הן הפי' הראשון מלשון נח נח וגם הפי' השני אמת דאם לא כן ה"ל לכתוב בפ' בראשית אצל ויולד נח ודוק מהרש"ל:	Mizrachi, Genesis 6:9:1
Yeriot Shlomo on Torah, Noach 6	@11בד"ה יש מרבותינו כו' אותו לגנאי @22נ"ב ואפשר שנוכל לקיים שניהם כאחת ודוק מהרש"ל:	Mizrachi, Genesis 6:9:3
Yeriot Shlomo on Torah, Noach 7	@11בד"ה ובאברהם הוא כו' @22נ"ב זהו חיבור וקשר אלעיל כלומר יש דורשין אותו לגנאי משום סיוע דהאי קרא אבל בזולת זה חלילה לדרוש על הצדיק לגנאי ומאן דדריש לשבח אמר בעבו' זה לא נאמר אצל אברהם את האלהים לפי שכל הילוכו היה עם הבריות להכניסם תחת כנפי השכינה אבל נח אנשי דורו רשעים היו על כן הרחיק מהם כמו שדורש בב"ר אשרי האיש אשר לא הלך כו' זה נח הצדיק ודוק מהרש"ל:	Mizrachi, Genesis 6:9:4
Yeriot Shlomo on Torah, Noach 8	@11בד"ה כי השחית כו' נזקקין לשאינן כו' @22נ"ב אף ע"פ שותשחת הארץ נמי בע"ז איירי מ"מ עיקר הבטה וקצף של מקום היה על הזנות ולא על העבודה זרה וכך החיבור וירא אלקים והנה נשחת' כלומר בע"ז ובערוה ומ"מ עיקר הבטה על הזנות שנאמר כי השחית כל בשר ולשון כי השחית כו' דומה לגזר דין כמו כי מלאה הארץ חמם ודוק והא דלא כתיב וירא אלהים את החמם נראה לי משום שהיא עבירה שבין אדם לחבירו ולא יכול הקדוש ברוך הוא למחול וראה הקב"ה עבירות שבינו כגון ע"ז וזנות ודוק מהרש"ל:	NULL
Yeriot Shlomo on Torah, Noach 9	@11בד"ה הופכו להבא @22נ"ב פירש מזה דייק רש"י מדכתיב ובא והתפלל ולא כתיב ובא התפלל אלא שאם כתב כן ה"א שאפילו התפלל כבר בבית ואחר התפילה בא אל הבית ש"מ שבלא וי"ו היה משמש לשעבר ודוק מהרש"ל:	Mizrachi, Genesis 6:9:8
Yeriot Shlomo on Torah, Noach 10	@11בד"ה ע"י שהיו כו' @22נ"ב בתיבתו של משה כו' כך נ"ל הקשר אף על פי שוכפרת תרגם המתרגם ותחפי ועל בכופר תרגם כופרא מלשון זפת ולמה ג"כ לא נתרגם מלשון וכפרת לכך אומ' ע"כ מוכרחין לפרש זפת דלא גרע מתיבתו של משה שהיה לשם זפת וא"כ מקשה מ"ש מתיבתו של משה שהיה לשם מבפנים חמר ומשני בתיבתו של משה כו' מהרש"ל:	Mizrachi, Genesis 6:14:3
Yeriot Shlomo on Torah, Noach 11	@11בא"ד זפתה מבפני' @22נ"ב פירש אף מבפנים נ"ל מהרש"ל:	NULL
Yeriot Shlomo on Torah, Noach 12	@11בד"ה שהוא קצר כו' ששית אמה @22נ"ב לא קבלתי הכי אלא למעלה היה אמה על אמה וק"ל מהרש"ל:	Mizrachi, Genesis 6:16:2
Yeriot Shlomo on Torah, Noach 13	@11בד"ה שבלה את הכל @22נ"ב ולי נראה לפי שלשון בילה אינו נופל אלא על דבר דק המתערב ממש כגון קמח אבל עירוב גופות אינו נופל לשון בילה אלא בלבול ודוק ולפי שגם בלבול לא היה שמי בלבלם אם לא ע"י הבלה שהוביל אות' ממקום גבוה וכו' וע"י כן נתבלבלו ומ"מ שורש הלשון של מבול הוא לשון בילה ודוק מהרש"ל:	Mizrachi, Genesis 6:17:3
Yeriot Shlomo on Torah, Noach 14	@11בד"ה ברית היה כו' שלא ירקבו @22נ"ב נראה לי דצריך רש"י לזה דאי על הפירות לחוד אתך ל"ל ואי עליו לבד ה"ל למכתב ואת בריתי אקים והקימותי את בריתי משמע שבשכבר כרת ודוק מהרש"ל:	Mizrachi, Genesis 6:18:1
Yeriot Shlomo on Torah, Noach 15	@11בד"ה ומאליהן באו כו' @22נ"ב הבאין מאליהן כל אותן שבאו אל התיבה מאליהן באו ובהן הכיר אותן שבאו שבעה שבעה ידע שהן טהורין ושבאו שנים שנים ידע שהן טמאים ר"פ חטאת ומה שפירש רש"י כאן באו מאליהן קודם מה שאמר וכל שהתיבה קולטתו ובגמר' הוי להיפך לפי שס"ל האי שינויא עיקר דקרא מסייע ליה והבאים זכר ונקבה הובאו לא נאמר כו' וכמו שפירש"י לקמן ואגב אורח' הביא וכל שהתיבה קולטתו במקום יש מפרשים מהרש"ל:	Mizrachi, Genesis 6:20:2
Yeriot Shlomo on Torah, Noach 16	@11בד"ה למדנו שלמד כו' ותפש דרך כו' @22נ"ב ולי נראה דתרוייהו צריכי דאי לא למד תורה אם כן מה דיבר עמו טהורה הלא לא יבין לשון טהרה וטמאה ששניהם נאסרו לו לנח שעדיין לא אכל בשר בפרט מאחר שהקדוש ברוך הוא חפץ להוסיף עמו בדברים דאם לא כן לא היה צריך לשום דיבור אלא לומר כנוס סתמא והתיבה קולטת ודוק אלא שלמד תורה כפירש"י ואי לאו שהתיבה כו' לא הוי ידע איזה שמשו וסרחו דרכן ומה שהוא סובר שבתלמודא מפרש טעמא דהתיבה קולעת כו' אטהורין קאי שעתידין ליטהר אינו כן וז"ל הגמרא טהורין וטמאיי בהאי שעתא מי הוי אמר ר' שמואל בר נחמני טהורין מאותו שלא נעבדה בהן עבירה ל"א מאותן שעתידין ליטהר מנא ידע כדרב חסדא דאמר רב חסדא העבירן לפני התיבה כו' והנה רש"י תפש לו הלשון אחר דפי' שעתידין ליטהר אבל הטמאין נמי לא סרחו דרכן אלא מאות' שדבקו במיניהם ויליף מינייהו כדפירש לעיל ומ"ה פירש שלמד נח תורה כדפירש ותלמודא הוא דמקשה לר"ש בר נחמני דפי' טהורין שלא סרחו כו' מנא ידע ומשני כדר' חסדא דלא בעינן לטהורין אלא לענין כולם לידע איזה מהן שלא סרחו ודוק א"נ נראה דמ"ה לא הספיק תיבה קולטתו לחוד דאם כן לא ידע נח מתי גמרן כל ביאתן לתיבה וישב ויצפה עד שאמר לו מכל הפחות שנים ומן הטהורין שבעה ודוק מהרש"ל:	Mizrachi, Genesis 7:2:1
Yeriot Shlomo on Torah, Noach 17	@11בד"ה ויעש נח זה ביאתו לתיבה @22נ"ב נראה לי דעת רש"י כאבן עזרא כלומר הקרבתו אל התיבה ולא כניסתו ודוק מהרש"ל:	NULL
Yeriot Shlomo on Torah, Noach 18	@11בד"ה האנשים לבד כו' נ"ל שיבוש כו' @22נ"ב ול"נ דקאי אז' ימים שעדיין לא נכנס בתיבה ואפ"ה אסרו עצמם בתשמיש מפני שהעולם שרוי בצער שכבר בא עת הגזירה ודוק ולכך הוסיף רש"י כאן הטעם שהעולם שרוי בצער לפי שהמקום לא ציוה ועדיין לא נאסר ורש"י דייק מיתורא דקרא ויבא נח ובניו כו' שה"ל לכתוב ויבא נח וכל אשר לו אלא ללמדך שקודם הכניסה היו הוא ובניו יחד ודוק מהרש"ל:	Mizrachi, Genesis 7:7:1
Yeriot Shlomo on Torah, Noach 19	@11בד"ה כולם הושוו @22נ"ב ונ"ל מ"ה כתב כאן כולם הושוו במנין ושינה הלשון משום דק"ל שנים שנים ל"ל אלא ה"ק שנים מכולם כלומר אפילו אותן שהיו שבעה זוגות לא היו באין בערבוביא אלא בשנים שנים איש ואשתו ודוק מהרש"ל:	Mizrachi, Genesis 7:9:2
Yeriot Shlomo on Torah, Noach 20	@11בד"ה דבוק הוא כו' פירש כל צפור @22נ"ב ונ"ל דא"כ חגב אינו בכלל שאר ציפור אבל עכשיו שעיקר השם הוא כנף א"כ חגב בכלל ודוק מהרש"ל:	Mizrachi, Genesis 7:14:1
Yeriot Shlomo on Torah, Noach 21	@11בד"ה נשמה של רוח חיים @22נ"ב ונ"ל שצריך רש"י לפרש כך דאם לא כן קשיא למ"ד בפרק עגלה ערופה שהנשמה בעיבור ולא בנחיריו א"כ למה אמר קרא רוח חיים באפיו אלא כלומר שהנשמה של רוח חיים דהיינו הנשימה ולא רוח חיים ודוק מהרש"ל:	Mizrachi, Genesis 7:22:1
Yeriot Shlomo on Torah, Noach 22	@11בד"ה גונח וכו' וחציו חולה @22נ"ב וד"א שפירש שהכישו הארי יפרש אך מלשון ואך אותך ודוק מהרש"ל:	Mizrachi, Genesis 7:23:5
Yeriot Shlomo on Torah, Noach 23	@11בד"ה יבשת המים @22י"מ בפסוק מרומז יבשת הוא תשבי ונראה לי כפשוטו מדכתיב עד יבשת המים מעל הארץ ולא כתיב יבשת הארץ ודוק מהרש"ל:	NULL
Yeriot Shlomo on Torah, Noach 24	מה שכתב רש"י וייחל הוא ויתמתן נראה לי דהיינו החילוק דפעל היינו שהוא המתין עוד מדעתו אבל ויתמתן כלומר מורגש ומושג מעצמו מאחר שקלו המים כבר אם כן בשבעה ימים ישתנה מאוד ודוק מהרש"ל:	NULL
Yeriot Shlomo on Torah, Noach 25	@11בד"ה לכן קוריהו פעמים לשון זכר @22נ"ב ונראה לי מה שהודיע כאן שהוא זכר כדי להשמיע לנו אף על פי שכבר חשדו העורב אפ"ה לא נמנע מלשלוח פעם שנית הזכר לפי שהעורב קילקל בזנות ופרוץ בעריות על כן חשדו כי כל הפוסל כו' אבל יונים אינם פרוצי' בעריות ע"כ ידע שלא יחשד אותו ודוק מהרש"ל:	Mizrachi, Genesis 8:11:1
Yeriot Shlomo on Torah, Noach 26	@11בד"ה הוצא @22נ"ב מה שפירש רש"י קרי היצא כי הוי"ו קריאתה עומדת במקום יו"ד כמו חוה חיה הוה גביר היה גביר לאפוקי שלא תקרא הוצא בחולם בנח הוי"ו בלא תנועה ודוק וכן דעת מחבר זה נרא' לי עיקר מהרש"ל:	Mizrachi, Genesis 8:17:1
Yeriot Shlomo on Torah, Noach 27	@11בד"ה אמר לא כו' להכניס מאלו @22נ"ב ול"נ דק"ל למה לקח מן הטהורין אי משום שלמד תורה היינו שנופל עליו לשון טהרה אבל סוף סוף באותו פעם היה הכל מותר וראוי להקרבה דהאדם מקריב מה שהוא מותר לפיו או לא הו"ל להקריב אלא מה שראוי אחר מתן תורה ולא מכל הטהורין אלא משום לא לחינם ציוה לי וכו' ואי אפשר לפרש משום קיום המין דמנא ידע דלמא המקום ציוה להכניס בתיבה כדי להקריב ולא משום קיום המין ודוק מהרש"ל:	Mizrachi, Genesis 8:20:1
Yeriot Shlomo on Torah, Noach 28	@11בד"ה כל ימות כו' שאמרו בב"ר @22נ"ב ונראה מה שאמר בב"ר כל י"ב חדש היינו שמשו בכח זריחת' וניהוג סידרן והא ראייה שפירש רש"י אח"כ לא ישבותו לא יפסקו כל אלה מלהתנהג כסדרן אבל מה שפירש לא היה ניכר בין יום ולילה היינו בהיות המבול דהיינו ארבעים יום כדכתיב ויהי המבול וגומר ואין להקשות מנא ליה לרש"י שבאותן המ' ימים לא שמשו כלל משום דכתיב עוד כל ימי הארץ כו' עד יום ילילה כו' מכלל דבתחילה לא היה יום ולילה כל עיקר ודוק מהרש"ל:	Mizrachi, Genesis 8:22:3
Yeriot Shlomo on Torah, Noach 29	@11בד"ה לא ישבותו כו' מפני שהשביתה כו' @22נ"ב ולי נראה מדכתיב עוד כל ימי הארץ דהיינו גזירה נצחית שיהיה כך לעולם א"כ לא ישבותו ל"ל ודוק מהרש"ל:	Mizrachi, Genesis 8:22:4
Yeriot Shlomo on Torah, Noach 30	@11בד"ה לכם יהיה כו' את כל @22נ"ב מה שמקשין העולם למה התיר לנח לאכול בשר נראה בעיני לפי שמתחילה היו שוין שהרי האדם והבהמה כולם מעשה ה' המה ובורא אחד לכולם ולא ימית זה את זה והנה בשעת המבול חטאו כל הבהמות כמו כל האדם אמר הקדוש ברוך הוא אם כן אין מן הראוי עוד לחמול על הבהמה שהרי חטאו כמו בני האדם ואדרבא יש יתרון לאדם שיצרו רע מנעריו כמו שנאמר וירח ה' את ריח הניחוח וגו' אם כן ראוי שהאדם ישלוט עליו ודוק מהרש"ל:	Mizrachi, Genesis 9:3:1
Yeriot Shlomo on Torah, Noach 31	@11הם המתהלכים עם הבריות @22נ"ב פירש אפילו ארי ודוב ונמר ודוק מהרש"ל:	Mizrachi, Genesis 9:10:1
Yeriot Shlomo on Torah, Noach 32	@11בד"ה כשנכנס כו' ויחורי תאנים @22נ"ב ומהרא"י פי' מדאמר ה"ל לעסוק בנטיעה אחרת ש"מ שעוד נטיעה היתה ראויה ומסברא אוקמינא איחורי תאנים שמצינו כבר במקרא עלי תאנה ודוק א"נ מאחר שהתאינה הביאה מיתה לעולם בנות שוח בנות שבע ויין לא נברא אלא לנחם אבלים ודוק מהרש"ל:	Mizrachi, Genesis 9:20:3
Yeriot Shlomo on Torah, Noach 33	@11בד"ה בנו הקטן כו' גדול מיפת @22נ"ב ונ"ל שטעה מחבר זה שאינו גדול מיפת כמו שפירש רש"י בסוף בראשית אלא גדול משם הוא בהכרח ומה שקשה למה מנה אותו קודם יפת הלא בפרק בן סורר ומורה הקשו התו' זה ועומדים בתימה ע"ש מהרש"ל:	Mizrachi, Genesis 9:24:1
Yeriot Shlomo on Torah, Noach 34	@11בד"ה שנאמר וננוה כו' ולא הבינותי כו' @22והתוס' במסכת יומא דף י' תירצו דאדרבה דאם איתא דקאי אכלח לא הל"ל היא העיר הגדולה רק העי' הגדולה דהא עלה קאי:	Mizrachi, Genesis 10:12:1
Yeriot Shlomo on Torah, Noach 35	@11בא"ד בכלח @22נ"ב ואני אומר ברסן אין ראוי להסתפק דהא עכשיו בנאה אלא בכלח שבנה כבר ודוק מהרש"ל. 	NULL
Yeriot Shlomo on Torah, Noach 36	@11בד"ה שהרי בן ת"ק שנה @22נ"ב ויש מקשין מה תועלת יש אם נדע באיזה שעה נפלגה אם ממש באמצע ימיו או סמוך למיתה או קודם חצי ימיו ונ"ל דה"פ בשלמא אם בתחילת ימיו נפלגה קרא פלג לרוב הצער והסיבה אשר פגע לו בעת הולדו כמו אי כבוד אבל אם באמצע ימיו למה קרא שם לסיבת הפורענות והצרות שהעולם בורחי' מזה אם כן יש תימה בדבר ולא בא הכתוב לסתום אלא לפרש ולברר למה קרא אותו פלג בשלמא אם בסוף ימיו אז קרא שמו למעליות' שבסוף ימיו נפלגה הארץ והוא לא יראה באותו רעה מהרש"ל:	Mizrachi, Genesis 10:21:3
Yeriot Shlomo on Torah, Noach 37	@11בד"ה יקטן שהיה כו' @22נגזר מהקטנות ומהרא"י פירש מדשינה הכתוב וכתב בסוף כל אלה בני יקטן ודוק מהרש"ל:	Mizrachi, Genesis 10:25:4
Yeriot Shlomo on Torah, Noach 38	@11בד"ה שלא יהיה כו' לא הבינותי כו' @22נ"ב ולי נראה כמו שמסיק שאביו חזר בתשובה ואברהם לא ידע אבל אם היה ידע בודאי היה חוזר אליו או היה משלח אחריו לקיים כיבוד אביו וא"כ הבריות יטעו בזה וע"כ לא פרסם הכתוב ודוק מהרש"ל:	Mizrachi, Genesis 11:32:2
Yeriot Shlomo on Torah, Lech Lecha 1	@11בד"ה לך לך כו' ורבים ככה @22נ"ב ולי נראה דלא דמי כלל ואדרבה משם קשיא כי הלשון של אלכה היינו לפי שההליכ' תלויה ברצונו וברשותו ואם כן קרויה ההליכה אחר הרצון ודוק וכן חלף והלך לו דהיינו לעצמו ולרצונו אבל הכא שההליכה היתה ברצון הבורא ובגזירתו ולא ברצון אברהם מעצמו א"כ מהו לך לך ואדרבה לך לי הל"ל לכך פירש להנאתך ולטובתך א"כ היתה ההליכ' ממילא לרצון אברה' ודוק מהרש"ל:	Mizrachi, Genesis 12:1:1
Yeriot Shlomo on Torah, Lech Lecha 2	@11בריש הפרשה @22נ"ב מה ק' לרש"י שפי' ועוד אודיע טבעך בעולם לפי שלפירש הראשון שתלויה ההנא' בו אעשך לגוי גדול א"כ צריך אתה להגיה מבחוץ ושם אעשך לגוי גדול וזהו דוחק ע"כ פי' שההנאה הוא דרך טבעי לפי שאודיע טבעך בעולם ואעשך לגוי גדול היא ברכה בפני עצמה א"כ יקשה לרש"י איך שייכ' הברכה לכאן מאחר שהקב"ה לא בא לנסותו וגם אינו דרך תנאי לומ' שם אתה ראוי לכך כמו שפי' דעיקר ההנא' וטוב' לאו מחמת הברכות האמורו' בפסוק אלא מחמת הודעת טבעך כו' א"כ איך נתקשרו הפסוקים לכך פי' לפי שהדרך מחסר הוזקק כו' מהרש"ל:	NULL
Yeriot Shlomo on Torah, Lech Lecha 3	@11בד"ה הוזקק כו' שהבטיחו כו' @22נ"ב ויש מקשין איך הפסוקים האחרים כגון והיה ברכה וגו' איך באו לכאן ונ"ל דמחובר למעלה לואגדלה שמך כלומ' במה בעבור והיה ברכה כלומר שהברכות יהיו מסורין בידך מעתה ובמה ידעו שכך הוא שיראו שכל מברכיך מבורך וס"ס מה יהיה גידול השם בך יברכו לאמור ישימך אלהים כאברהם ודוק מהרש"ל:	Mizrachi, Genesis 12:2:1
Yeriot Shlomo on Torah, Lech Lecha 4	@11בד"ה זהו שאומרים כו' @22נ"ב אפשר שק"ל בפירש הראשון שהיה לו לכתוב והיה מבורך מה לשון ברכה אלא ש"מ על הברכה ממש קאי ומ"ה נמי מיושב למה כתב והיה ולא כתב תהי' לפי שמדבר בענין הברכה שחותמין אותו עם השם המיוחד דהיינו והיה ודוק מהרש"ל:	Mizrachi, Genesis 12:2:3
Yeriot Shlomo on Torah, Lech Lecha 5	@11אשר אראך כו' ולמה לא גילה לו כו' @22נ"ב תימה שהוא מביא לשון זה של רש"י והוא כנגדו דאי על חיבוב בנו קאי א"כ מה לחבב עליו את המצו' וג"כ קשה למה הזכיר שם יותר מצוה ובפרשת לך לך לחבבה בעיניו אלא בודאי רש"י סבר שפי' לחבבה בעיניו קאי אמה שלפניו דעדיין לא גילה והיא הארץ לכן כתב סתם לחבבה בעיניו אבל הכא מה שלפניו היא שחיטת בנו ואינו נופל עליו חיבוב אם לא בעשיית המצוה ודוק ומ"מ נ"ל שפי' אמת שרש"י הקשה ב' קשיו' האחד למה צריך להאריך ולומר מארצך וממולדתך כו' ועוד קשי' למה לא גילה לו הארץ ומה אל הארץ אשר אראך רק דרש"י ז"ל קיצר לשונו ומערב שני הקושיו' יחד וכאשר פי' תמצא להדיא בילקוט בפ' זו וכן בפ' וירא וגבי האי עניינ' איתא התם כדי לחבבה בעיניו והיינו על הארץ שהלך משם דומיא דלחבבו בעיניו דקאי על בנו ודוק מהרש"ל:	Mizrachi, Genesis 12:2:5
Yeriot Shlomo on Torah, Lech Lecha 6	@11בד"ה הראהו הר כו' אלוני ממרא @22נ"ב דמורה הוא לשון תורה ואלוני מלשון אלה ודוק מהרש"ל:	Mizrachi, Genesis 12:6:4
Yeriot Shlomo on Torah, Lech Lecha 7	@11שם נ"ב ויבן שם מזבח פירש"י על בשורת הזרע ועל בשורת א"י כו' @22יש מקשין למה לי' לרש"י לפרושי תרוייהו ונ"ל מדקאמר ויבן שם מזבח לשונו משמע שם על המקום אשר בשרוהו דלעיל מיניה נאמר לזרעך אתן את הארץ הזאת וע"כ נמי אבשור' זרע שמח ובעבורו בנה המזבח מדכתיב לה' הנראה אליו דהיינו תחילת הראייה ויאמר י"י אל אברם ויאמר לזרעך וק"ל ומה שהבטיחו הקב"ה מתחלה קודם הליכתו ואעשך לגוי גדול לא סמך כ"כ עליה לפי שהיא ברכה על תנאי ואינו דומה לברכה ממש וק"ל מהרש"ל:	NULL
Yeriot Shlomo on Torah, Lech Lecha 8	@11שם @22נ"ב פרש"י הל"ל ויהי כבואם מצרימה פירש דעיקר עניינו בשרה איירי דלקחוה לבית פרעה אבל לעיל גבי כי הקריב לבא לק"מ דאיירי באברהם כאשר הקריב אז היה מתיירא ודיבר אל שרה אשתו וק"ל מהרש"ל:	Mizrachi, Genesis 12:6:5
Yeriot Shlomo on Torah, Lech Lecha 9	@11בד"ה יתנו לי מתנות @22נ"ב ומשונא מתנו' ל"ק שלא ביקש אלא ליתנם לאחרים וכן עשה לסוף ימיו שנתן כל המתנות לבני הפילגשים מהרש"ל:	Mizrachi, Genesis 12:13:1
Yeriot Shlomo on Torah, Lech Lecha 10	@11בד"ה הללוה כו' לפרעה מ"ל כו' @22נ"ב ומהרא"י פי' מדכתיב ותקח האשה בית פרעה ולא כתיב וישלח פרעה ויקח את שרה כאשר כתיב באבימלך מהרש"ל:	Mizrachi, Genesis 12:15:1
Yeriot Shlomo on Torah, Lech Lecha 11	@11בד"ה מכת ראתן @22נ"ב אפשר מנגעים גדולים קנפיק מהרש"ל:	Mizrachi, Genesis 12:17:1
Yeriot Shlomo on Torah, Lech Lecha 12	@11בד"ה על פי כו' לא קשיא @22נ"ב ואולי לשם נמי על פי דיבורם שאמרו להדיא שלא לקדם מהרש"ל:	Mizrachi, Genesis 12:17:2
Yeriot Shlomo on Torah, Lech Lecha 13	@11בד"ה לשלחו ולשמרו @22נ"ב ונ"ל דאי לשלחו לבד א"כ היה לו לכתוב ויצו לשלחו ולא עליו כמו שכתוב אחריו וישלחו אלא ע"כ הוא ציווי זריזות מבחוץ שאינו נופל עליו עשייה כלל אלא רוב הזריזות כלומר באותו השילוח תשמריהו העיב בכל תכלית השמירה ורוב הזריזות וזה עליו על אודותיו דהיינו השלוח ודוק מהרש"ל:	Mizrachi, Genesis 12:20:2
Yeriot Shlomo on Torah, Lech Lecha 14	@11בד"ה הלך לו @22נ"ב מה שפרש"י הלך ולן תפש שני הלשונו' יחד הלך לפרוע הקפותיו ולן באכסניא הראשונה ומוכרח אתה לפרש תרוייהו דאי משום לשלם ה"ל למכתב ויחזור למסעיו ואי משום שלא ישנה ה"ל למכת' וילך במסעיו ודוק מהרש"ל:	Mizrachi, Genesis 13:3:1
Yeriot Shlomo on Torah, Lech Lecha 15	@11בד"ה לפיכך כו' שרץ ארצם @22נ"ב ולי נראה מה שהתם נכתב בלשון זכר לפי שהמקור שממנו בא השריצה הוא לשון זכר ונוכל לומר בדרך מפעיל אקב"ה שהשריץ ארצם אף על פי שאינו מפעיל מכל מקום נופל על הארץ לשון זכר בהאי סיגנו' וק"ל וכה"ג נמי בגורל יחלק את הארץ שהמחלקים זכרים היו אבל הכא דהמקור הוא מן הארץ ואינו נופל כאן לשון זכר כלל ודוק מהרש"ל:	Mizrachi, Genesis 13:6:1
Yeriot Shlomo on Torah, Lech Lecha 16	@11בד"ה אברם אין כו' בן הראוי ליורשו כו' @22נ"ב ולפי זה מיושב ג"כ למה לא הוסיף ג"כ אות אחת על שמה של שרה כמו באברהם ולמה שינה והחליף לגמרי אלא משום שמזל שלה היה כ"כ שלא תלד לגמרי ודוק מהרש"ל:	Mizrachi, Genesis 15:5:1
Yeriot Shlomo on Torah, Lech Lecha 17	@11בד"ה שאל לו אות כו' ניסים רבי' שהציל כו' @22נ"ב ולי נראה דירושת הארץ שתלוי בקילקול מעשה האומות כמו שאמר הכתוב לא בצדקתכם כ"א ברשעת הגוים האלה וא"כ היה מתיירא שמא יעזבו מעט ממעשיהם וה' ירחם עליהם וק"ל ומה שמסיק אח"כ ד"א ה"פ לעולם אפי' ירושת הארץ האמין אלא ששאל אות במה יתקיימו שלא תקיא הארץ אותו מהרה ודוק מהרש"ל ומ"ש ולי נראה דירושת הארץ כו' תימה למה תלה דבר זה בדברי עצמו הלא כבר קדמוהו הרמב"ן ז"ל שכתב כן והיותר תימה עליו וכי לא שפיל לסיפא דדברי הרא"ם ז"ל שכתב להדיא הכי בשם הרמב"ן ז"ל וסותר דבריו כמו שהוא מבואר בהדיא בדבריו דהכא וצ"ע כנ"ל:	Mizrachi, Genesis 15:6:1
Yeriot Shlomo on Torah, Lech Lecha 18	@11מה שפירש"י ויצחק ויגר בגרר @22תימא דמקרא זה באברהם כתיב ונראה דט"ס הוא וה"ג ויצחק גור בארץ הזאת ודוק כן נ"ל:	NULL
Yeriot Shlomo on Torah, Lech Lecha 19	@11פירש"י אביו עובד ע"ז והוא מבשרו כו' @22אינו בלשון קושיא אלא בניחות' ועיין לעיל בס"פ נח ויש נוסחאו' משובשו' ואל תשגיח בהן מהרש"ל:	NULL
Yeriot Shlomo on Torah, Lech Lecha 20	@11בד"ה מועד הקבוע כו' תן לי ערב כו' @22פי' שאם נשא אות' קודם זה הזמן או אחריו שלא היית שואל למה לא נשא אותה קודם אותו הזמן או אחריו כנ"ל:	Mizrachi, Genesis 16:3:2
Yeriot Shlomo on Torah, Lech Lecha 21	@11בד"ה אמרה שרה אין סתרה כו' @22נ"ב וק"ל מה היתה טענת הגר על שרה שלא נתעברה הלא עקרה היתה וכמה צדקות שאינן מתעברות ונ"ל דה"ק מאחר שאני נתעברתי מביאה ראשונה והייתי בתולה אעפ"י שאין האשה מתעברת מביאה ראשונה אפ"ה זכותו של אברהם גרם ופעל חוץ לטבע א"כ למה לא הועיל גם זכותו אף לשרה אלא בודאי במעשיה קלקלה ודוק מהרש"ל:	Mizrachi, Genesis 16:4:2
Yeriot Shlomo on Torah, Lech Lecha 22	@11נ"ב ואברהם בן שמונים שנה וגו' @22פירש"י לשבחו של ישמעאל כו' הקש' מהרא"י והלא פסוק מלא הוא ותירץ בדוחק להודיע אף שמלאו לו שנותיו ול"נ דלא קשה מידי כי מן הפסוק אין ראיה שלא עכב דדלמא עכב ואברהם מל אותו שלא בטובתו ובע"כ לכך כתב שנותיו קודם שציוה המילה כדי להודיע על המילה שנצעוה שהיתה ברצון אעפ"י שהיה בן י"ג ודוק מהרש"ל:	NULL
Yeriot Shlomo on Torah, Lech Lecha 23	@11בד"ה שאף יוד כו' הרי"ש של אברהם @22נ"ב וק"ק מה בכך שיתרעם הלא היו"ד בלאו הכי מתרעם ונ"ל דיו"ד אעפ"י שהתרעם מ"מ הקב"ה פייס' שנתנה בראש הצדיק יהושיע כדאית' במדרש מה שלא היה יכול לפייס הרי"ש ועי"ל היו"ד התרעם אעפ"י שהקב"ה חלקה ונתן הי"א אחת לה והי"א אחת לאברה' ואם היה לוקח רי"ש בלא חילוק איך היה מתרעם ודוק מהרש"ל:	NULL
Yeriot Shlomo on Torah, Lech Lecha 24	@11בד"ה יש תמיהות כו' גם זו מהמכחישות היא כו' @22ונראה דודאי היא תמיה קיימת ומה שפרש"י הנעשה חסד זה לאחר הוצרך לזה דאל"כ לא הוי אפי' תמיה קיימת דמאי רבות' היא לכן פירש הנעשה חסד זה לאח' כו' וא"כ שפיר תמיה קיימת היא ומה שלא פי' הלבן מאה שנה יולד על אחר והוי תמיה מכחשת משום דמפרש דומיא ואם שרה הבת תשעים כו' שהוא בע"כ תמיה קיימת ודוק כנ"ל:	Mizrachi, Genesis 17:17:1
Yeriot Shlomo on Torah, Lech Lecha 25	@11בד"ה ואעפ"י שדורות כו' שנתמעטו השנים @22נ"ב ול"נ דעיקר הקושי' הי' מתחילה כך אעפ"י שדורות הראשונים הולידו עד שהגיעו יותר מחצי ימיהם והגיעו לזקנה למה לא הוליד נמי אברהם לק' אעפ"י שהית' יותר מחצי ימיו והגיע לזקנה לכך תירץ שנתמעטו השני' ומה שהקשה שנח על פי הגזירה היה לא נ"ל כי לא היה בגזיר' אלא מה שנסתם מעיינו אבל מה שהוליד אחר ה' מאות לא היה בגזירה אלא בטבע ודוק ומה שכתב רש"י אח"כ שמיהרו תולדותיהן כו' ה"ק בתחילה לא היו ראויים להוליד מיד אלא לאחר ק' וק"ה שנים כי באותן השנים הי' בן מאה נער כבן י"ג עכשיו וכן לעונשים כדפרש"י לעיל ואח"כ נתמעטו השנים שהתחילו להוליד לל' שנים וק"ל והא ראי' שעכשיו מולידין לי"ד וט"ו ודוק ומאדם הראשון שהוליד מיד אין ראי' שהי' בגן עדן ומה שהוליד אברהם אח"כ לבן ק"ס שנים לק"מ כי עיקר התימה שזקן שנחלש פעולתו יוליד עם זקנה וזו היתה תמיהת שרה ואדוני זקן וק"ל מהרש"ל:	NULL
Yeriot Shlomo on Torah, Lech Lecha 26	@11בד"ה יחיה כו' אינו עושה @22נ"ב מה שפירש רש"י וקראת שמו יצחק בעבור י' נסיונות ולא סגי לו בשם של צחוק לבד דאם כך למה לא ציוה לו לקרותו צחוק ומדיו"ד לדרשה כולהו לדרשה מהרש"ל:	Mizrachi, Genesis 17:18:2
Yeriot Shlomo on Torah, Lech Lecha 27	@11בד"ה שמלאו לאברהם צ"ט @22נ"ב נראה בעיני מה שלמד הכתוב שמלאו שנותיו היינו להודיע מעלת המילה כאלו עכשיו נולד כגר שנתגייר ולכן מילא שנותיו מתחילת הלידה עד המילה ומן המילה עד הלידה כי הקדו' ברוך הוא מילא שנותיהן של צדיקים מיום אל יום ודוק מהרש"ל:	Mizrachi, Genesis 17:25:1
Yeriot Shlomo on Torah, Vayera 1	@11בד"ה לבקר את החולה כו' הוא דמפקי לה @22נ"ב ולי נראה דעיקר הראייה מדלא כתיב וירא ה' אל אברהם כמו שכתיב בפרשת לך לך אלא סמיך אדלעיל מיניה ש"מ דאיירי בעניינ' דמילה וק"ל א"נ לשון אליו משמע שהראייה היתה אליו לבד כלומר שלא כדרך שאר הראיות שהם בגזירת רצון הבורא ית' לציווי' אבל כאן לא בא רק אליו כלומר לבקרו ודוק מהרש"ל:	Mizrachi, Genesis 18:1:1
Yeriot Shlomo on Torah, Vayera 2	@11מה שפירש רש"י שאין מלאך אחד עושה ב' שליחות @22תימה דבפ' חלק איתא שאמר הקדוש ברוך הוא לגבריאל כשאתה הולך לבשל פירות הזקיק להם הרי בישול פירות והריגת סנחרב פענח רזא ונ"ל ליישב דבישול פירות לא קרוי שליחות דמעולם נתמנה גבריאל על בישול פירות וכן משמע לישנא דכשאתה הולך לבשל פירות ודוק כנ"ל:	NULL
Yeriot Shlomo on Torah, Vayera 3	@11מה שפירש רש"י מכאן שאל ישנה אדם מן המנהג @22יש מקשין דלמא לאו משום הכי עשו כן אלא משום שלא יצטער אברהם אם לא יאכלו דהא משום זה נשתלחו בצורות בני אדם ונראה דאי משום כבודו של אברהם ה"ל למכתב והיו כאוכלים דלישנא דויאכלו משמע כאלו היתה אכילה ממש והיינו מכאן שאל ישנה מביאורי מהר"י העכננן ז"ל:	NULL
Yeriot Shlomo on Torah, Vayera 4	@11בד"ה יום שלישי כו' היום הג' כו' @22נ"ב ולי נראה דבודאי לא היה ביום המילה דאין שייך שם ביקור חולה אלא צער בעלמא בשלמא ביום ג' כתיב בהיות' כואבים ואפשר שהחולש' היתה מתגברת עליו כאשר אפרש לקמן מהרש"ל:	Mizrachi, Genesis 18:1:2
Yeriot Shlomo on Torah, Vayera 5	@11בד"ה ישב כתיב כו' @22נ"ב יש מקשין איך בא הסימן לכאן שא"ל הקדוש ברוך הוא שהוא סימן שיהיו בניך יושבין בעדת הדייני' כו' ונראה לי מדכתיב לפניהם ולא לפני הגוים אפילו הם דנין כדייני ישראל אם כן ש"מ שהדין תלוי בישראל שהוא נימול ומבניו של אברהם שקבל עליו את הברית ועל כל זרעו ע"כ הראה לו סימן בדייני' וק"ל מהרש"ל ומה שפירש בקש לעמוד וכו' דיוקו דרש"י דכשהוא חסר וי"ו משמע ישב בציר"י היו"ד ר"ל שביקש לעמוד א"ל הקדוש ב"ה שב וזהו ישב כן נראה לי:	Mizrachi, Genesis 18:1:5
Yeriot Shlomo on Torah, Vayera 6	@11בד"ה שאין מלאך א' כו' שתי שליחות @22נ"ב ותדע שכתב רש"י מגומגם מאוד וקבלתי מאמ"ז שה"ק דלמא לעולם לא משום שאין מלאך אחד עושה ב' שליחות אלא משום ששלשה היו נזקקין לשליחות אחד על זה אמר תדע ודוק מהרש"ל:	Mizrachi, Genesis 18:2:2
Yeriot Shlomo on Torah, Vayera 7	@11בד"ה ורפאל שרפא את אברהם כו' @22נ"ב ותימה דלמא היה נתרפא מאליו וי"א דאי אפשר שאדם חולה מיד שנתרפא שיהיה בבריאותו שירוץ לפני אורחי' לשמש לפניהם ולי נראה מאחר שהוא לא היה חולה בעבע אם כן בוודאי צריך רפואה וק"ל מהרש"נ:	Mizrachi, Genesis 18:2:3
Yeriot Shlomo on Torah, Vayera 8	@11בד"ה ושתי הל' כו' למדנו זה @22נ"ב יוקח נא מעט מים פירש רש"י על ידי שליח כלומר המים שלא לקח בעצמו אלא ע"י שליח לכן לא נתן הקב"ה המים לישראל בעצמו אלא על ידי שליח דהיינו על ידי משה ואהרן ובא תקלה גדולה על ידי זה שנלקו משה ואהרן ולא הכניסם לארץ ישראל אבל הלחם שלקח בעצמו שנאמר ואקחה פת לחם הקדוש ב"ה שילם בעצמו והמטיר להם המן בלתי שום אמצעי וק"ל מהרש"ל:	Mizrachi, Genesis 19:24:1
Yeriot Shlomo on Torah, Vayera 9	@11בד"ה ורחצו וכו' מהפילוסופים היו כו' @22נ"ב והנראה בעיני לפי שהיו עובדין לחמה שכל האבק מתהוה בה בעת זריחתה כדאיתא ביומא וכל דיירי ארעא כלא חשיבי ואם כן האבק שהוא ברגלי' והוא מכוסה שאין החמה שולטת בו היו משתחוין לו כלומר להוכיח שאף זו תחת כח החמה אף שאינה שולטת בו בזריחת' מהרש"ל:	NULL
Yeriot Shlomo on Torah, Vayera 10	@11בד"ה שאף לשרה כו' @22נ"ב ויאמרו אליו איה שרה אשתך אמר רב יהודה אמר רב יודעין היו מלאכי השרת שרה אמנו באהל היתה אלא מאי באהל כדי לחבבה על בעלה פירוש שצנועה היתה רבי יוסי ב"ח אומר כדי לשגר לה כוס של ברכה תנא משום ר' יוסי למה נקוד על אי"ו שבאליו לימדה תורה דרך ארץ שישאל אדם באכסני' שלו והאמר שמואל אין שואלין בשלום אשה כלל על ידי בעלה שאני עכ"ל הגמרא ופירש"י נקוד על אי"ו שבאליו והלמ"ד אינה נקודה. לימדה תורה כו' והיינו נקודת אי"ו דלא היו צריכין לשאול שיודעין היו שהיא באהל שכל נקודה עוקרת התיבה שאינה אלא לדרשה ודריש מינ' דרך ארץ. באכסני' אשת אושפיז' עכ"ל וכתבו התו' למה נקוד על אי"ו בב"ר אי"ו נקוד למ"ד אינו נקוד אר"ש כל מקום שאתה מוצא הכתב מרובה על הנקודה אתה דורש הכתב וכשאתה מוצא הנקודה רבה על הכתב אתה דורש הנקודה וכאן שהנקודה רבה על הכתב אתה דורש הנקודה כלומר איו אברהם א"ר עזרי' כשם ששאלו לאברהם איה שרה כך שאלו לשרה איו אברהם וה"נ הוי פירש הכי אבל לפירש הקונטריס ק' למה נקוד על אי"ו שבאליו ה"ל לנקוד על איה שרה אשתך שהיא עיקר השאלה ששאלו עליה עכ"ל התו' ומה שכתב מחבר זה כאלו התוספו' לא הבינו כוונת רש"י ז"ל כי רש"י סובר כמותם לא נהיר' אלא רש"י בודאי מבין דברי רבי יוסי כפשוטו שקאי על הא דלעיל שיודעין היו מלאכי השרת וכולן באו לתרץ למה שאלו המלאכים ע"כ רבי יוסי נמי תירץ שלמדה דרך ארץ כו' ועל זה שאל התלמו' שפיר הלא אין שואלין כו' ואם כן מה בא התורה ללמדינו אבל מה ששאלו לשרה על אברהם לא מזכיר התלמוד כלל והב"ר חולק על ר' יוסי ומכל מקום רש"י הכריע כדעת הב"ר משום דק"ל מה שהקשו התוספות דה"ל נינקוד על איה שרה אשתך כו' ומכל מקום סבירא ליה גם כן הא דרבי יוסי שהתורה בא ללמדינו דרך ארץ דאם לא כן היה לו לינקוד על למ"ד לבד ומה שתירץ רבינו בחיי שהיה נראה כזקף כו' נ"ל כחוכ' וטלולא על כן נראה שבשיט' זו מתורץ כל היכא שהנקודה מרובה ואתה דורש הנקודה כלומר שכבר ידעו ולא באו אלא ללמדך דרך ארץ ומאחר שעיקר השאל' הנאמרה בפסוק לא נאמרה אלא לדרך ארץ ק"ו אותה השאלה המרומזת בפסוק באי"ו ששאלו לשרה איה אברהם שאינ' אלא לדרשה ולדרך ארץ ומה שכתב מחבר זה שטעות הוא ואסור לא נ"ל לפי' התוספות שמפרשין הבריית' דרבי יוסי כדברי ב"ר ואינן סוברין כפירש רש"י שבא הנקודה לעקור כו' אם כן מה שואל התלמוד והלא אין שואלין או מה אמר רבי יוסי שבא התלמוד ללמדך דרך ארץ מניין לו והלא לא ילפינן מקרא אלא ששאלו גם כן לשרה איה אברהם אלא ש"מ לפירש התוספות שס"ל מאחר שלימדנו הכתוב ששאלו לשרה איה אברהם על כן אינו אלא ללמדנו דרך ארץ דאי לא תימא הכי הדר' קושיא דתלמודא וכי לא ידעו מלאכי השרת כו' דלא שייך לתרוצי כאן כמו שתירץ על השאלה ששאלו לאברהם איה שרה כדי לשגר לה כום של ברכה או כדי לחבבה על בעלה משום צניעות והכא לא שייך שום תירוצא אלא ללמדך דרך ארץ בהכרח שהמנהג הוא לשאול באכסני' לבעל על אשתו היכן היא וכן להיפך לאשת אושפיז' הא לך ראייה שלפירש התו' ע"כ שריא ולפירש"י נמי שרי כדפי' מהרש"ל:	NULL
Yeriot Shlomo on Torah, Vayera 11	@11בד"ה מדלא קרינן כו' כעת של חיות @22נ"ב כלומר כדרך הנשים היולדות לט' חדשים מהרש"ל ואין הלשון משמע כן דאם כן הל"ל כעת של חיה אלא הא דקאמר כעת של חיות ר"ל כעת של חיים ודוק כן נ"ל:	NULL
Yeriot Shlomo on Torah, Vayera 12	@11בד"ה לא בשרו כו' על הסדר שהוא @22נ"ב ולי נרא' דה"פ מיד שפיר' דכעת בקמ"ץ קאי על הזמן הזאת אם כן ק"ל הלא הקב"ה אמר ליה ביום המילה לשוב אליו וא"כ איך אמר המלאך בג' למילתו כעת הזאת בשנה האחרת אלא וודאי צ"ל דכעת הזאת דקאמר המלאך קאי על העת שאמר הקב"ה אל אברהם ביו' המילה וא"כ ק' וכי ידבר המלאך על העת שקבע לו הקב"ה ובודאי זה העת הוא שקבע המלאך ע"כ פירש דהרי אמר המלאך שוב אשוב וע"כ בשליחתו של מקום הוא כמו שמוכח מקרא שלאחריו שאמר ה' למועד אשוב אליך כו' אם כן מאחר שלא דיבר המלאך כי אם בשליחתו של מקום אם כן בודאי קאי על העת הראשון שקבע הקב"ה ביום המילה ודוק מהרש"ל:	NULL
Yeriot Shlomo on Torah, Vayera 13	@11בד"ה פסק ממנה דרך נשים @22נ"ב ואף ע"פ שחזר לה אורח כנשים זהו וסת שלא בזמנו שהוא מקולקל והיא לא ידעה שיהיה מאותה ראייה וסת כדרכה כאורח הנשים עד ימי העיבור שהו' ג' חדשים שהרי מאותו זמן היה שנה ללידתה וק"ל מהרש"ל ומ"ש עד ימי העיבור שהו' ג' חדשי' כו' תימה הלא בר"ה היתה נפקדה והיתה יולדת לז' מקוטעין כדאיתא במסכת ר"ה והביאו הרא"ם ז"ל לקמן בסמוך בד"ה סמך פרשה כו' כן נראה לי:	NULL
Yeriot Shlomo on Torah, Vayera 14	@11בד"ה שינה הכתוב כו' @22נ"ב ועיקר הביזוי לאברהם שזכותו לא ינצח חולשת הזקנה וק"ל מהרש"ל:	NULL
Yeriot Shlomo on Torah, Vayera 15	@11בד"ה ד"א ארדה @22נ"ב משום דלפי' הראשון קשה הלא אינו דומה כלל לנרד' ונבלה שפתם דהתם הוא פסק הדין והכא ארדה ואראה ולא פסק שום דבר ולא שייך לימד לדייני' אלא בע"כ צ"ל ארדה לבסוף מעשיהם וזו לבד אינו מספיק דא"כ לכתו' אראה וארדה כו' ודוק מהרש"ל:	NULL
Yeriot Shlomo on Torah, Vayera 16	@11בד"ה הכצעקת' כו' כבדה מאד @22נ"ב מה שפירש ריבה אחת כו' ס"ס הדרי' קושי' לדוכת' ומי איכא ספיקא קמיה שמיא שצריך לירד ולראות ואת"ל שזהו דרך דרש ס"ס קשיא וכי שייך לדרוש מה שהוא חירוף וגידוף כלפי מעלה ועוד היה לו לכתוב ורבותינו דרשו לעיל על הכצעקת' וק"ל ועוד איך מיושב כל המקר' ואם לא אדעה ולכן נ"ל דה"ק צעקת ריבה כלומר וכך אמר המקום אם כך הוא כצעקתה שבעבו' שנתנה לחם הרגו' אעשה כלה ואם לא הרגוה בעבור זה מכל מקום אדעה ולמדה תורה גדול עונש של הריגה וק"ל מהרש"ל:	Mizrachi, Genesis 19:24:5
Yeriot Shlomo on Torah, Vayera 17	@11בד"ה ולכל אלה כו' פיוס התשחית בחמשה @22נ"ב ואני אומר פיוס חליל' לך השופע כל הארץ כו' תפיל' הואלתי לדבר כו' מהרש"ל:	NULL
Yeriot Shlomo on Torah, Vayera 18	@11בד"ה דבר הזה כו' ולא דכוותי' @22נ"ב נ"ל לא זו צדיקים אלא אפי' בינונים אינם ראוים למות על הרשעים כו' וק"ל מהרש"ל:	NULL
Yeriot Shlomo on Torah, Vayera 19	@11בד"ה חלילה לך כו' פירש שהשני כו' @22נ"ב ונ"ל כפשוטו חלילה בעולם הבא שהוא חילול שמיך והבריות מתוך זה יבואו למינות ואפי' לעולם הבא שכל הנשמו' מסורין בידך ואין שייך שם חילול השם מ"מ חלילה שיסבול הצדיק בעון הרשע ודוק מהרש"ל:	NULL
Yeriot Shlomo on Torah, Vayera 20	@11בד"ה הואלתי כו' @22נ"ב ויש מקשין למה לא פירש על הואלתי הראשון שהוא לשון רציתי ואני אומר שגם קשה לי למה לא אמר אברהם בתחילה הואלתי ובפעם הרביעי כשבקש על עשרים חזר ואמר הואלתי אלא נראה דהואלתי שכתב באחרונה הוא לשון רציתי וכאלו היה מבקש רשות מהשם יתברך לבקש ממנו דבר חדש ומופלא כי בתחילה ביקש על הצירוף וא"כ כשהקב"ה הבטיח לו על הצירוף א"כ ממילא ביקש ארבעים אפילו ע"י צירוף וכן שלשים יצילו לפי ערך עד כשבקש על עשרים שזהו ענין חדש שהוא המיעוט מן החמשים שהבטיחו הקב"ה מתחילה דשמא זכות של רבים יועילו וק"ל ומ"ה לא פירש"י על הואלתי הראשון דבודאי הוא לשון התחלה אבל הואלתי האחרון הוא קשה דאי לשון התחלה הוא או יאמר בכולן או בפעם הראשון לחוד ותו לא אלא בודאי הראשון הוא התחלה והשני הוא רציתי ודוק מהרש"ל:	Mizrachi, Genesis 19:24:5
Yeriot Shlomo on Torah, Vayera 21	@11בד"ה ואצל לוט @22נ"ב האי דבר אחר שפירש רש"י נראה משום דלפי' הראשון קשה לאיזה תועלת בא להודיע שאצל השכינה היו כאנשים וכי לא ידעינן כבר מעלות השכינה אלא בא להודיע מעלות אברהם כו' וזו לבד אינו מספיק דאם כן לכתוב בתרוייהו אנשים וממילא אנו יודעין שמשום מעלות אברהם הוא דאם לא כן לכתוב בתרוייהו מלאכים אלא צריך לומר דאי הוי כתב בתרוייהו אנשים לא הוי ידעינן מעלות אברהם ולא היה קש' לכתוב בתרוייהו מלאכים ומשום שכינה ולא הוי אמרינן כלל שבא להודיע כולו ודוק מהרש"ל:	NULL
Yeriot Shlomo on Torah, Vayera 22	@11בד"ה אותו היום כו' @22גמרא ול"נ דקראי קדרשי וישפוט שפוט וק"ל מהרש"ל:	NULL
Yeriot Shlomo on Torah, Vayera 23	@11בד"ה יפשוטו כו' מפני הקושיא @22נ"ב ול"נ דה"ק תעשה חסד זה עמדי להציל העיר הזאת בעבורי עד שאמלט ואחר כך תעשה עמה מה שתרצה מה אתה אומר אתה צריך למעשה אחר להפוך אות' ולעשות דין עליה ביחידי מאחר שקרובה היא אל העיר וקטנה היא א"כ היא בעיבורה של העיר וממילא כשאמלט מן העיר תכלה מעצמ' בכל גזירת העיר ודוק מהרש"ל:	NULL
Yeriot Shlomo on Torah, Vayera 24	@11בד"ה ארבעתן יושבות בסלע כו' @22נ"ב ונ"ל דדייק מדכתיב ויהפוך את הערים ולא כתיב ויהפכם ש"מ דכל הערי' היו נהפכין בהפיכה אחת ומדלא כתיב ויהפוך סדום ועמורה וממילא שמעי' כולן וכתב ויהפוך הערים האל כלומר מיעוטו הוא ולא כולם וקרא דאתם נצבים ותהילם מסייעים לנו וק"ל אבל הב"ר סבר מ"ה כתב בקרא ארבעה שהיו נהפכין כאחת אבל צוער שהיא החמשית נהפכה מעט אחר כך וכדרך שאדם הופך דף ארוך שמתחיל צד אחד לירד למטה קודם שיתהפך צד השני ובתוך שעה זו נמלט ודוק מהרש"ל:	Mizrachi, Genesis 19:25:1
Yeriot Shlomo on Torah, Vayera 25	@11בד"ה מאחריו כו' לפרוש בו הוא @22נ"ב ולי נראה דהכי קאמר כוונת אשת לוט היתה למה ציוה המלאך שלא נביט אחרינו שאנחנו אינם כדיים כו' בשלמא אני לא הנחתי ליתי לעני מלח אבל בעלי כדאי שהרי הוא היה מגמל חסידים ובזכותו אני ניצול ובעבורו היתה מבטחת שלא תזוק וזהו מאחריו של לוט ודוק מהרש"ל:	Mizrachi, Genesis 19:26:1
Yeriot Shlomo on Torah, Vayera 26	@11בד"ה כשהיה שומע כו' רק על הניצול @22נ"ב ומהרא"י ז"ל פירש משום שלא הזכיר כאן שום קורב' לומר את לוע בן אחיו או אחיו כמו שכתב לעיל כי נשבה לוט אחיו ש"מ דאותה זכירה לא היתה בעבור שום קורבה וקל להבין ואני אומר שהמסורת תוכיח שמביא עוד התם ג' ויזכור אלהים את נח ויזכור אלהים את רחל ויזכור אלהים וישמע את נאקתם והני כולהו משמע שהקב"ה זכר עתה דבר שלא היה נזכר זמן מה כגון נח שהיה כמה ימים בתיבה ורחל כמה שנים שהיתה עקרה וישראל במצרים וכל זה אינו שייך על לוט שהרי הצילו מיד אלא אזכירה שזכר לו הקב"ה שלא גילה כו' והיינו שבנתיים היו עליו כמה מאורעות ולא שילם לו הקב"ה אותה מצוה עד עתה שאין שייך לומר על אברהם ודוק מהרש"ל:	Mizrachi, Genesis 19:29:2
Yeriot Shlomo on Torah, Vayera 27	@11בד"ה ובקומה של בכירה נקוד @22נ"ב יש מקשין א"כ למה כתב המקרא דבר שאינו ונראה בודאי לא ידע בקומה כדרך המשתכרין אבל אחר כך שהתחילה הצעירה לשתות עמו הרגיש ונזכר ואפ"ה לא מנע מלהשתכר עוד מהרש"ל:	Mizrachi, Genesis 19:33:3
Yeriot Shlomo on Torah, Vayera 28	@11בד"ה שיצא עליו שם רע @22נ"ב וק"ק הלא הקב"ה זימן להם יין בתוך המערה אלמא דמצוה היתה דלולי זה אין הקב"ה מסייע ידי עוברי עבירה ונ"ל מה שהזדמן להם יין משום כבודו של אברהם דגלוי היה לפניו דאף בלא שכרות היו מזנין עם אביהם ע"כ ברא הקב"ה דבר מכסה קלון וק"ל מהרש"ל:	Mizrachi, Genesis 20:1:2
Yeriot Shlomo on Torah, Vayera 29	@11בד"ה אבל נקיון כפים @22נ"ב ויש מקשין מה צריך נקיון כפים מה שלא דימה לחטא כלל ונר' דה"ק אמת שלא דימת לחטא מתחילה אבל אח"כ שהית' עמך והגיד לך המלאך שהיא בעולת בעל לא היית יוכל למשול ברוחך ולהתאפ' ביצרך לולי שלא הנחתי אותך וק"ל מהרש"ל:	NULL
Yeriot Shlomo on Torah, Vayera 30	@11לעיל בד"ה לפי שכבר כו' @22לא יתכן לומר כולו הג"א כתב דדברי הרא"ם שבכאן אינם מובנים ונראה דבודאי בספרו של הרא"ם ז"ל לא היה כתוב ברש"י כמו שהוא לפנינו כאן לא נטל רשות אלא על כרחה שלא בטובתה לפי שכבר לוקחה לבית פרעה ע"י כן דגיר' זו בודאי כפשוטו היא דלכך לא נטל רשות משרה נומר לה אמרי נא אחותי את דבודאי לא היתה מתרצית מאחר שכבר לוקחה לבית פרעה עי"כ לכך אמר הוא בעצמו הכי בע"כ אלא הרא"ם היה גורם בדברי רש"י כאן לא נטל רשות לפי שכבר לוקחה לבית פרעה עי"כ ואף דגם גירסא זו יש לפרש כמו לפי גירס' שלפנינו הרא"ם ז"ל מפרש אותו בענין אחר דלכך לא נטל רשות לומר לה אמרי נא אחותי את לפי שכבר לוקחה לבית פרעה עי"כ פירש בחזקת אחותו וכבר היתה מוחזקת באותה חזקה שהיא אחותו לכן לא הוצרך לומר לה אמרי נא אחותי את דודאי לא יתכן לחשוב ולומר שהיא אשתו אבל אם כך דעתו תימה על דבריו וכי לא נודע ג"כ הסוף המעשה שהיא אשתו ודוק כנ"ל:	Mizrachi, Genesis 20:2:2
Yeriot Shlomo on Torah, Vayera 31	@11בד"ה אכסנאי שבא @22נ"ב יש מקשין למה לא השיב אברהם לפרעה כן ונ"ל שהמדקדק בקרא לק"מ שהרי אף לאבימלך לא השיב כששאלו מה עשית כו' כי היה יודע שאין לו להשיב שס"ס עשה להם רעה גדולה עד ששאל אותו אבימלך שנית ומה עשית פי' כלומר מה עלה בדעתך ואז השיב לו ודוק א"נ משום כבוד מלכות לא רצה להשיב אין יראת אלהים במקום הזה אם לא גבי אבימלך שהיה מוכרח להשיב מהרש"ל:	Mizrachi, Genesis 20:11:1
Yeriot Shlomo on Torah, Vayera 32	@11בד"ה ולשר' אמר שהאלף כסף @22נ"ב ולי נראה דבודאי נתן לו הצאן והבקר כדי שיתפלל עליו והשיב לו שרה אשתו כמו שנצטוה מפי ה' ואח"כ נתן מעצמו אלף כסף מפני כבוד של שרה ומ"מ אמר לשרה נתתי לאחיך כלומר שלא יאמרו שלחתיה ריקם אחר שנתעוללתי בה והצאן ובקר משום שיתפלל ע"כ הוספתי אלף כסף לכסות עינים ומה שלא נתן לה הוא משום שלא יאמרו מחמת תשלום תשמישו נתן לה באתנן ודוק מהרש"ל:	NULL
Yeriot Shlomo on Torah, Vayera 33	@11בד"ה סמך פרש"י כולו תימה דמהא כו' @22נ"ב ואני אומר שהויו מורה על הסמיכות ולמידרש הכי דלא שייך למידרש כאן הוא ובית דינו ודוק מהרש"ל:	Mizrachi, Genesis 21:1:1
Yeriot Shlomo on Torah, Vayera 34	@11בד"ה והביא היורש כו' העתידה להיות @22נ"ב ופי' לידה הוא שיהא נולד ממך בן קיימא שיהא ראוי לירש אותך ולא בסתם לידה ודוק מהרש"ל:	Mizrachi, Genesis 21:1:4
Yeriot Shlomo on Torah, Vayera 35	@11בד"ה כאשר כו' אמר לאברהם @22נ"ב ונ"ל דצריך לפרש דבשלמא גבי כאשר אמר לא צריך לפרש לאברהם כי לשרה אמר אעפ"י שלא דיבר הקב"ה עמה מ"מ עליה אמר כאשר יאמר אמרי לי דהוא לשון עלי וק"ל אבל מה שדיבר דהיינו לא ירשך זה לא מורה על שרה כלום ונוכל לומר שעל ישמעאל קאי רק שהקב"ה הביא היורש משרה א"כ מפרש רש"י כאשר דיבר לאברהם והבטיח אותו שלא ירשנו אלא מיוצאי חלציו ואותה הברכה נתן לשרה ודוק מהרש"ל:	Mizrachi, Genesis 21:1:5
Yeriot Shlomo on Torah, Vayera 36	@11בד"ה לסוף כ"ד כו' בפ' אעפ"י @22נ"ב ס"ס ק' מניין שהניקה אותו עד תשלם ב' שנים דלמא הפסיק אות' קודם כמו שמצינו בזמנינו בחולשת הטבע ונראה לי דדייק מדכתיב ויגמל ולא כתיב ויגמליהו אלא משמע כאלו נגמל מעצמו שהיה ינק שדי אמו עד סוף תמצית השיעור ששיערו חז"ל ודוק מהרש"ל:	Mizrachi, Genesis 21:8:1
Yeriot Shlomo on Torah, Vayera 37	@11בד"ה חזרה @22נ"ב ואני אומר דאי כפשוטו ה"ל למכתב ותלך במדבר ותתע דאז היה פירושו שהיה מתעתע במדבר אבל עכשיו דכתיב ותתע במדב' משמ' שתיתע דרך הילוכה וק"ל מהרש"ל:	Mizrachi, Genesis 21:14:3
Yeriot Shlomo on Torah, Vayera 38	@11בד"ה מכאן כו' מבית האסורין @22נ"ב ואני אומר דוקא בסתם בני אדם ובסתם חולים אבל היכא שיש גזר דין וצריכין תפילת צדיק לבטלה כה"ג תפילת צדיק אחר עדיף מהרש"ל:	Mizrachi, Genesis 21:17:1
Yeriot Shlomo on Torah, Vayera 39	@11בד"ה אמרו לו צחק כו' אך ק' כיון @22נ"ב ואני אומר לכל הפירושים היה צדיק כיון שהיה מתחרט על עונותיו ואפשר היה מתודה עליהם ומשום הכי שמע הקב"ה לתפלתו אלא שהמלאכי' אמרו וכי בעבור זה אתה עושה לו נם שממנו תקלה יצא לישראל כלומר שאם לא תעשה לו נס א"כ ממילא יתבטל הצרה מישראל וא"כ השיב לו המקום ס"ם היה צדיק מאותו עון וק"ל ואין להקשות מבן סורר ומור' שנידון על שם סופו דלא מצינו שיהא אדם נידון על שם מעשה בניו מהרש"ל ובספר דברי שלום סתר תירוץ זה דא"כ למה הוצרך להשיב הקב"ה למ"ה דלפי מעשה של עכשיו הוא נידון תיפוק ליה דהוא עצמו לא חטא רק בניו:	Mizrachi, Genesis 21:17:3
Yeriot Shlomo on Torah, Vayera 40	@11בד"ה יורה כו' רובה קשת @22נ"ב ותימה הלא אח"כ מפרש קשת אומן כמו חמר גמל לכן אני אומר שמתחילה קשה לו וכי יורה קשת והלא חצים הוא יורה על כן הוא מפרש יורה חצים בקשת ומ"מ קשת הוא אומן וצריך אתה לפרש כך הוא יורה חצים בקשת ובאיזה ענין הוא יורה לא כדרך היורים כמתלהלה או להראות אומנות או לצוד בו אלא היה יורה כדרך קשת בעל קשת שהוא אומן כלומר המלסטם את הבריות וכן פירש"י ודוק ומלת בקשת שפירש"י בתחילה הוא לשון רש"י ובא לתואר ולא לפרש ודוק מהרש"ל:	Mizrachi, Genesis 21:20:1
Yeriot Shlomo on Torah, Vayera 41	@11נכתב בצד הגליון וז"ל @22חיבור על המקרא ויאמר יצחק אל אברהם אביו ויאמר אבי כלומר הלא אבי אתה ואיה רחמיך המרובים עלי שאתה מבקש לשחוט אותי ולהקריב ויאמר לו אברהם הנני בני כלומר אתה בני יחידי והנני מוכן לאהבתך וממני אל תירא והשיב יצחק א"כ הנה העצים והאש ואיה השה לעולה והשיב אברהם לא ממני הוא אלא אלהים יראה לעולה בני במקום השה ואז הלכו שניהם יחדיו בשמחה ומה ששיבח המקום את אברהם ונתן לו המעלה יותר מליצחק כאשר טען ר' אברהם אבן עזרא נראה דלק"מ דבודאי כל אדם מרוצה לשחיטה ע"פ הקב"ה כי יודע שהוא מזומן לעולם הבא וטוב שעה אחת בעה"ב כו' ובפרט מאחר שה' בחר בו א"כ יגיע למעלה גדול' אבל אברהם לא נתעלה בזה דס"ס ילך ערירי בלא יורש ובלא זרע ראוי וק"ל מהרש"ל:	NULL
Yeriot Shlomo on Torah, Vayera 42	@11בד"ה ולמה לא כו' לחבב את בנו @22נ"ל ולא גרסינן לחבב את המצוה ולעיל בפרשת לך לך פרשתי מהרש"ל:	Mizrachi, Genesis 22:2:2
Yeriot Shlomo on Torah, Vayera 43	@11בא"ד מצא אותו נעלם ממנו @22גמרא דס"פ הנחנקין דף ע"ב וז"ל אמר ליה את בנך שני בנים יש לי את יחידך זה יחיד לאמו וזה יחיד לאמו אשר אהבת תרוייהו רחימנא להו את יצחק וכל כך למה כדי שלא תטרף דעתו עליו ע"כ כנ"ל:	NULL
Yeriot Shlomo on Torah, Vayera 44	@11בד"ה שאם יצטרך כו' וזה יכשיר @22נ"ב ואני אומר כל א' הוא ראוי למקומו דגבי אברהם שאינו צריך כ"כ לשימוש שאדרבה הוא היה מדקדק לעשות המצוה בעצמו ולהיות נזהר וזריז ואם כן הוה מספיק משרת א' לו ולעצמו וגבי בלעם להיפך לא היה מדקדק כ"כ על חשיבתו שלא ישאר יחידי ואדרב' היה לו נפש רחבה ומחמד ממון כדלקמן א"כ לא היה לוקח עמו שני נערים לולי שחוזרים ומשמשי' זה את זה מהרש"ל:	Mizrachi, Genesis 22:3:3
Yeriot Shlomo on Torah, Vayera 45	@11בד"ה ויבקע כו' לשון בקע @22נ"ב ונרא' שהוא רוצה לפרש שהוא היה מבקע הגזרין לשני חלקים כמו צלחו ולא תפרש שהיה מבקע העצים מן הקורה או מן האילן דא"כ היה לו לכתוב ויבקע עצים לעולה וק"ל ואפשר מ"ה היה מבקע הגזרין לחתיכות קטנות כדי שיהיו ראוין לישא במשא וליתן לנערים וק"ל ועוד אני אומר שלא בא לפרש המקרא שכבר אנו יודעין מהו ביקוע אלא שלא תטעה בתרגו' שפי' וצלח ע"כ מפרש' שצלח הוא ג"כ לשון ביקועה כמו וצלחו הירדן מהרש"ל:	Mizrachi, Genesis 22:3:4
Yeriot Shlomo on Torah, Vayera 46	@11בד"ה מוכן היה כו' בעשרה מאמרו' @22נ"ב ואפשר מלשון הנה קדייק לומר הואיל שהיה מוכן כבר בא הנה לידו מהרש"ל:	NULL
Yeriot Shlomo on Torah, Vayera 47	@11בד"ה אחרי שאמר כו' כאלו אמר @22נ"ב ואני אומר כפשוטו מדלא כתיב והנה איל אחר נאחז קרניו בסבך אלא ה"פ בא המלאך וסבכו ובמה סיבכו בקרניו וקאי על פועל אחר שהסביכו ודוק מהרש"ל:	Mizrachi, Genesis 22:13:1
Yeriot Shlomo on Torah, Vayera 48	@11בד"ה בהר המוריה כו' להניח פשיטא @22נ"ב ואני אומר קרא מסייע ויוגד לאברהם לאמר מהו לאמור אלא כלומר תשובת דברים לשאלתו והרהרו וק"ל מהרש"ל:	Mizrachi, Genesis 22:20:1
Yeriot Shlomo on Torah, Chayei Sara 1	@11בד"ה שהרי כו' ושמא י"ל @22נ"ב ונראה לי מאחר שקבלו עליהם אברהם ושרה דהא אפילו עירוב תבשילין קיים א"כ היה דינם כלאחר מתן תורה ומ"מ לא שייך עליהם עונש בידי אדם דהא לא קבלום רק מעצמם ומי ידין אות' לולי הקב"ה וק"ל מהרש"ל:	Mizrachi, Genesis 23:1:4
Yeriot Shlomo on Torah, Chayei Sara 2	@11בד"ה ובת כ' כו' עונשי אדם @22נ"ב ולי נרא' דזה פשיטא לן שלא חטאו חטאים גדולים וגלוים שאפי' בני נח נצטוו עליהן דהיו מוחזקין לצדיקי' רק שלא נאמר שמא עברו עברות קלות והיינו שלא יאמרו אין סתרה כגלוי' וק"ל מהרש"ל:	Mizrachi, Genesis 23:1:5
Yeriot Shlomo on Torah, Chayei Sara 3	@11בד"ה שני חיי שרה כו' אע"ג דמקרא דשני כו' @22נ"ב ומאמ"ז קבלתי שבע"כ מוכרח לומר ששני חיי שרה אינם שוין בסגנון אחד כולם לחטא או כולם ליופי אלא מקצתן לחטא ומקצתן ליופי מדכתיב מאה שנה ולא תמצא במקרא דבוק וכאן עומד לומר שק' נדרש לעצמו ולא נדרש בת ק' כבת ך' דקאי על היופי ודוק ומ"ה כתב אח"כ שני חיי שרה שיהיו כולן שוין שאף על היופי נדרש בת ק' כבת ך' ומה שטען המחבר שהיתה זקנה אין ה"נ ומ"מ קלסתר פניה לא שינתה וזו הנם הגדול שהודיע לנו המקרא וראייה מרוב יופיה לקחה אבימלך וק"ל ולי נראה כפשוטו דבודאי אי לא כתיב שני חיי שרה לא היינו דורשין לגנאי בשום אופן כמ"ש המחבר אלא שהיינו דורשין כולן ליופי כמו שהיינו דורשין לגבי אברהם כולם לחטא ע"כ כתב שני חיי שרה שיהיו כולן שוין לטובה ואם אתה דורש כולן ליופי ולא לחטא א"כ לא יהיו השנים שוים לטובה שהרי בת ך' לא היתה בת חטא ובת ק' היתה וק"ל אבל עכשיו שאנו דורשין בת ק' לחטא אם תאמר שלא היתה בת ק' ביופיה אין זה פחיתות וגריעות שתאמר שלא הושוו כולן לטובה:	Mizrachi, Genesis 23:1:6
Yeriot Shlomo on Torah, Chayei Sara 4	@11יש מקשין למה הכ' של ולבכותה קטנה @22ונראה לי דבא ללמד שעיקר הבכייה לא היתה בעבור הכ' כלומר בת עשרים כבת ז' ליופי אלא מחמת מעשיה ויראת ה' מהרש"ל ואני שמעת ממורי מהר"ש מלובלין ז"ל דמצינו בגמרא בת היתה לאברהם ובכל שמה ולא מצינו במקרא למי השיאה אברהם או היכן מיתה לזה נכתב ולבכתה חסר כ' וא"כ הוי ולבתה לומר לך שמתו בפעם אחת שרה ובתה וזהו לספוד לשרה ולבתה ות"ל:	NULL
Yeriot Shlomo on Torah, Chayei Sara 5	@11בד"ה כמו לא תכלה @22נ"ב פי' לא ימנע דל"ת לא יפסיק וקללה היא ודוק מהרש"ל:	Mizrachi, Genesis 23:6:1
Yeriot Shlomo on Torah, Chayei Sara 6	@11בד"ה המכפלה כו' ד"א שכפולה @22נ"ב דאי כפירש הראשון בית ועליה היה לו לכתוב מערה הכפול' אלא המכפילה כלומר מפעיל שהוכפלה ע"י זוגו' וק"ל וזה לבד לא יתכן דעדיין לא היתה כפולה בזוגות אלא בזוג אחד אדם ואשתו וק"ל מהרש"ל:	Mizrachi, Genesis 23:9:1
Yeriot Shlomo on Torah, Chayei Sara 7	@11בד"ה הרי היא כו' כמו @22נ"ב ועל נתתי השני פירש"י הלואי שנתתי לפי שקאי על הכסף שצריך נתינ' מיד ליד לאפוקי קרקע הרי ברשותך כמו שנתתי לך מהרש"ל:	Mizrachi, Genesis 23:11:2
Yeriot Shlomo on Torah, Chayei Sara 8	@11בד"ה אלא הנח כו' @22נ"ב יש טועין בפשט ואומרים הנח המכר כלומר יהיה המכר ואעפ"י שאני לוקח ממך אין הקפדה כי מה נחשב הכסף ביני וביניך ואין חילוק בין תתן ובין שלא תתן כלל רק בעבור שאת' מבקש כי אקח ממך וטעות הוא בידם כדמוכח להדיא בפ' השוכר וגם מל' ארץ ארבע מאות שקל כסף ש"מ דעיקר אארץ קאי שרצה ליתן לו בחינם ודוק ומ"ש וישמע אברהם לעפרון היינו על סכו' המקח שהעריך עפרון עצמו על ד' מאות שקל ודוק מהרש"ל:	Mizrachi, Genesis 23:15:3
Yeriot Shlomo on Torah, Chayei Sara 9	@11בד"ה תחת יריכי כו' @22של מצו' ומה שהוסיף רש"י שבצער באתה לו דאל"כ היה לו להשביע לאליעזר במילה שלו אלא משום שמילה של אברהם היתה באה אליו בצער וק"ל מהרש"ל:	Mizrachi, Genesis 24:2:1
Yeriot Shlomo on Torah, Chayei Sara 10	@11בד"ה שאינו נופל כו' מבלתי יכולת @22נ"ב ונ"ל בקיצור שהאמיר' מאחר שלא תמצא זולת נוכחי נגדו שייך בו ל' לי או לו אבל אצל הדיבו' הוא לאדם עצמו המדבר אינו נופל לשון לי או לו כי הדיבור אינו לו אלא למדבר עצמו רק עליו הוא מדבר ודוק ולפ"ז נמי הוא מכוון מה שאמרי' שלשון דיבור הוא לשון קשה ואמירה הוא חיבה אלא לפי שדיבור הוא מה שמדבר לפי חפצו ולא שישיב לחבירו ויאמר לו כפי הנאות לו ודוק מהרש"ל:	Mizrachi, Genesis 24:7:5
Yeriot Shlomo on Torah, Chayei Sara 11	@11בד"ה וקח לי כו' וממרא @22נ"ב ולי נראה דמעולם לא דיבר אליעזר לאברהם כך ולא תבע בפה כדי שלא יחשוד אותו שיתרשל וימעול בשליחתו כדי שיתחתן עמו וק"ל וגם אם היה אברה' רוצה להזדווג עמו אם לא ימצא ממשפחתו מ"מ לא היה מגלה לו כדי שלא יתרשל בשליחתו ובודאי שהיה אליעזר נושא ונותן כך בשכלו שראוי היה להזדווג עמי אלא שהוא ארור אבל לא דיבר כלל בפני אברהם וכדי לפייס' ולשבחם ולהודיע להם שאברה' חשק בהם מחמת יחום משפחתם הוצי' אותן הדברים מפיו ובראותו שהם נתגאו עליו ונתקשו שהיה מוכרח להם והיו רוצין להענישו בהון עתיק הוציא נמי דחייה מלבו ואמר להם שאינו מוכרח להם ויש לו רשו' נמי להזדווג עם ישמעאל ולוט אעפ"י שלא היו דברים מעולם וק"ל קרוב לזה פירש מהרא"י ודוק מהרש"ל:	Mizrachi, Genesis 24:8:1
Yeriot Shlomo on Torah, Chayei Sara 12	@11בד"ה ובה אדע לשון תחינה @22נ"ב ול"נ דאל"כ היה מנחש ממש וחשב אותו לידיעה ממש אינה כוזבת לכך פי' לשון תחינה ודוק מהרש"ל:	Mizrachi, Genesis 24:14:3
Yeriot Shlomo on Torah, Chayei Sara 13	@11בסוף ד"ה לפי שראה @22נ"ב אבל ק"ל מאחר שעמד אצל העין ממש א"כ למה לא אמר לה הגמיאני מיד אחר שמלאה ולמה המתין עד אחר שהלכה שהיה צריך לרוץ אחריה והנראה בעיני שלא היה אצל העין ממש אלא רחוק ממנו ורש"י דייק מדקרי ליה וירץ העבד ולא כתיב וירץ סתם כמו לעיל מיניה והאיש משתאה לה אלא כלומ' בעבור שהיה עבד אברהם וידע שאברהם הורגל באלו הנסים כדלעיל גבי ז' כבשות הצאן היה רץ לקראתה כי ראויה היא לבית אברהם שהרי ג"כ המים עולים לקראתה כמו לאברהם ודוק מהרש"ל:	NULL
Yeriot Shlomo on Torah, Chayei Sara 14	@11בד"ה לאחר שנתן כו' שלא יתפשוה @22נ"ב מה שפירש"י שלא יתפשוה נ"ל שהיה מתיירא שלא יוסיפו עליו הון עתיק והנה היה מראה להם שלא היה מוכרח להם כ"כ כמו שאמר ואפנה על ימין או על שמאל וא"כ אם יאמר שמתחילה נתן א"כ יתפשוהו בדבריו ויראו שהוא מוכרח לכך שסמך על הניחו' לכך שינה ודוק מהרש"ל:	Mizrachi, Genesis 24:23:1
Yeriot Shlomo on Torah, Chayei Sara 15	@11בד"ה למה וירץ @22נ"ב פי' למה וירץ ולא וילך ועוד למה רץ כלל לא היה לו לילך ודוק מהרש"ל:	Mizrachi, Genesis 24:29:1
Yeriot Shlomo on Torah, Chayei Sara 16	@11בד"ה התיר זמם כו' בביתו של ר' פנחס @22נ"ב ול"נ דלק"מ כי אברהם עשה בעבור אחרים שיזוממו גם הם בהמתם וק"ל מהרש"ל:	Mizrachi, Genesis 24:32:1
Yeriot Shlomo on Torah, Chayei Sara 17	@11אם ישכם עושים חסד כו' @22הקשה מהרא"י ז"ל הלא בפ' ויחי יעקב דייק רש"י מדכתיב חסד ואמת היינו חסד שעושין עם המתים ומהו שייך הכא ותירץ דה"נ חסד של אמת היא כלומר שלא ע"מ לקבל פרס והנאה כי אליעזר היה דואג שיבקשו ממנו ממון ע"כ וזהו סיוע לכל מה שפרשתי מהרש"ל:	NULL
Yeriot Shlomo on Torah, Chayei Sara 18	@11בד"ה ואתה ארור שהרי אליעזר @22נ"ב לעיל פרשתי למה לא כתיב אולי הראשון חסר מהרש"ל:	NULL
Yeriot Shlomo on Torah, Chayei Sara 19	@11בסוף ד"ה לפי שמה' @22נ"ב ולי נראה מאחר שאמרו בתחלה לא נוכל דבר אליך ואיך בקשו אח"כ לעכב עוד שנה אלא כך אמרו לפי דבריך מה' יצא הדבר אבל אין אנו יודעין אם האמת אתך ודוק מהרש"ל:	NULL
Yeriot Shlomo on Torah, Chayei Sara 20	@11בד"ה שכך נותנין כו' לא י"ב חדש @22ובעל מתנות כהונה כתב בשם רש"י דמאו מרבינן עוד שני חדשים אמנם לי יראה לפרש דדעת הרבות הוא ג"כ כדעת רז"ל בגמרא שלנו וה"פ ימים ר"ל אלו הוי כתיב ימים לחוד ולא או עשור הוי מוקמינן ימים לז' ימים אבלו של בתואל שכך הוי מיסתבר אבל השתא דכתיב או עשור ואין דרך המבקשים לבקש תחילה דבר מועט ואח"כ דבר מרובה א"כ מעתה האי ימים אלו י"ב חדש ולא ז' ימים אבלו של בתואל ודוק כנ"ל:	Mizrachi, Genesis 24:55:1
Yeriot Shlomo on Torah, Chayei Sara 21	@11בד"ה לשוח כו' אלא תפילה @22נ"ב ואני אומר דאי לאו תפילה לעני כו' ה"א דקרא לשוח בשדה הוא מלשון לילך בין האילנות כמו שפירש ראב"ע או פיר' לחפור בארות מלשון שוחה ומ"ה ילפינן משם שהוא מלשון שיח ותפילה ואי לאו קרא דהכא ה"א דישפוך שיחו הוא מלשון דיבור לבד ומניין שהוא לשון תפילה לכך יליף מהכא דהכא לא שייך לפרש אלא מלשון תפילה וק"ל מהרש"ל:	Mizrachi, Genesis 24:63:1
Yeriot Shlomo on Torah, Chayei Sara 22	@11בא"ד ויהי אומן את הדסה נמחק @22וצ"ל והוא עומד בין ההדסים כנ"ל:	NULL
Yeriot Shlomo on Torah, Chayei Sara 23	@11בד"ה ראתה אותו הדור בלבושו @22נ"ב ולא נ"ל כלל פירש מהרא"י שחזר לאחוריו כו' מהרש"ל:	Mizrachi, Genesis 24:64:1
Yeriot Shlomo on Torah, Chayei Sara 24	@11בד"ה ושקשרה @22נ"ב מוכרח לפרש שני פשטי' דאי בעבור שנאי' מעשיה כקטורת היה לו לקרותה קטורת ואי משום לשון קשור היה לו לקרותה קשורה בלשון הקודש ולא קטורה לשון ארמי ודוק מהרש"ל:	Mizrachi, Genesis 25:1:2
Yeriot Shlomo on Torah, Chayei Sara 25	@11בד"ה פלגשים כו' לא בא @22נ"ב אבל ק' א"כ למה לא נאמר פלגש אלא נרא' שבא להודיע שלקחה שנית בה כמי שהיתה פלגש אחרת ומ"ה היה ישמעאל כבן הגביר' בעיני אברהם נגד האחרים ודוק מהרש"ל:	Mizrachi, Genesis 25:6:2
Yeriot Shlomo on Torah, Chayei Sara 26	@11בד"ה כדי לייחס שנותיו @22נ"ב והנראה בעיני מ"ה כתב שנה בכל א' כדי להודיע שלא נמנ' לעצמו אלא לייחם בו מניין וחשבון אחר ודוק מהרש"ל:	Mizrachi, Genesis 25:17:2
Yeriot Shlomo on Torah, Toldot 1	@11בד"ה יעקב ועשו כו' למלת אלה @22נ"ב ואולי ג"כ קשה לו כ"מ שנאמר אלה פסל ואלה מוסיף וא"כ בכאן לא היה לו לכתוב ואלה מאח' דלעיל מיניה איירי בתולדותיהן של ישמעאל שכולן היו רשעי' וכאן איירי בתולדו' של צדיקים ומ"ה כתב נמי אלה תולדות נח אע"פ דלעיל מיניה איירי בנח משום שלפסול את הראשונים בא ודוק לכך משני משום שקאי על יעקב ועשו וכו' וחד מינייהו היה רשע או אפשר שבא להוסיף על אברהם כשם שהוא הוניד אחד רשע ואחד צדיק כך יצחק נמי ולפ"ז פריך אח"כ שפיר א"כ אברהם הוליד את יצחק מה בא להשמיע לני ודוק מהרש"ל:	Mizrachi, Genesis 25:19:1
Yeriot Shlomo on Torah, Toldot 2	@11בד"ה לפי שהיו כו' מאבימלך @22נ"ב ויש מקשין ולמה כתב' כאן ונ"ל על שתי סבות חדא להודיע לנו גודל הנס שבהשגחה פרעית עשה השי"ת ולא בדרך הטבע שהרי שני בני יצחק לא היה שום אחד מהם בדומה ממש לאביהם וק"ל ועוד שלא יאמרו דלמא לעולם מאבימלך נתעברה ובעבור שהרהרה על אברהם הולידה בעבע בדומה לו ע"כ הודיע לנו שאינו בעבע שהרי רבקה לא הולידה בעבע וק"ל מהרש"ל:	Mizrachi, Genesis 25:19:3
Yeriot Shlomo on Torah, Toldot 3	@11מה שפירש רש"י שהרי עדו' @22מקשין העולם הלא לעולם בן המנאפת דומה לבעלה מצד המורא שיש לה מבעלה ולק"מ דבהדיא אמרינן בגמרא פרק השוכר את הפועלים דבתחילת הלידה לא היה קלסתר פניו של יצחק דומה לאברהם רק אח"כ כשהיו מרננין עליו היה מהפך הקב"ה קלסתר פניו של יצחק דומה לאברהם ע"ש שמעתי. 	Mizrachi, Genesis 25:20:1
Yeriot Shlomo on Torah, Toldot 4	@11בד"ה ובו בפרק כו' חולקת כו' @22ובספר פענח רזא תירץ שאינן חולקין אהדדי ע"ש:	Mizrachi, Genesis 25:20:2
Yeriot Shlomo on Torah, Toldot 5	@11בד"ה אלא להגיד כו' דהני קראי כו' @22נ"ב ולי נראה דבא להשמיענו שכ"כ רשעים היו שלא היה ניח' להם באדם שיש בו מעש"ע כי לפעמים ישנן כמה רשעים מחמת שאינן יכולין להתאפק ביצרם ומ"ה גונבין ומזנין אבל מ"מ מי שהוא נקי בכל מעשיו חשוב בעיניהם ומשבחי' אותו משא"כ הכא ודוק מהרש"ל:	Mizrachi, Genesis 25:20:3
Yeriot Shlomo on Torah, Toldot 6	@11בד"ה שסתם כו' @22נ"ב ונראה לי לפ"ז יהי' פיר' של אם כן למה זה אנכי כלומר למה אני מתאוה על ההריון מאחר שאחד יהיה רשע גמור מוטב שלא הייתי מולד כלל והא ראיי' האמת שלבסוף העלים הקב"ה מיתתה וק"ו לפי מדרש רבות וז"ל אם כך אני ראויה להעמיד י"ב שבעים הלואי לא עברתי במניינ' דזה עד כאן פירש מאחר שאחד צדיק ואחד רשע למה לי הרשעים מתיירא אני שלא יהיו ששה רשעים ומ"ה לא הזכיר רש"י לעיל צער העיבור בדבריו ואח"כ מפרש רש"י שהיו מריבין בנחלת שני עולמים שכל אחד רצה לזכות בשני עולמות מזה לא הרגישה שאחד יהיה רשע וא"כ ע"כ אם כן למה זה אנכי קאי על גודל צער העיבור שהיה נגיחתם וריבת' יחד בביטנה וק"ל מהרש"ל:	Mizrachi, Genesis 25:22:1
Yeriot Shlomo on Torah, Toldot 7	@11בד"ה בעקב כו' מספיק לגמור @22נ"ב פירש זה הוא נלמד מלשון בעקב אבל דעתו של יעקב לא היה להראות סימן אלא לעכבו ודוק מהרש"ל:	Mizrachi, Genesis 25:26:1
Yeriot Shlomo on Torah, Toldot 8	@11מה שפירש רש"י גבי ויקרא שמו יעקב הקב"ה @22מקשין העולם מה ק' לו הלא לעיל דייק מדכתיב ויקראו א"כ הכא שפיר כתיב ויקרא ונ"ל דדייק מדלא כתיב ויקרא יצחק מאחר שהפסיק הענין ולא הזכירו א"כ משמע שקאי על הקב"ה ולא כמו שפי' מהרא"י ומה שפי' אח"כ ד"א יצחק קרא לו שם ומה שלא גילהו הכתוב לפי שיצחק קראוהו בעבור אחיזת העקב ועשו הרשע אמר שבעבור ויעקבני זה פעמים ומ"ה לא גילהו להוציא מחשד של עשו והדומה וק"ל מהרש"ל:	NULL
Yeriot Shlomo on Torah, Toldot 9	@11בד"ה והוא עיף כו' ופגע ביריחו @22ותימה דלקמן בפרש' ויצא כתב המחבר הזה גופ' דופגע ביריחו הוא לשון חנייה ולא לשון פגישה ע"ש כנ"ל:	Mizrachi, Genesis 25:29:1
Yeriot Shlomo on Torah, Toldot 10	@11בד"ה העיד הקב"ה כו' לא כן @22נ"ב ול"נ דה"פ מן המכירה אין אנו יודעים אם ביזה או לא דשמ' מחמת מורא שהולך למות מכר אבל בזה אתה מכיר רשעתו שאח"כ ביזה את הבכורה והיתה כצחוק בעיניו ומי יודע זה מה שבדעתו בא הקב"ה והעיד על לבו שביזה אותו וק"ל מהרש"ל:	Mizrachi, Genesis 25:34:1
Yeriot Shlomo on Torah, Toldot 11	@11בד"ה כי ארכו אמר מעתה כו' @22נ"ב ואין משיבין את הארי אבל נ"ל לפרש כי בתחילה שאמ' יצחק לאבימלך שהיא אחותו האמין לו ואח"כ שארכו לו הימים לאבימלך והיה מתמיה א"כ עד עתה למה לא נשא אשה וגם אחותו למה לא השיאה לאיש אחר בודאי לא כך הוא כדבריו וישקף אחריו וימצא כי לפרש"י הי' לו לכתוב ויהי כי ארכו לו הימים ויהי כמצחק ודוק מהרש"ל אמנם המעיין במדרש רבות בפ' זו ימצא כפירש רש"י ע"ש. 	Mizrachi, Genesis 26:8:1
Yeriot Shlomo on Torah, Toldot 12	@11בד"ה ורבותינו אמרו אומד זה למעשרות היה @22נ"ב ואני קבלתי דה"פ דרבותינו אמרו הא דכתיב בקרא וימצא בשנה ההיא מאה שערים אותן מאה שערים היו מעשר והיינו שעשתה על אחד מאה דמה שאמדוהו שהיתה ראוי' לעשות אחד היתה עושה אלף וממילא היה המעשר מהם מאה שערים מהרש"ל אמנם בב"ר משמע כפשוטו כמו שפירש הרא"ם ז"ל ע"ש כנ"ל:	Mizrachi, Genesis 26:12:3
Yeriot Shlomo on Torah, Toldot 13	@11בד"ה בעשנן @22נ"ב ואני אומר שרש"י הוכרח לפרש כל הג' טעמים ובתחילה מפרש משום עשנן והוא סמיכות ואחר כך ק' ליה איך הביא הקב"ה תקלה לידו אלא מפני הבכורה לא מנעו הקב"ה מן הסיבה וא"כ ס"ס מאחר שהיה העשן ק' למה לא היתה רבקה נסמית ע"כ פירש שכבר כהו עיניו במקצת ע"י עקידה ובא זו ואיבד הכל ואפילו לפי ב"ר שכתב שרבקה לא היתה מקפדת כו' מ"מ איכא לתרץ דקש' לרש"י שאיך יכהו עיניו שלא יראה לגמרי מפני עשנן וצ"ל דכבר כהו קצת ודוק מהרש"ל:	Mizrachi, Genesis 27:1:1
Yeriot Shlomo on Torah, Toldot 14	@11מה שפירש"י לפני ה' ברשותו כו' @22מיד אחר וצודה לי ציד שלא במקומו וגם מקשין איך אמרה רבקה לפני ה' מה שלא אמר יצחק בעצמו וכי היתה משקרת לפני יעקב נראה שק"ל מאחר שאמר יצחק וצודה לי ציד משלי ולא מן הגזל א"כ איך נדרוש ועשה לי מטעמים והבא לי כו' מה נעשה באותן לי ומשני שאותן לי כלומר לצרכי כדי שתשרה עלי שכינה מתוך שמחה שאברך לפני ה' ברשותו וכו' ועל זה אמרה לפני ה' ודוק מהרש"ל:	NULL
Yeriot Shlomo on Torah, Toldot 15	@11שני גדיי עזים פרש"י פסח היה @22נ"ל ע"ד הכוונה שהקב"ה מלא שנותיהן של צדיקים ובפסח נולד ומ"ה אמר לא ידעתי יום מותי וגו' מהרש"ל:	NULL
Yeriot Shlomo on Torah, Toldot 16	@11בד"ה ויתן לך יתן ויחזור @22נ"ב ול'נ דה"פ אפילו אם ח"ו יפסיקו הברכות כשיגרמו העונו' אפ"ה יחזור ויתן לך בתשובה ודוק מהרש"ל:	Mizrachi, Genesis 27:28:1
Yeriot Shlomo on Torah, Toldot 17	@11מה שפירש"י גם ברוך יהיה שנצטער על מה שבירך ליעקב כו' עד ששמע שאמר עשו ויעקבני כו' @22מקשין העולם והלא מקר' דויעקבני הוא אחר פסוק דגם ברוך יהיה ואין שייך לומר אין מוקדם ומאוחר כו' דסיפור הענין מוכח כן ונראה דלק"מ דבודאי עשו צעק מיד בקול רם מה עשה לי האח הזה שעקבני פעמים ושמע אביו ועשו צעק בודאי כדי שישמע אביו וענה יצחק גם ברוך יהיה והנה כשמוע עשו דברי אביו שאמר גם ברוך יהיה אחרי טענותיו שאמר ויעקבני זה פעמים ולא השגיח אז א"ל הכי קרא שמו יעקב כלומר שאני מרגיש שאהוב בעיניך עקבתו ורמאתו ומ"ה קראת שמו יעקב ולא עקב משום שיעקבני פעמים ודוק מהרש"ל:	NULL
Yeriot Shlomo on Torah, Toldot 18	@11בד"ה שמא לכך כו' מה ניבא @22נ"ב ולי נראה דה"ק כי אולי בעבור זה נקרא שמו יעקב ולא עקב אלא היו"ד מורה על העתיד יעקב לאחרים וק"ל מהרש"ל:	Mizrachi, Genesis 27:36:2
Yeriot Shlomo on Torah, Toldot 19	@11בד"ה הן גביר כאן שבעה @22נ"ב ומהרא"י פירש א"כ למה הזכיר אח"כ ודגן ותירוש סמכתיו משו' שלא תאמר א"כ תברך אותי בארץ מבורכת כדי ליתן מס ודורן לארצי א"ל הלא דגן ותירוש סמכתי ואינו צריך לך כלל ודוק מהרש"ל:	NULL
Yeriot Shlomo on Torah, Toldot 20	@11בד"ה ויהיה לך כולי כאשר תצטער @22נ"ב ומאמ"ז קבלתי כאשר תריד הוא על הנסתר על התורה כאשר התורה תריד דאל'כ היה לו לכתוב כאשר תריד הפרוק אלא ה"ק אם היא תריד ג"כ תעשה את שלך ופרקת מהרש"ל:	Mizrachi, Genesis 27:40:1
Yeriot Shlomo on Torah, Toldot 21	@11בד"ה ואל שדי מי שדי בברכותיו @22נ"ב פי' זה השם הוא טוב להזכיר בעת צרה ובמקום דשכיח היזק שהרי עשו עומד עליו ודוק מהרש"ל:	Mizrachi, Genesis 28:3:1
Yeriot Shlomo on Torah, Vayetzei 1	@11בד"ה ה"ג כו' סבת החזרה @22נ"ב ונ"ל שכפל הלשון שיבוש גדול הוא כי ע"י קאי על ההפסקה שהפסיק כו' ושבשביל לא קאי על שום קושיא אלא על שרעות שכתו' אחריו וכן קבלתי מאמ"ז וכאלו נכת' ע"י שהלך עשו אל ישמעאל בשביל שרעות וק"ל מהרש"ל:	Mizrachi, Genesis 28:10:1
Yeriot Shlomo on Torah, Vayetzei 2	@11בד"ה מגיד כו' ליציאת גופו @22נ"ב ולא נ"ל כלל פירושו שיהיה כאלו כתוב ב' פעמים וחד לגופה כו' גם מה שהוא מבין הב"ר כפשוטו שדייק מלשון ויצא שמשמע הוא לבדו יצא והלא כמה גמלים וחמורים יצאו קושיא של הבל הוא אלא הב"ר נמי דייק דויצא הכתוב כאן הוא מיותר כדפרש"י ובא להודיע לנו הכתוב כאלו הוא לבדו יצא אע"פ שכמה גמלים וחמורים יצאו אלא יציאתו ניכרת ודוק מהרש"ל:	Mizrachi, Genesis 28:10:3
Yeriot Shlomo on Torah, Vayetzei 3	@11בד"ה ושינ' כו' תפגע בי @22נ"ב ולי נראה דאל תפגע דהתם נמי קצת לשון פגישה היא כלומר אל תפגשי נגדי להתפלל מה שאין שייך הכא כלפי המקום וק"ל מהרש"ל:	Mizrachi, Genesis 28:11:4
Yeriot Shlomo on Torah, Vayetzei 4	@11בד"ה עשאן כמין כו' מועטין שבאו בחירק @22נ"ב ול"נ דמ"ה כתב מראשותיו בשו"א ולא בציר"י להודיע שתחת מראשותיו היה ושניהם אמת שלקח כמה אבני' לשכב עצמו מפני החיות וג"כ אחת תחת מראשותיו וא"כ כל האבנים היו מקנאין בזה שתחת מראשותיו ובעבור זה נתווכחו כל האבנים עד שנבלעו כולן כאחת וק"ל מהרש"ל:	Mizrachi, Genesis 28:11:6
Yeriot Shlomo on Torah, Vayetzei 5	@11בד"ה ושאמרו רבותינו כו' ועוד אמרו יעקב @22נ"ב ול'נ כלל כפירושו חדא דבגי' שלנו כתוב ועוד אמרו שיעקב קרא לירושלים בית אל ולפי פירש הרא"ם אין צירך לזה וג"כ לא מצינו שאמרו זה לוז היא ולא ירושלים שנקשה מניין להם ועוד אפי' לפי התירוץ עדיין קשה מניין להם שזו לוז היא ולא ירושלים דלמא לעולם ירושלים היא ומה שקפצה לו הארץ היינו שלא היה הולך עד חצי הדרך וקפצו לו כנגדו ועוד מאחר שרש"י מפרש שראשה בלוז ואמצעה בירושלים משמע שברור לו שלוז אינו ירושלים ואח"כ יקשה מהיכן למדו לומר כן לכן נ"ל שרש"י התחיל להקשות מתחילה כלפי שאמרו רבותינו צדיק זה בה לבית מלוני דהיינו ירושלי' ומקרא משמע שהיה לן בלוז שהוא שער השמים בעבור שהוא ראש הסולם ועוד ק' שאמרו רבותינו ז"ל שיעקב קראו לירושלים בית אל ובקרא משמע שקרא ללוז בית אל וזו לוז היא ואינה ירושלים ובזה אין ספק לרש"י שלוז אינה ירושלים ועוד ק' אפי' אם תוכל לתרץ מה שנ' בקרא ויקרא שם המקום בית אל לא קאי אלוז אלא אירושלים ס"ס מהיכן למדו לומר כן דלמא אלוז קאי כפשוטו ומשני שקפצה ירושלים ללוז ואז לק"מ ולעולם לוז אינה ירושלים ודוק מהרש"ל:	Mizrachi, Genesis 28:17:2
Yeriot Shlomo on Torah, Vayetzei 6	@11בד"ה בגבול שבין כו' מה דחילו דאתר' @22נ"ב ולי נראה אדרבה בעבור זה הביא רש"י התרגום כדי להוכיח שהמורא קאי על המקום עצמו מדלא תרגם דאתרה וק"ל מהרש"ל:	Mizrachi, Genesis 28:17:5
Yeriot Shlomo on Torah, Vayetzei 7	@11בד"ה אם שמור לי כו' אבל הבגד אעפ"י כו' @22נ"ב ול'נ דה"ק שיתן לי לחם בריוח שלא אצטרך למכור בגדי וכן פירש מהרא"י והוסיף שהבגדים הם עיקר לאדם יותר מאכילה ע"ד עשיק לגבך ושוי לכריסך כו' מהרש"ל:	Mizrachi, Genesis 28:20:1
Yeriot Shlomo on Torah, Vayetzei 8	@11בא"ד המתחייב בחן @22נ"ב ולי נראה דפשיטא על החטא לא הבטיחו לפי שהכל בידי שמים חוץ מיראת שמים ומ"ה נאמר ושבתי ולא והשבני כמו שנאמרו כולן אלא הושבתי קאי על בשלום כלומר בעצמי אשוב מן החטא ודוק מהרש"ל:	NULL
Yeriot Shlomo on Torah, Vayetzei 9	@11בד"ה והיה ה' כו' יוציא המעשר ל"ק @22נ"ב ולי נראה דה"ק אם לא תתן לא אעשר שני פעמים ועכשיו עשר אעשרנו לך כמו שדרשו רבותינו ז"ל המבזבז אל יבזבז יותר מן החומש ולמדו מיעקב וק"ל מהרש"ל:	Mizrachi, Genesis 28:21:1
Yeriot Shlomo on Torah, Vayetzei 10	@11בא"ד מצינו שקיים @22נ"ב פיר' מאחר שראובן נמי הבכור א"כ תתחיל המניין משמעון וא"כ נכה עוד ג' בכורים ויחזור העשירי ללוי ודוק מהרש"ל:	NULL
Yeriot Shlomo on Torah, Vayetzei 11	@11בד"ה לפי שהאבן כו' גדולה כמו שפי' @22נ"ב פירש מדכתיב אבן גדולה ולא כתיב אבן סתם ש"מ כו' מהרש"ל:	Mizrachi, Genesis 29:3:1
Yeriot Shlomo on Torah, Vayetzei 12	@11מה שפירש"י שצפה ברוח הקדש שאינה נכנסת עמו בקבורה @22קשה א"כ איך בכה נגדה וכי גילה לה אותה הבכייה על מה היתה לכן פירש ד"א בעבור שבא בידים ריקנים וזה גילה לה אבל חלילה שצדיק יבכה על איבוד ממון ואדרבה יודה לה' שהציל גופו כי היה בסכנה גדולה וגם אין כל אדם זוכה לשתי שולחנות וצריך האדם לשמוח על איבוד ממונו כי לכפרה הוא לו אלא הוא בכה מפני הנבוא' שראה וק"ל ולפיכך לא צריכין אנו להאבן עזרא שמהפך הפסוקים עיין שם מהרש"ל:	NULL
Yeriot Shlomo on Torah, Vayetzei 13	@11בד"ה אמר שמא כו' יש בפיו @22ורבי' מן המתמיהין הלא אין מן הדרך להביא אבנים טובות בפיו לכן נראה לפרש בפיו כלומר לנשק לו ולהראות לו פנים יפות עד אשר יגלה כל מה שבפיו שדרך מרגלית ואבנים טובות להיות לו לאדם צרורות בהסתר ודוק מהרש"ל:	Mizrachi, Genesis 29:13:2
Yeriot Shlomo on Torah, Vayetzei 14	@11ברחל בתך הקטנה מה שלא אמר בתך הקטנה לחוד @22כי היה מתיירא שמא יש לו עוד בת קטנה ביותר ולא היה מתיירא שמא יחליף שמה כי בלי טעם אין לו להחליף בשלמא גבי לאה יחליף משום אין דרך וכו' ע"כ אמר נמי קטנה כי משום אין דרך אין לו לעשות אלא רמאות להחליף שם אבל אין שייך לומר על הגדולה קטנה בשקר ואפ"ה לא הועיל וק"ל מהרש"ל:	NULL
Yeriot Shlomo on Torah, Vayetzei 15	@11בד"ה שהרי כו' שפי' כימים @22נ"ב ונ"ל כימים שהם במספר אחדים דהיינו ז' ימי השבוע לאפוקי ח' ימים ודוק ומסתמא רבקה לא על ז' ימים שלחה אותו אלא על מספר שנים כימים אחדים וק"ל מהרש"ל:	Mizrachi, Genesis 29:20:1
Yeriot Shlomo on Torah, Vayetzei 16	@11מה שפירש"י ויהי בבוקר והנה היא לאה כו' שלמדה רחל סימנים דלמא כפשוטו הוא @22נ"ל דדייק מדכתיב והנה היא לאה ולא כתיב והנה לאה דמשמע עכשיו היתה לאה ולא בלילה לכך פי' שלמדה לה הסימנים וא"כ דומה היתה בלילה לרחל ולא ללאה וק"ל מהרש"ל:	NULL
Yeriot Shlomo on Torah, Vayetzei 17	@11מה שפרש"י שבעה שנים אחרי' הקשן לראשוני' @22מקשין העולם אדרבה לישנ' משמע דאחירות היו שלא היו דומין לראשונים. 	NULL
Yeriot Shlomo on Torah, Vayetzei 18	@11ונ"ל @22דאף רש"י כפשוטו ס"ל דאחירות אינן דומות לראשונו' שבאו לו בלב טוב והיו בעיניו כימים אחדים באהבתו אותה משא"כ באותן ז' שנים האחירות שבאו לו בצער ומ"מ כתב המקרא עוד ז' שנים דמשמע שבא להקישן שאעפ"י שבצער באו לו מ"מ היו באמונה ודוק מהרש"ל:	NULL
Yeriot Shlomo on Torah, Vayetzei 19	@11בד"ה לפי שהאמהות כו' ששאר האמהו' @22נ"ב ול"נ דכל אותן הנביאים מפורסמין היו במקרא וגם אפשר נביאותן היתה גלויה לרבים משא"כ הכא שכל נביאתן היתה מה שצפו בינם לבין עצמם וגם אינן מפורסמין במקרא וק"ל מהרש"ל:	Mizrachi, Genesis 29:34:1
Yeriot Shlomo on Torah, Vayetzei 20	@11מה שפירש"י מדברי רז"ל מי שנאמר בו על כן מרובה באוכלסין @22נ"ל משום דדרשינן על כנו ל' בסיס וכן כלומר ריבוי עם שעומדין בחוזק על בסיסן וק"ל מהרש"ל:	NULL
Yeriot Shlomo on Torah, Vayetzei 21	@11בד"ה וכי במקומו כו' נכרים עכ"ד @22נ"ב ולי נראה דה"ק לה אמת שאני מתפלל עליך ואינו מועיל וא"ת מ"ש מאבא שאני התם ששניהם צעקו והתפללו על עצמם ומרוב צערם שמע הקב"ה קול תפילת' משא"כ עכשיו שאנו מתפללים לצורך אדם אחד ודוק מהרש"ל: אבל ק"ל על דבריו דאם איתא שהיה מתפלל עליה א"כ למה לא הועיל תפלתו כמו תפלת אליהו ואלישע כנ"ל:	Mizrachi, Genesis 30:2:1
Yeriot Shlomo on Torah, Vayetzei 22	@11בד"ה דנני כו' אבל רש"י ז"ל כו' @22נ"ב ואני אומר דעת רש"י כן דנני במדת הדין שאני לא זכיתי לבן וזכני שלכל הפחות שפחתי ילדה לי בן מהרש"ל:	Mizrachi, Genesis 30:6:1
Yeriot Shlomo on Torah, Vayetzei 23	@11מה לפיכך כו' שתהא עזרה לבניה כו' @22נ"ב ולי נראה דלק"מ כי מה שנקברה בדרך היינו לפי מה שלא זכתה לקבור עמה וא"כ היה מוכרח לקברה באפרת בית לחם ומשום שתהא עזרה לבניה בגולה היה קוברה בדרך כמו שפירש"י בפ' ויחי אבל מחמת עזרה לבניה לבד א"א שבעבור זה לא תיקבר עמו במערת המכפלה כמו שרה ורבקה ולאה וח"ל וג"כ אי לאו שאמר יעקב לקמן לא יחיה נגד אחיכם א"כ לא היה נגזר עליה מיתה כל עיקר ופשיטא שלא היתה מתה בדרך בעבור שתהיה לעזרה לבניה יותר מכל האמהות ודוק מהרש"ל:	NULL
Yeriot Shlomo on Torah, Vayetzei 24	@11בד"ה שהיתה מתאוה כו' @22נ"ב ואני אומר יש לי עוד קושי' רבה ועצומ' במקרא שכתוב כי שכור שכרתיך וגו' ואח"כ נתן לי אלהים שכרי בזה אשר נתתי שפחתי לאישי ותקר' את שמו יששכ' ולמה לא קרא' אותו יששכ' בעבור שכור שכרתיך אלא כך אמר' שכור שכרתיך מש"ה נתן לי אלהים שכרי ולא תאמ' שבעבור הנאת תשמיש עשיתי ולא כדי להרבות שבעים יעיד עלי זכותי שנתתי שפחתי לאישי ונגרע ממני עונתי כדי להרבות ודוק מהרש"ל:	Mizrachi, Genesis 30:17:1
Yeriot Shlomo on Torah, Vayetzei 25	@11בד"ה זכר כו' שמסרה סימני' לאחותה כו' @22נ"ב פירש מדכתי' זכר משמע דברים הנשכחי' דהיינו מה שעבר דהיינו מה שלמדה בשכבר סימני ומדכתיב וישמע משמע מה שעכשיו היתה צועקת ובוכה על שלא תיזקק לעשו וק"ל מהרש"ל:	Mizrachi, Genesis 30:22:1
Yeriot Shlomo on Torah, Vayetzei 26	@11בד"ה האדמון כו' שלא התפלל כו' @22ולא ידעתי למה נדחק לפרש כך ולמה לא מפרש כפשוטו לשון כי חלה וגם ילדה ציון וק"ל כנ"ל:	Mizrachi, Genesis 30:22:2
Yeriot Shlomo on Torah, Vayetzei 27	@11בד"ה נקודים כו' והוכרח לפרש השה הראשון כו' @22נ"ב ואני אומר חלילה לפרש כך כי א"א שלא הזכיר רש"י ברמז ששה הוא תיש וג"כ משה כבשים כו' אין ללמוד דדלמא אדרבה מדכתיב שה עזים ש"מ שסתם שה אינו עזים וג"כ קשה א"כ למה לא כתיב תיש כמו שכתב אח"כ ועוד קשה הלא אח"כ לא הזכיר יעקב תיש כלל אלא נקוד וטלוא בעזים וחום בכבשים וכלל בעזים זכרים ונקבות וא"כ מ"ש ברישא שהזכיר בדבריו תיש ועוד קשה א"כ איך הפסיק כשבים בין תיש לעז לכך נרא' דבודאי שה כמשמעה ואינו קשה למה כתב אח"כ שה כבשים משום שכתב שה עזים אח"כ א"כ נופל הלשון בחילוף כבשים וק"ל וה"ק יעקב הסר כל שה נקוד כו' אע"פ שנקוד וטלוא בשה אינם שלי אפ"ה הסר כדי שלא תאמר שיולידו העזים אחריהם בהבטת' אליהם וכל שה חום בכשבים ונקוד וטלוא בעזים שהם עיקרי הסימני' ג"כ תסיר והיו שכרי הנולדים אח"כ כמו שפירש רש"י ומ"ה כתיב ויסר התישים וגו' וכל אשר לבן בו לרבות אפילו נקוד וטלוא בכבשים והא דלא כתי' מידי בחום העזים אפשר שלא היה בנמצא ומ"ה לא עשה יעקב שום תחבולה במקלות אלא כנגד נקוד וטלוא וק"ל מהרש"ל:	Mizrachi, Genesis 30:32:2
Yeriot Shlomo on Torah, Vayetzei 28	@11בד"ה ויסר לבן כו' דאל"כ ויעקב כו' @22נ"ב והנראה בעיני שיעקב לא ציוה להסיר אלא הנקבות העזים ולא התישים ולבן נבלה עשה והסיר אף התישי' ומ"ה עש' המקלו' בדין דלא עדיפי מתישי' ומ"ה מיושב שהמלאך א"ל שא נא עיניך וראה כל העתודים וגו' ומה שפרש"י שלא תאמר ע"י הזכרים הולידו כותיה כו' ל"ת שציוה להסיר כל הזכרי' אלא ישארו תישים מעט כדי שלא יסמוך על הנם כ"כ מהרש"ל:	Mizrachi, Genesis 30:35:1
Yeriot Shlomo on Torah, Vayetzei 29	@11בד"ה ברהטים כו' ברהטים במרוצת בו @22נ"ב ונ"ל שהרהטים היו נוזלים ויוצאין מתוך השקתות דהיינו הבריכות ובתוך אותן הנוזלין הציג המקלות ודוק ומ"ה עשה רהטים כדי שיוכל להציג שם המקלות לאפוקי בתוך הבריכות שהוא מקום שמשקין שם כל העולם ואינם בידו וק"ל מהרש"ל:	Mizrachi, Genesis 30:38:1
Yeriot Shlomo on Torah, Vayetzei 30	@11בד"ה אל המקלות כו' כבר תירצו כו' @22פירש של אמרי נועם מהרש"ל:	Mizrachi, Genesis 30:39:1
Yeriot Shlomo on Torah, Vayetzei 31	@11בד"ה והכבשים כו' כפי' דברי הרב כו' @22נ"ב ולפי מה שפרשתי א"כ הסיר לבן הכל מקודם ומה שהפריד יעקב היינו הנולדים אח"כ נקוד וטלוא בכשבים וחום בעזים שהיו ראוין ללבן וה"פ שיעקב לקח הנקוד וטלוא בכשבים ונתן לפני הצאן שהם העזים וק"ו שנתן הנקוד וטלוא של העזים לפניהם אלא שהוסיף ונתן אף הנקוד וטלוא של הכבשים ונתנ' עם הנקוד והטלוא של העזי' והכל לפני העדר של הצאן וכן לקח החום של הצאן דהיינו העזים ונתנ' לפני הכבשים עם החום של הכבשים וזהו מה שפירש רש"י החום שמצא בצאן לבן פי' שהיו נולדים בתוכם ולא היה נותן ג"כ לפני הכבשים ועכשיו ג"כ יתורץ קושי' הרמב"ן ע"ש ואל תתמה שצאן הוא עזים כי ע"כ מוכרח אתה לפ' שסימן נקוד וטלוא הוא בעזים והזכיר צאן וכן בכל הפרשה הזכיר צאן במקום עזים בפרט העתודי' העולים על הצאן שהם תישים וג"כ הכא שהזכיר כבשים אצל צאן א"כ צאן הוא העז ודוק מהרש"ל:	NULL
Yeriot Shlomo on Torah, Vayetzei 32	@11בד"ה מוכר צאנו כו' כל אלה @22נ"ב פיר' אף עבדים ושפחות מהרש"ל:	Mizrachi, Genesis 30:43:2
Yeriot Shlomo on Torah, Vayetzei 33	@11בא"ד מכח הכתוב כו' @22נ"ב ולי נראה מה שפירש בדמים יקרים אינו ר"ל בשער היוקר אלא כלומר דמים הרבה בסך חשוב שמכר הרבה צאן וקבץ סך חשוב שקנה כל אלה ודוק מהרש"ל:	NULL
Yeriot Shlomo on Torah, Vayetzei 34	@11בד"ה למה נעכב כו' @22נ"ב וטוב היה ראוי לגרום למה נתעכב על ידו וקאי על לבן ודוק מהרש"ל:	Mizrachi, Genesis 31:14:1
Yeriot Shlomo on Torah, Vayetzei 35	@11בד"ה לאחיו הם כו' לא יחיה פיר' כו' @22נ"ב ולי נרא' דבודאי אין דרך מוסר לומר להאורחין שבאו עם לבן לכבודו שיעשו מלאכה ויעשו גל בשלמא אם היה אומר ללבן אף שהיה חמיו ליכא קפידה משום שהיה ברית ועדות ביניהם שהוא כבר הרים המצבה מאבן גדולה והי' אומ' לו שיעשה ג"כ אבל לאותם שבאו עמו איך שיעבד עמהם ומה שמקשין העולם הרי כתיב בדברי לבן הגל אשר יריתי ודוחק הוא לפי זה שלא עשה מאומה דהכי פירוש' הנחתי לירות אותו להיו' ברית מ"ה מתרגם אשר יריתי די אוקימות ודוק מהרש"ל:	Mizrachi, Genesis 31:46:1
Yeriot Shlomo on Torah, Vayetzei 36	@11בד"ה לאחיו כו' וללוי תבריח כו' @22צ"ל קבריה ופי' הלואי שאותו אח היה קבור כנ"ל:	Mizrachi, Genesis 31:54:2
Yeriot Shlomo on Torah, Vayetzei 37	@11בסוף ד"ה המלאכים כו' @22נ"ב ול"נ דלק"מ כי מיד שעקר יעקב ממקומו לילך לביתו לא"י אז הלכו עמו מלאכים של א"י ופסקו ממנו מלאכי חו"ל וכן מיד כשיצא מבאר שבע ללכת לחרן סלקו ממנו מלאכי א"י ופגעו בו מלאכי ח"ל ומאחר שאין כח למלאך אלא בארצו מ"ה לא הצילו אותו במקום דשכיח היזק' ומ"ה לקח אליפז כל אשר לו ולולי שנתגדל בחיקו של יצחק היה הורגו וכן המלאכי' של א"י לא היה לכם כח להציל אותו מהיזק המצוי ומ"ה היה מתיירא מעשו ושלח אות' לפניו ודוק מהרש"ל:	NULL
Yeriot Shlomo on Torah, Vayishlach 1	@11בד"ה מלאכי' ממש כו' @22נ"ב ולי נראה מלשון לפניו דייקינן דכל שליחות הוא להחזיר ודעתו של יעקב היה שלא יחזרו אלא יצילו אותו ממנו ובסיבת' ויגמרו בפעולת שכלן שלא יצא נגדו והקב"ה רצה לעשות לו נם נגלה וגם להבהיל אותו כי הקב"ה מתאוה לתפילתן של צדיקים כדאמרינן ביבמות בפרק הבע"י למה אבותינו עקורים היו כו' א"נ לפניו מאותן שהיו מוכנין לפניו תדיר לשומרו וללויהו וק"ל מהרש"ל:	Mizrachi, Genesis 32:4:1
Yeriot Shlomo on Torah, Vayishlach 2	@11בד"ה לא נעשתי כו' @22נ"ב מה שפירש"י גרתי תרי"ג מצות כו' מה בא להודיע לעשו נ"ל דהכי החיבור דמתחילה ציוה לו לאמר שלא נתקיימו בו הברכות ולכן לא יתקנא בו ואם אתה אינו משגיח בזה וסובר שנתקיימו הברכות א"כ לא תוכל לעשות לי מאומ' מצד הברכות ובמה אתה סומך על דברי אבינו והיה כי תריד וגו' קיימתי כל התורה ואין להתורה על מה לצעוק מהרש"ל:	Mizrachi, Genesis 32:5:1
Yeriot Shlomo on Torah, Vayishlach 3	@11בד"ה אל אחיך כו' לא דרשו כלום @22נ"ב נראה דלק"מ דיעקב ציוה להאריך בדברים ולהתאירן על צד ההכנעה כלומר מעבדיך מאיזה עבד מיעקב וכן לאדוני לאיזה אדון לעשו אבל גבי אל אחיך שחזרו המלאכים בתשוב' מה תועלת יש בתואר הלשון ודוק מהרש"ל:	Mizrachi, Genesis 32:7:1
Yeriot Shlomo on Torah, Vayishlach 4	@11בד"ה וירא כו' מחא דבר כו' @22נ"ב ולי נראה דלק"מ כי כל השליחות שאמר הקב"ה לנביא או מה שיוצא מפיו של הקב"ה אינו חוזר אבל מה שאומר אדם בנבואה ע"ד רוה"ק כגון השירה שאמר משה ברוה"ק שפיר חוזר ומה שהבטיח הקב"ה ליעקב היה בישן ממש ובחלום ולא עדיף מרוה"ק ודוק ודע שיש חילוק בין נבוא' שהיא בהכרחי לרוה"ק השורה על הנביא והוא מדבר קצת בבחירתו ומ"מ נענשה דבורה על שאמרה עור' דבורה עד שקמתי אם בישראל וכן נענש ישעיה בדברו בתוך עם טמא שפתים אנכי יושב וגו' והמבין יבין ועוד נראה בעיני ט"א דהיה ירא שמא היה חעא בידו שהיה לו למחות ולא מיחה ובפרט בלבן ואמרינן דאפילו מפי הקב"ה עצמו חוזר לרעה מהרש"ל:	Mizrachi, Genesis 32:8:1
Yeriot Shlomo on Torah, Vayishlach 5	@11ויצר לו שמא יהרוג אחרים כו' @22נ"ב והעיקר נראה בעיני מה שפירש"י יהרוג אחרים כלומר אותן שדעתן לא יהיו לרעה אף שבאו עם עשו מ"מ יהיו כמה וכמה שאין דעתם כלל להריגה וק"ל מהרש"ל:	Mizrachi, Genesis 32:8:2
Yeriot Shlomo on Torah, Vayishlach 6	@11בד"ה ובבית לבן כו' ואהיה עמך כו' @22נ"ב ומזה אין להקשות איך יחזור מן העובה לרעה כי לא הבטיח אותו שיחזירנו בשלום אל אדמתו אלא שיצא מן הרשע לשוב לארצו ויחיה יום אחד אף שיהרג אח"כ בדרך מ"מ נתקיים הנבואה אף שלא שב לארצו כמו וילך חרנה יצא ללכת חרנ' כדאמרי אינשי ה"נ יצא לשוב ודוק מהרש"ל:	Mizrachi, Genesis 32:10:1
Yeriot Shlomo on Torah, Vayishlach 7	@11בד"ה לפניהם כו' שאגמלים המניקו' כו' @22נ"ב ולא נהירא לי שהרי רש"י כתב מתחילה גמלים מניקות שלשי' משמע דזה בא להודיע לנו שלא תאמר עם הכל שלשים מ"ה פי' גמלים שלשים ובניהם עמהם כלומר שלשים גמלים מניקות ובניה' עמהם ואינם מן החשבון של שלשים ואח"כ כתב ומדרש אגדה אומר ובניהם זכרים כלומ' זכר לנקבה דהיינו בין הכל שלשים וראיי' מדלא כתיב גמלים שלשים ובניהם שלשים ולא שייך לומר כאן עמהם כמו על בנים ממש וק"ל מהרש"ל:	Mizrachi, Genesis 32:17:2
Yeriot Shlomo on Torah, Vayishlach 8	@11בא"ד בנאיהו זכר @22נ"ב ולפירושו לא כתיב ומדרש אגדה אומר כו' מהרש"ל:	NULL
Yeriot Shlomo on Torah, Vayishlach 9	@11בד"ה והנה גם כו' ופירושו שציוה כו' @22נ"ב וכך נ"ל ההוצעה שבתחילה ציוה לומר לכל עדר והנה גם הוא אחרינו וכשתתקבצו כולכ' לפניו תחזירו ותאמרו גם הנה יעקב אחרינו כי אמר אכפרה פניו כי דברים ריצוים כאלו ראוי לומר כשיהיו כולם ביחד וק"ל מהרש"ל:	Mizrachi, Genesis 32:19:2
Yeriot Shlomo on Torah, Vayishlach 10	@11בד"ה עשה עצמו כו' את הנחל @22נ"ב ודינה היכן היתה וכו' דע"כ לא חסר שום אחד דהא מדכתיב לקמן אלהי' יחנך גבי בנימין ודרשינן לפי שלא היה בברכת חנן משמע שכולן היו בברכת חנן ודוק מהרש"ל:	Mizrachi, Genesis 32:24:1
Yeriot Shlomo on Torah, Vayishlach 11	@11בד"ה שכח פכי' קטנים כו' @22נ"ב ולי נראה מ"ה פי' פכים קטנים דהא כתיב לעיל ויעבר את כל אשר לו אלא היה פכים קטנים עם שמן ליצוק על האבן אשר נדר וזהו אינו שלו אלא של שמים ומ"ה נשא את נפשו עליו ופכים קטנים לאו דוקא קאמר אלא פך קטן ואולי רמז בזה בעבור שנשא את נפשו לקיים נדרו בפך קטן נעשה נם לבניו חשמונאי ע"י פך קטן וזהו שכח פכי' קטנים ודוק מהרש"ל:	Mizrachi, Genesis 32:25:1
Yeriot Shlomo on Torah, Vayishlach 12	@11בד"ה ותוכל להם @22נ"ב ולי נראה שרש"י כיון להא שלא תימא שותוכל קאי אעשו ולבן ושרית קאי אאלהים לבד אבל לא שיוכל לו וזהו נגד הקרא וישר אל מלאך ויוכל אלא ותוכל קאי אכולהן וזהו להם ודוק מהרש"ל:	Mizrachi, Genesis 32:29:1
Yeriot Shlomo on Torah, Vayishlach 13	@11בד"ה והוא צולע כו' הוסיף מלת כו' @22נ"ב ולי נראה כפשוטו מדכתיב והוא צולע אחר זריחת השמש מלבד שאף אחר זריחת' היה צולע אלא שברוח שפעת זריחת שהוא רוח צפונית שמנשבת עם זריחת החמה כדאיתא בפרק הערל הוא המרפא כדי שלא תאמר מיד כשהאיר החמה והוא תלך במערכת הגלגלי' כי יש חולי שהוא תקיף בלילה וכהאיר היום הוא נקלה ודוק ומאחר שלא נדע כמה זרחה שהרי לא נתרפא מיד כדפי' לכך פי' שאות' שעות שמיהרה וכו' ואח"כ בא לפרש ויזרח לו השמש כפשוטו מהרש"ל:	Mizrachi, Genesis 32:32:2
Yeriot Shlomo on Torah, Vayishlach 14	@11בד"ה למה הוא לך כו' מלת מי @22נ"ב ולי נראה דה"ק מי הם המוליכי מנחה אם הם משרתים שלך שקשה למה הוא לך או אם הם בני משפחתך וריעים שלך שהם מבקשים אהבתי שזו אינו קשה למה הוא להם ודוק מהרש"ל:	Mizrachi, Genesis 33:8:2
Yeriot Shlomo on Torah, Vayishlach 15	@11בד"ה יהי לך מפני שמלת @22נ"ב ולי נראה דרש"י דייק שלא תאמר אל נא קאי אהודאות שהודה לו על הברכות וזה לא יתכן אלא על האמירה שאתה אומר יש לי רב ואינך רוצה לקבל כולו מהרש"ל:	NULL
Yeriot Shlomo on Torah, Vayishlach 16	@11בד"ה נסע סכו' כו' של מקרא @22נ"ב וי"ל לפי שבפ' וישב פירש"י על ימי' רבים כ"ב שנה לא כבד יעקב אביו שהיה בבית לבן ואלו לא שהה כאן לא תמצא כ"ב שנים מהר"ן שפירא מה שפרש"י ויבא יעקב שלם שלם בגופו ובממונו ושלם בתורתו נ"ל כפשוטו היכא דכ' שלם משמע בשלימתו בלי העדר ומ"ה פיר' כולם ואולי ג"כ רש"י למד מעניינו דמה שכתיב אחריו בבואו מפדן משמע שלא למד מלבן ומה שכתיב אחריו ויקן כו' משמע שלא נחסר ממונו שהרי בקרקע קטנה בזבז מאה קשיע' וא"כ ויבא שלם דקאמר לגופו אתי ובעבור זה כתיב ויבא יעקב הוא בעצמו שהרי כבר היה נחסר כדכתיב ותקע כף ירך יעקב וק"ל מהרש"ל:	Mizrachi, Genesis 33:17:1
Yeriot Shlomo on Torah, Vayishlach 17	@11בד"ה שני בני כולו יעקב יתירה @22נ"ב ולי נראה דרש"י דייק מדלא כתיב ויבואו שמעון ולוי בני יעקב אלא ודאי שבא לדרשה וה"ק שני בני יעקב היו ועשו את עצמן כאלו היו שמעון ולוי מן השוק שאינם בניו ודוק מהרש"ל:	Mizrachi, Genesis 34:25:1
Yeriot Shlomo on Torah, Vayishlach 18	@11מה שתרגם אונקלם ויבאו על העיר בטח ועלו על קרת' דיתבת לרוחצן @22ולמה לא תרגם בטח על בני יעקב וכדפרש"י א"ל דאי אבני יעקב קאי הל'ל בבטח או בטוחים דהא מצינו ג"כ בפ' ראה וישבתם בטח אלא נראה דדייק מדלא כתיב ויבואו בטח על העיר ודוק כנ"ל:	NULL
Yeriot Shlomo on Torah, Vayishlach 19	@11בד"ה את אחותינו כו' כדלעיל @22נ"ב ולי נראה שאם תפרש עם אחותינו א"כ מה תמיה היא זו וכי בעבור שאחותם היא מ"ה לא יעשה מה אתה אומר ואחותינו כשירה היא ואין ראוי לעשות עמה כבזונה זה לא כתיב במקרא אבל כשאתה מפרש ית אחתנ' כלומר שעושה אות' הפקר משמע שהיא אינה עושה אלא הוא עושה אותה וא"כ היא התימה ודוק מהרש"ל:	Mizrachi, Genesis 34:31:2
Yeriot Shlomo on Torah, Vayishlach 20	@11בד"ה האלה מין אילן סרק כו' @22נ"ב והקש' הרמב"ן והלא דינא בשריפה או מפרר וזוזרה לרוח ואי מותרת ומיירי שביטלו הגוי בע"כ א"כ מותרת לגמרי ולמה הטמינם ואני שמעתי שיעקב אמר לבניו אם ירדפו יושבי הארץ אחריכם וישאלו למה הרגתם אותם ואם שכם וחמור חטאו הם מה חטאו תשיבו שהיינו מתנים עמהם בתנאי גמור להיות לעם אחד ולעבוד אלהי אברהם ולבער הפסילים וכל אלהי נכר והרי בכל בית ובית מצאנו ע"ז ע"כ הטמינ' לעדות ולראייה אם ירדפו אחריה' ודוק מהרש"ל:	Mizrachi, Genesis 35:4:1
Yeriot Shlomo on Torah, Vayishlach 21	@11בד"ה הוגד כו' וכדפרש"י לעיל @22נ"ב מה שפירש"י שהעלימו מיתתה קבלתי מאדוני חמי ז"ל ע"ד הכוונה המקלל החי חייב שהוא בכלל חרש והמקלל המת פטור ודוק מהרש"ל:	Mizrachi, Genesis 35:8:3
Yeriot Shlomo on Torah, Vayishlach 22	@11בסוף ד"ה גוים מנשה כו' @22נ"ב ואני אומר שאין לשבש כאשר נכתוב לקמן בפ' ויחי מהרש"ל:	NULL
Yeriot Shlomo on Torah, Vayishlach 23	@11בד"ה ואהליבמה היא יהודית כו' @22נ"ב ויש מקשין א"כ למה כתיב לעיל יהודית איך כינה בשם הרשע שמה לעיל ולא כתב שם האמיתי וגבי בשמת כתב הכינוי לגנאי וי"ל דמ"ה כתיב לעיל בשמת ללמדך על סימוי העין של יצחק מעשנן של אלו מהרש"ל:	Mizrachi, Genesis 36:2:1
Yeriot Shlomo on Torah, Vayishlach 24	@11בא"ד לחתי ולחוי @22נ"ב ומה שמקשין העולם וגם רא"ם למה כתב כאן החוי ולעיל החתי י"ל לפי שאפשר שהחוי היה יותר אדוק בע"ז משאר בני אדם ולעיל שינה שמה יהודית כלומר שהיא כופרת בע"ז וכאלו היא בתו של חתי ודוק ומה שמקשין העול' דהכא כתיב בת ענה ושם כתיב בת בארי י"ל נמי שאותה רשע כינה שמה בת בארי כלומר בת באר לחי רואי לשבח ולא בת ענה שהוא פסול והביא פסולים לעולם מהרש"ל:	NULL
Yeriot Shlomo on Torah, Vayishlach 25	@11בד"ה ענה כו' י"ל א"ה כו' @22נ"ב והקשה לי משכיל אחד אדרב' נימא ששניה' קלקלו ואז לא קלקל' אלא אשה אחת דהיינו אשת צבעון שפעם אחת בא שעיר עליה ופעם שנית בא עליה בנה ענה ממה שנאמ' צבעון לבד קלקל ושתי נשים אשת שעיר ואשת ענה והשבתי לו שהקילקול אינו שייך כ"כ באשה לפי שאפשר שבא עליה בע"כ וק"ל מהרש"ל:	Mizrachi, Genesis 36:2:2
Yeriot Shlomo on Torah, Vayishlach 26	@11בא"ד שכך כתבו התו' @22ונ"ב ותימה על דבריו מאח' שרוצה לפרש שענה היתה נקבה א"כ לא יצטרך לשום פסול ומפרש המקרא כפשוטו בת ענה שהיתה בת צבעון וכן הוא לדעת ר"ת שם ונ"ל שלא דק מהרש"ל:	NULL
Yeriot Shlomo on Torah, Vayishlach 27	@11בא"ד ולית' דא"כ כו' @22נ"ב ולי נראה דשפי' קמתרצי והא דקרי ליה בנו של שעיר אינו שקר דהא בני בנים הרי הן כבני' ואעפ"י שלא בא הפסוק ללמדינו זה אלא שיצאה מתוך שניהם ונראה כבנו של שעיר מ"מ הכתוב אומר האמת נמי שהוא ג"כ בנו של שעיר אבל אי הוי שעיר בא על כלתו לא הול"ל שהוא בנו של צבעון והתורה הקדושה מעיד' ואלה בני בסיפור הנבוא' וע"פ האמת ומה שפי' גבי אהליבמה כו' ואעפ"י שלא תהיה בתו של ענה לפי האמת לא קפדינן שהרי לא כתב שם ואלה בני וגו' ולא סיפר היחם אלא ודאי בת ענה כמו שהיה העולם סובר ומה שכתב אח"כ ואלה בני ענה וגו' וחשיב אהליבמה נוכל לומר דאדרב' משם יראה דלא היתה בתו מדכתיב בת ענה יתירא ש"מ דה"ק ואלה בני ענה דישון וכל הנולדים ואהליבמה היתה ג"כ נחשבת לבת ענה ואע"פ שאינה בתו וק"ל וכ"ז לפרש"י שלנו אבל לפרש"י שהביאו התו' בפרק יש נוחלין שפי' נמי שענה בא על אמו כלומר על אמו שהיא אשת אביו כמו שבא צבעון על אשת אביו והוא אמו ממש כך בא ענה על אם חורגו דהיינו אשת צבעון מיושב הכל שפיר בסיגנון אחר ודוק מהרש"ל:	NULL
Yeriot Shlomo on Torah, Vayishlach 28	@11בד"ה ובדברי הימים כו' דלמא בהיתר @22נ"ב ולי נראה דלא קשיא כי אע"פ שהם בני ממזרים מ"מ לא עשו כ"כ בפרהסיא שאם היה ידוע לעולם שהית' בתו לא היה לוקחה לפילגש ועוד מה היה מראה לנו גדולתו של אברהם וק"ל אבל אין להקשות לפירש הרב דילמא נאמר שעיר החורי בא על אשת אליפז וק"ל אלא ע"כ חד מהני ב' תירוצים שפי' שא"כ היו העולם סוברין שהיא בתו של אליפז ולא היה לוקחה לפילגש וג"כ לא היתה גדולתו של אברהם מוכחת כדפירש משום דא"א לפרש שבא שעיר כו' דא"כ היה לו לימנות בבני שעיר והכתוב קראה אחות לוטן דמשמע מן האם לחוד כדפי' מהרש"ל:	Mizrachi, Genesis 36:12:2
Yeriot Shlomo on Torah, Vayishlach 29	@11בד"ה מגדיאל כו' שמלכו ברומי @22נ"ב ולי נראה שבא להודיע כמו שפסקו המלכים כן יפסקו האלופים שהרי לא מנה אחריו אלא א' מהרש"ל:	Mizrachi, Genesis 36:43:1
Yeriot Shlomo on Torah, Vayeshev 1	@11בד"ה אחר שכתב לך ישובו של עשו כו' @22נ"ב ולי נראה מדכתיב כאן וישב יעקב בלי צורך שהרי כבר כתיב ויבא יעקב אל יצחק אביו אלא כלומר שהפסיק בתולדותיו של עשו ואח"כ אמר נחזור לראשונה ודוק מהרש"ל:	Mizrachi, Genesis 37:1:1
Yeriot Shlomo on Torah, Vayeshev 2	@11בד"ה ואלה תולדות כו' עם וי"ו @22נ"ב ואני אומר שהוי"ו זו כפשוטו כלומר כבר ספרתי בקצרה תולדותיו של עשו ועתה באתי לספר ולהציע תולדותיו של יעקב ודוק מהרש"ל:	Mizrachi, Genesis 37:2:1
Yeriot Shlomo on Torah, Vayeshev 3	@11בד"ה תלה הכתוב @22נ"ב מפני שקשה לו דדי היה בוישב יעקב שחוזר על הראשונות מפני מה הוסיף וכתב תולדות כו' היה לו להתחיל ויוסף היה כו' וק"ל מהרש"ל:	Mizrachi, Genesis 37:2:2
Yeriot Shlomo on Torah, Vayeshev 4	@11בד"ה בקש כו' עליו רוגזו כו' @22נ"ב פירש שק"ל למה הפסיק כל עיקר בתולדותיו של עשו בשלמא גבי נח א"א שלא להפסיק וק"ל אבל הכא לא היה לו להפסי' כלל ואם בא להודיע התועלת שיוצא ממנו היה לו לכתוב במקום אחר אלא כלומר הודיע כאן שיעקב ביקש לישב בשלוה פי' מהרש"ל:	Mizrachi, Genesis 37:2:5
Yeriot Shlomo on Torah, Vayeshev 5	@11בד"ה ובשלשתן לקה כו' קורין אותן עבדים כו' @22נ"ב ולי נראה דלאו דוקא שהיו קוראין אותן עבדים דח"ו שגנאי היה להם ולאביהם אלא שהיו קורין אותן לשימוש תבא ותעשה לי כך וכאלו היו קורין אותן עבדים דשימוש של עבדות הרי הוא כעבדות ולא היה הדבר כן אלא שבני השפחות נהגו כבוד וחשיבות בבני הגבירות ואותו הדיבור היה גם כן זילות' לבני השפחות שיוסף אמר איך שקורין אותן עבדים ודוק ומ"ה מיושב נמי מה שהקשה הרמב"ן למה לא הצילו אותו בני השפחות וק"ל מהרש"ל:	Mizrachi, Genesis 37:2:13
Yeriot Shlomo on Torah, Vayeshev 6	@11בד"ה לסוחרים ואת האגדה כו' @22נ"ב ונראה לי דלק"מ כי המדינים שמכרו למצריים היינו סוחרי מצרים קודם שמכרו לפוטיפר ומ"ה אל תצערך לפרש לקמן למצרי' כמו במצרים ודוק מהרש"ל:	NULL
Yeriot Shlomo on Torah, Vayeshev 7	@11בד"ה לאחר כו' ולאביו בפניהם @22נ"ב והנרא' בעיני שדעתו שנ יוסף היה כדי שיפתרו אותו וכן עשו שיאמרו לו המלוך תמלוך וגו' ואח"כ הרגישו בדבר ושתקו ומ"ה חזר וסיפר לאביו בפניהם אולי יפתחו פיהם וע"כ גער אביו וכו' ומה שאמר הבא נבא ע"כ צ"ל שלא היה יודע דאל"כ למה היה פותר כך דכ"ש שיטיל עליו שנאה והיה לו לגעור ולשתוק בפניהם אלא בע"כ לא ידע ומה ששמר הדבר לפי שאין חלו' בלא דברים בעלים ומה שאמר ורבותינו למדו מכאן כו' אפילו לפי פירש הראשון צ"ל כן אלא שרבותינו אמרו שהאמת כן הוא שלא היה מכוין ומגיע לבלהה שגדלתו כאמו אלא הוא דברים בעלים וק"ל מהרש"ל ובב"ר איתא דלכך שמר את הדבר שהי' סבור דלמא תחיית המתים יהיה בימיו ותחזור ותחיה אמו ולכך היה שומר ומצפה ע"ש:	Mizrachi, Genesis 37:10:1
Yeriot Shlomo on Torah, Vayeshev 8	@11בד"ה ויבא שכמה כו' לדעת זה @22נ"ב ובימי חורפי תרצתי מדכתיב וימצאהו ולא כתיב ויפגשהו ש"מ שביקש אותו האיש וימצאהו וק"ל מהרש"ל:	Mizrachi, Genesis 37:14:2
Yeriot Shlomo on Torah, Vayeshev 9	@11בד"ה רוח הקודש מעיד' כו' @22נ"ב אמר בכור אני מקשין העולם שמא דעתו לשם שמים היה וי"ל דא"כ אמאי שיבח יעקב את יהודה מטרף בני עלית יות' היה לשבח את ראובן שבא להצילו לגמרי אלא שדעתו לא היה לש"ש אלא משום שלא יתלה כו' ומה שאמר בכור אני כלומר ידמה אבי שהסירחון בי מאחר שאני בכור ומקנא אותו בעבור הבכור' כי מיד כשקלקל ראובן נטל ממנו הבכורה ונתנה ליוסף ודוק מהרש"ל:	Mizrachi, Genesis 37:22:1
Yeriot Shlomo on Torah, Vayeshev 10	@11בד"ה את כתונת כו' אשר עליו @22נ"ב ולי נראה כפשוטו שהיה הכתונת פסים על זה הכתונת והוציאו שניהם כאחד מלמע' למעלה כדי לומר שאין אנו מקנאין בך בעבור הכתונת אלא הפשיטו התחתון והעליון ממילא היה נפשט עמו וק"ל מהרש"ל:	Mizrachi, Genesis 37:23:2
Yeriot Shlomo on Torah, Vayeshev 11	@11בד"ה והודיעך הכתוב כו' @22נ"ב ואני אומר לולי פירש"י הייתי מפרש שהמדנים אינם מדינים והמדנים הם האנשים המסתחרים למצרים וקרובי' למצרים אבל המדינים לא הלכו למצרים וה"ק קרא ויעברו אנשים ישמעאלים פירש אותן אנשים לא הורגלו להסתחר בעבדי' ובפרע אותן אנשים שסחורתן היה נכאת וצרי ואינם מן הסוחרים הגדולים ואח"כ בעת שמשכו אותו באו המדינים דהיינו סוחרים גדולים שדרכן לקנות עבדים ומ"ה לא מכרו להם אלא לישמעאלים כמובן מן הפסוק כלומר שהקב"ה נתן סיבה בלבם שיתגלגל הדבר שיבא למצרים ולא למדין והיינו דכתי' נורא עלילה וכו' מהרש"ל:	Mizrachi, Genesis 37:28:2
Yeriot Shlomo on Torah, Vayeshev 12	@11בד"ה כנעני תרג' @22נ"ב וכ"ש מה שאמר ר' נחמיה כנעניות היו שפירושו כך וק"ל מהרש"ל:	NULL
Yeriot Shlomo on Torah, Vayeshev 13	@11מה שפירש רש"י @22ותקרא שמו שלה פוסקת ר"ל שילהי קייט' ושילהי מסכת' מהרש"ל:	NULL
Yeriot Shlomo on Torah, Vayeshev 14	@11בד"ה ויבך אותו אביו כלפי יצחק כו' @22נ"ב פירש יצחק היה בוכה מפני צערו של יעקב ולא מפני יוסף שהרי ידע בנבואה שהוא חי וק"ל מהרש"ל:	Mizrachi, Genesis 37:35:4
Yeriot Shlomo on Torah, Vayeshev 15	@11בד"ה ונ"ל כו' @22נ"ב ואני אומר מאחר שגזרו על הזנות מימי נח א"כ אזהרתן זו היא מיתתן וק"ו זו שעומדת ליבום מהרש"ל:	NULL
Yeriot Shlomo on Torah, Vayeshev 16	@11בד"ה שלש נפשות כו' משמע שלא כו' @22נ"ב ואני אומר והנה תאומים כמו ויהי בבוקר והנה היא לאה כלומר שעכשיו נתפרסם מה שהיא ידעה בשכבר ואפשר שקשה למחבר שלא היה לו לכתוב נא באמצע אלא מקודם הכר או בסוף הענין אלא שאמרה לו הכר שאני הרה תאומים ונא אל תאבד ג' נפשות מהרש"ל:	Mizrachi, Genesis 38:25:1
Yeriot Shlomo on Torah, Vayeshev 17	@11בד"ה כנגד ד' חרמי' כו' @22נ"ב מה שרימז פה נגד ד' חרמי' היינו נגד חוט השני שרימז על החטא שנאמר אם יהיו חטאיכם כשנים כשלג ילבינו מהרש"ל:	NULL
Yeriot Shlomo on Torah, Vayeshev 18	@11בד"ה ויקרא שמו כו' דכיון דשם פרץ כו' @22נ"ב ול'נ מדלא כתיב ואחר יצא אחיו ויקרא שמו זרח וכתיב ואחר יצא אחיו אשר על ידו השני משמע שנתינת טעם הוא לשם וק"ל מהרש"ל:	Mizrachi, Genesis 38:30:2
Yeriot Shlomo on Torah, Vayeshev 19	@11בד"ה ועוד כדי לסמוך כו' למעשה תמר @22נ"ב ועוד נראה לי דק"ל מאחר שחוזר על הראשונות א"כ היה לו לכתוב ויביאו יוסף מצרימה כמו שכתוב מתחילה או והמדנים מכרו אותו לפוטיפר וכולו שהוא עניינו של ראשון ממש אלא שבא לומר כאלו סמך כאן מצד עצמו ודוק מהרש"ל:	Mizrachi, Genesis 39:1:1
Yeriot Shlomo on Torah, Vayeshev 20	@11בד"ה כי אם הלחם כו' ולכן מה שהקשה כו' @22נ"ב ואני אומר שבודאי סריס ממש היה וקודם זה המעשה כמו יום או יומים היה נתרפא בסיבה זו כדי שיאמין לאשתו ויתפסוהו וע"י גילגול זה ירדו כל אחיו למצרים כדפירש לעיל אבל מ"מ לא אמר' ששכב עמה אלא עשה עמה חדודין קרובי תשמיש מהרש"ל:	Mizrachi, Genesis 39:3:2
Yeriot Shlomo on Torah, Vayeshev 21	@11נ"ב לעשות מלאכתו @22מה שתרג' אונקלום למבדק בכתבי חושבנ' ולא שאר מלאכה משום דק"ל הלא מ' מלאכות כתובים בתורה ותלמודא בפרק במה טומנין דריש כמנין ל"ט מלאכות ע"כ משני שאינה מלאכה ממש ודוק מהרש"ל:	NULL
Yeriot Shlomo on Torah, Vayeshev 22	@11מה שפירש"י דמות דיוקנו של אביו כו' @22כתבו התו' במסכת סוטה בשם ר' משה הדרשן דדיוקו הוא מדכתיב ואין איש מאנשי הבית שם דמשמע מאנשי הבית לא היה שם איש אבל איש אחר היה שם וזהו דמות דיוקנו ע"כ:	NULL
Yeriot Shlomo on Torah, Vayeshev 23	@11בד"ה כפורחת כו' משיב ידו כו' @22נ"ב ואני אומר כמשיב ידו הוא פירש כדמות משיב ידו כאלו רצה לשוב ונרתע לאחוריו ועדיין לא שב לגמרי התחיל השני לצאת ולא המתין עד שהחזיר כבר כל ידו ותדע דאי לא תימא הכי למה קשרה השני כלומר להודיע שהוא הראשון אע"פ שאינו נ"מ לענין דין בכורה מ"מ אפשר נ"מ לכבדו להקדימו וכן היה המנהג בימיהם דאל"כ קשיר' השני למה וא"כ קשה הלא לא מצינו דאישתמוט בקרא שום חשיבות והקדמה בשום ענין לזרח אלא שתאמר שדעתם היה שהשיב ידו ממש או יצא כולו והנה לא שב ידו ועומד לצאת ואפ"ה לא הגביר אחיו ויצא וע"כ קראו שמו פרץ ודוק מהרש"ל 	Mizrachi, Genesis 40:10:1
Yeriot Shlomo on Torah, Miketz 1	@11בד"ה מקץ כו' עוד שני שנים כו' @22נ"ב ול"נ דכוונת רש"י לקיים המדרש דסוף הפרשה דסיים מינה לפי שתלה יוסף בטחונו בשר המשקים הוזקק להיות אסור עוד שני שנים אלמא דשני שנים היה אסור וקר' מסייע אשרי הגבר אשר שם ה' מבטחו והוא לא עשה כראוי לו לצדיק לכך נענש שנה ולא עוד אלא ולא פנה אל רהבים והוא פנה לכך נענש עוד שנה דהיינו ב' שנים א"כ צריך לפרש מקץ שנתי' מסוף כתרגומו ולא תפרש מהתחלת ב' שנים דהיינו יום א' בשנה שנייה לאסירתו דא"כ לא יתקיים הא דלעיל ומ"ה פי' דאינו כן דכל לשון קץ סוף הוא ואפי' מה שנאמר מקץ שבע שנים וגו' אפי' אותו קץ לשון סוף הוא ואיירי בשמיעת כספים כמו שפי' הרב אבל לא שבא לפרש כל לשון קץ ולאפוקי קצה כמו שפי' הוא מהרש"ל. ונ"ב עוד יש מקשין למה לא ראה פרעה השנות הדבר כענין א' ב"פ פרו' או ב"פ שיבלים ונ"ל לפי שהשיבלי' היו מראין לו שע"י השיבולים אלו יתקיים החלום שלו שהיה ע"י השיבולים והנה מאלמין אלומין וגם הפרו' היו עולין מן היאו' לפי שהשובע התחיל רק במצרים לפי שלא תמצא שובע רק בארץ מצרים כמובן מן הפסוק כלומר מן הנילוס יעלה שובע לעולם ולא משום ענין אחר אבל השיבלים רמז לכל העולם דהיינו ותבלענה השבלים שיהיה בכל העולם הרע' ותדע שאם היה שובע בארץ כנען וכי לא היה יעקב מאסף ג"כ מרוב ריבוי השובע שדרך לבא רעב אחר רוב תגבורת השובע שלא בדרך העולם בפרט החכם עיניו בראשו אלא כדפירשי' ודוק מהרש"ל והנה מ"ש שהשובע לא היה רק בארץ מצרים לחוד יפה כתב שכן כתב בהדיא הרמב"ן בפר' זו אך מ"ש שהרעב היה בכל העולם זה אינו סברה כלל דא"כ היו מתים ברעב אותן שלא היו יכולין להגיע לארץ מצרים וכ"כ הרמב"ן בפרשת ויגש והביא ראייה מב"ר ע"ש כנ"ל:	Mizrachi, Genesis 41:1:1
Yeriot Shlomo on Torah, Miketz 2	@11בד"ה כל שאר כו' אבל נהר כו' @22נ"ב ואני שמעתי דק"ל מאחר דכתיב פה יאור וע"כ נילוס הוא דלא היה במצרים אלא זה ובבראשית קרא נהר פישון אלא צ"ל שהנהר קרוי יאור וממ"נ אם תאמר שכל נהר קרוי יאור א"כ היה לו לכתוב אצל הנהר מה אומר לא הייתי יודע אצל איזה נהר והכתוב לא בא לסתום אלא לפרש ביאור ג"כ לא תדע איזה יאור שהרי כל נהר קרוי יאור ע"כ פי' בודאי כשכתב הכתו' סתם יאור ע"כ נילוס הוא שראוי לקרותו מן הסתם יאור כמו שפי' שעשוי יאורים לאפוקי שאר נהרות אינם בכלל סתם יאור א"ל היכא שכתב להדיא ודוק מהרש"ל:	Mizrachi, Genesis 41:1:2
Yeriot Shlomo on Torah, Miketz 3	@11בד"ה שדופו' כו' הלי"דש @22נ"ב בכאן טעה כל עיקר שהרי לשם בכי תבא פירש"י להדיא דשידפון וירקון מכת תביאה וגם דוחק הוא שפירש אחר לשון הלועז ואח"כ מביא התרגום שלא פי' כן א"כ מתחילה למה לא פי' אחר התרגום אלא רש"י מפרש הכא הלעז שהוא מלשון התפעל כלומר שהן מוכות מן הקדים כמו שפירש התרגום אבל שידפון שבתוכחה הוא שם המכה כמו ירקון ולא מלשון התפעל ודעת רש"י לשם כמו שפרשתי ע"ש ומ"ה פי' הכא הליד"ש בלעז ולשם פ" אשליד"א בלע"ז ואין לומר שהלעז שפי' לשם מלשון רוח קדים קאמר שקרוי כן שהרי הכא פי' להדיא שקרוי ביש"א בלעז אלא שהש' אשליד"א והמתפעל קרוי הליד"ש וכן עיקר מהרש"ל:	NULL
Yeriot Shlomo on Torah, Miketz 4	@11בד"ה ומערפ' כו' הענבלין שבתוכן כו' @22נ"ב ואני אומר בקצרה הרוח מקשקש' בתוך הגוף כענבול בתוך הפעמון וק"ל מהרש"ל:	NULL
Yeriot Shlomo on Torah, Miketz 5	@11בד"ה שבע בנות כו' אתה קובר @22נ"ב מה שפרש"י פותרין היו אותו אבל לא לפרעה כו' יפה פירש דבודאי חרטומי מצרים פתרו לפי מושכל ראשון מאד בדמיון אבל לא לפרעה שלא היה קולן נכנס באזניו ולמה לפי שלא היה לו קורת רוח בפתרונם כלומר מה תועלת לו בהגלות לו זה הענין מה שיהיה מקוד' ויוסף ברוב שכלו הרגיש דבודאי שלא הודיעוהו לפרעה מן השמים אלא דבר גדול שתלוי בו כל קיום המלכות והמדינה וכאשר פתר כן היה שאלמלא לא אספו וקבצו בר בתוך שני השובע אבדה כל הארץ מהרש"ל:	NULL
Yeriot Shlomo on Torah, Miketz 6	@11בד"ה אין נצן לקיין כו' @22נ"ב ולי נראה דמ"ה הביא התרגו' לסייע שאין בו שום צד לחלוחית והיינו כעצים ארוכים יבישים כסלעי' והיינו שנתרוקנו לגמרי כמו שפי' התרגום הענין ולא המלות ולפי זה הרגיש יוסף כאשר פי' תנחומ' שפרעה בא לנסותו והרגיש בדבר שלא ראה צנומות שהרי בפתרון לא הזכיר יוסף צנומות ומהיכן ידע שלא ראה פרעה בחלום הא לא נביא היה אלא שהרגי' שאם היו צנומות בלי לחלוח כלל א"כ לא יהיה קיום לשנת הרעב מחמת רוב חזקו כפי הענין פתרון של צנומות והוא ידע שלא הראה לו החלום אלא לקיום המלכות והמדינה ודוק מהרש"ל:	NULL
Yeriot Shlomo on Torah, Miketz 7	@11בד"ה נכון ומזומן @22נ"ב אחר שפירש"י נכון מזומן פירש"י בשב' שני הרעב נאמר הראה כו' כלומר שלא תאמר דלמא מ"ה לא הגיד לפי שהשובע בודאי והרעב הראה אולי יחזרו בתשובה וינחם על הרעה כמו שמצינו גבי ננוה ומ"ה אמר יוסף נכון מזומן הדבר כלומר נגמר ונחתם וכאלו כבר בא וא"כ צריך לפרש למה כתיב הראה וק"ל ואולי גם מיושב מה שמקשין העולם למה התחיל יוסף בתקלה ואמר יהיו שבע שני הרעב וגם שלא כסדר שהרי השובע היה מקודם אף שהרמב"ן ג"כ פי' יפה מ"מ נ"ל שדעת יוסף היה לפתור אותו כך שיהיה הרעב בודאי ולא יועיל שום דבר לבטלו כמו גבי ננוה ומ"ה פתר כך ובקש שיהיה רעב וע"י זה יהיה פליטה לו ולכל בני אביו שיתקבצו כולם אליו ודוק מהרש"ל:	NULL
Yeriot Shlomo on Torah, Miketz 8	@11בד"ה אין נכון כו' פי' זאת @22נ"ב ולי נרא' דמ"ה פירש"י כן שאם תפרש שלא היה בנמצא כמוהו זה אינו שהרי עיקר מעלתו איש אשר רוח אלהים בקרבו וכי לא היה כבר אברהם שנתפרסם שמו בכל העולם כולו והיה נביא אלא כנגד עבדיו וחרטומי מצרים אמר אם נלך ונבקש הנמצא כמוהו שהרי יש בו רוח אלהים מש"כ בכל הנמצאי' לעת עתה שהרי החרטומין וכל חכמים אין דומין לו לפי שרוח אלהים בקרבו ועוד נראה דאף מקרא דייק שאם לא היה בא לפרעה אלא כדי לספר מעלותיו שלא היה בנמצא כמוהו הוה ל"ל הנמצא איש אשר בו רוח אלהים כזה ושב כזה על סוף המבוקש אבל עכשיו דיבר פרעה נגד עבדיו אם נלך ונבקש הנמצא כמוהו ולמה לא נמצא איש בגוף וידים ורגלים כמוהו על כן מתאר הענין כאלו אמר והשיב נגד שואליו לא תמצאוהו כן לפי שרוח אלהים בקרבו ודוק מהרש"ל:	NULL
Yeriot Shlomo on Torah, Miketz 9	@11בד"ה לקמצים כו' נ"ל כו' @22נ"ב ול"נ לפרש כפשוטו כל מעט ומעט שבא לידם היו מקמצין ומאספין וקימוץ הוא מלשון קומץ ממש ולא שהיו אוצרין רוב המותר שלא לצורך אלא אף היו מצמצמין ומקמצין יד על יד וכל הראשון שבא לידם וכך היו עושין כל שבע שנים ופירש של הרא"ם נ"ל דוחק מהרש"ל:	NULL
Yeriot Shlomo on Torah, Miketz 10	@11בד"ה מכאן שהאדם כו' בסופו @22נ"ב והב"י בהלכות תענית תמה עליו דא"כ יוסף ג"כ ה"ל להיות שרי דהא ג"כ לא קיים עדיין מצות פריה ורביה דהא לא היה לו בת מדלא השיאה בירידת' למצרי' ונראה דאפש' שהיתה לו בת ומתה קודם ירידתן למצרים כמו שצריכין לומר לאותו מ"ד שס"ל דתאומות נשאו כנ"ל והתוס' במסכת תענית כתבו דיוסף מדת חסידות היתה בו ומחמיר ע"ע היה:	Mizrachi, Genesis 41:3:2
Yeriot Shlomo on Torah, Miketz 11	@11בד"ה אשר יאמר כו' @22נ"ב וז"ל השמעוני וב"ר אפי' יאמר לכם חתכו לכם מן בשרכם והשליכו לנעמית עשו והיינו דכתיב וכל אשר יאמר לכם תעשו פי' מלכם דייק דהיינו מעצמיכם וממילא אתא למילה וזו המחוור בעיני מכל הפי' מהרש"ל:	Mizrachi, Genesis 41:55:2
Yeriot Shlomo on Torah, Miketz 12	@11סוף ד"ה ודומה לו כו' @22נ"ב והמדקדק בגמרא בדף י"א משמע מלשון רש"י ותו' כפשוטו שלפי' הראשון הוא ראי' ממש ולא מל' שביעה וכן אית' בשמעוני וז"ל למה תתראו אל תצאו ובידכם פרוסה מפני התרעומו' ואל תכנסו כולכם בשע' אחד מפני העין ע"כ משמע להדיא דלשון ראייה הוא לפי' הראשון כלומר אל תראי עצמיכם כפשוטו ע"כ נראה דללשון כחישה הוא מביא הפסוק ומרוה גם הוא יורה והוא לשון כחישה ובלשון אשכנז טנט זע"ט כמו ודשנו וכן הרבה וק"ל מהרש"ל:	NULL
Yeriot Shlomo on Torah, Miketz 13	@11בד"ה ולא אמר כו' @22והג"א כתב דלכך הל'ל לכו משום דהיה לו לתפוס בדבריו לשון צח והגון ולא לשון ירידה ומה שכתיב וירדו אחי יוסף ל"ק משום דלישנא דקרא הוא ולא ידעתי מה יעשה בפסוק רדה אלי אל תעמוד וגו' וכן והורדתם את אבי וגו' לכן נ"ל כמו שמצאתי ביש נסחאות שלא היה כתוב בהן ולא אמר לכו רק רדו שמה רמז כו' והיינו ממלת שמה מפיק ליה שמיותר הוא דבתר הכי כתיב ושברו לנו משם א"נ דלא הל"ל כלל רדו שמה דהא כתיב בתר הכי ושברו לנו משם אלא עכ"ל רמז כו' וכן משמע במדרש רבות ע"ש:	Mizrachi, Genesis 42:2:1
Yeriot Shlomo on Torah, Miketz 14	@11בד"ה הוא אשר כו' @22נ"ב ואני שמעתי חיבור הענין כך אמרו בני יעקב אין אנו מרגלים שהרי כולנו בני איש אחד אנחנו וכי מן האפשרות שהאחד ישלח כל בניו למקום הסכנה כזו להיות מרגלים והוא השיב אדרבה הוא הדבר אשר דברתי שאם לא הייתם אחים היה מן הסברא להאמין לכם שאין אתם מרגלים שאין רגילות שעשרה בני אדם יאמינו זה לזה שלא יגלה א' על חבירו אבל מאחר שאתם אחים א"כ אין תימא ודוק מהרש"ל:	Mizrachi, Genesis 42:14:1
Yeriot Shlomo on Torah, Miketz 15	@11בד"ה ויבך כו' מפני ששמע @22נ"ב ולי נראה לפרש דאי לא שמע שמתחרטין אין כאן בכיה אלא רוגז וכעם היה לו להלביש עליהן ולזכור מה שעשו וההיפוך של הבכיה שבאה מרכות הלב וק"ל מהרש"ל:	Mizrachi, Genesis 42:24:2
Yeriot Shlomo on Torah, Miketz 16	@11בד"ה לעיניהן כו' יחידי משמעון כו' @22נ"ב ונראה לי ליישב מה שאמרו חז"ל בתענית אולת אדם תסלף דרכו ועל ה' יזעף לבו על בני יעקב שאמרו מה זאת עשה אלהים לנו אף שכבר הצדיקו עליהם הדין באמרם אבל אשמים אנחנו אלא שהיו מרננין על מה שהוסיף ה' עליהם הוה אחר הוה ללקות בכפלים והיה להם להשיג מאחר ששמעון ולוי יותר חטאו במכירתם והם היו העיקר משום הכי באו להם סיבות זרות יותר מלאחרים שהאחד נתפס והשני מצא את הכסף ודוק ולפי פיר' האבן עזר' שפי' האחד הוא ראובן א"כ היה מתקונן על מדותיו של מקום ואמר מה זאת עשה אלהים לנו הלא אני אמרתי אל תחטאו בילד ואלי בא הסיבה יותר מכולם והיינו אולת אדם תסלף דרכו שהיה לו להזכיר מעשה בלהה וק"ל מהרש"ל:	Mizrachi, Genesis 42:24:4
Yeriot Shlomo on Torah, Miketz 17	@11סוף ד"ה שמא הרגוהו כו' @22נ"ב ולי נראה דלק"מ דבודאי מתחילה לא חשדם עד שראה ששמעון איננו אתם א"כ סבר בודאי מכרוהו וסופו יוכיח על תחילתו כשנודע לו אמיתת דבריהם של שמעון חזר אף מן החשד של יוסף וק"ל מהרש"ל:	NULL
Yeriot Shlomo on Torah, Miketz 18	@11בד"ה שדי כו' היכולת בידו @22נ"ב וכך נראה לי ההוצעה שאמר יעקב לבניו הלא עשיתי כל מה שראוי לעשות בדרך הטבע וההנהגה הישר' לפייס אדון כמוהו ואם כל זה לא יועיל א"כ השגחה פרטית וסיבת אלהים הוא ולא בדרך הבחירה א"כ אינו חסר אלא תפילה והריני מתפלל למי שהיכולת בידו ליתן רחמים אפי' לאיש כמוהו שיש לו שנאה בתכלית עליכם וחקוקה כבר בלבו וישוב ממנה מהרש"ל:	Mizrachi, Genesis 43:14:1
Yeriot Shlomo on Torah, Miketz 19	@11בד"ה עלילת הכסף הוצרך כו' @22נ"ב מה שפירש"י ולהתגולל שתרגם ולאתרברב' כו' כלומ' להתפלל לא פי' כלל אחר דקדוק לשון המקרא אבל להתגולל פירש התרגום שפיר אחר המקרא אף שלא פירש כמותו כי רש"י פירש מלשון גלגול ק"ל וגם בעבור שפירש התרגם על להתגולל ולאתרברבא ג"כ תואר ולהתנפל ולהסתקפה אע"פ שאינו מכוון אחר הלשון אבל לפירש"י שפירש מלשון גלגול א"כ ולהתנפל הוא כפשוטו פירש ע"י גילגול באה הנפילה ודוק מהרש"ל:	Mizrachi, Genesis 43:18:3
Yeriot Shlomo on Torah, Miketz 20	@11בד"ה ויבא יוסף כו' @22נר' מדרשם בפירושו תחילת הקרא ויבא יוסף הביתה רצונו לומר דרש"י פירש כן אהבית' קמא דקרא וא"כ תימה מה זה שסיים בדבריו כי כבר הובאו בית יוסף מה בכך דלמא הם היו בבי' יוסף אבל יוסף לא היה בביתו והל"ל כי כבר היה יוסף בביתו והג"א נר"ו הבין ג"כ דכוונת רש"י אהבית' קמא דפירש מפרוזדור לטרקלין דאל"כ אלא בית ממש היכן היה יוסף שאמר ויבא יוסף הביתה ע"כ ותימה על דבריו דלמא אה"נ לא היה כבר בביתו אלא בשדה או בביתו של פרעה לכן נ"ל דרש"י דייק הביתה בתרא ויביאו לו את המנחה אשר בידם הביתה דק"ל הלא כבר הובאו בית של יוסף כדכתיב ויבא האיש את האנשי' ביתה יוסף אלא עכ"ל מפרוזדור לטרקלין ואפשר דכוונת הרא"ם ז"ל ג"כ כמו שפרשתי כמו שמשמ' מסוף דבריו ומ"ש בתחילת דבריו ויבא יוסף ט"ם הוא ודוק כנ"ל וכן שמעתי ממהר"א היילפרון ז"ל:	Mizrachi, Genesis 43:26:1
Yeriot Shlomo on Torah, Miketz 21	@11מה שפירש רש"י מדברי רז"ל מטרפולן היתה כו' @22יש לתמוה מנ"ל ופירש בעל מתנ"כ בפירושו לרבות דדייקי מדנקט ל' עיר ולא לשון כרך ולא נהירא דא"כ הא דכתיב לעיל בפר' זו הם יצאו את העיר וגו' וכן בפר' וארא כתיב כצאתי את העיר מא"ל ועוד דכרך לשון התרגום הוא ולא לשון המקרא ולכאור' נראה דדיקי לישנ' דהעירה דהל"ל העיר וכן דייק לישנ' דרש"י ולכן נמי קאמר עיר בינונית של י' בנ"א דזה מרומז בב' ההי"ן של העירה אך ק' מה יעשו בהעירה דגבי יריחו וכן בשאר מקומות ושמא כל היכא דאיכא למדריש דרשינן כנ"ל:	NULL
Yeriot Shlomo on Torah, Miketz 22	@11בד"ה ותרגומו כו' קושט' @22נ"ב ופירש הוא מלשון גנאי אלא שכינה התרגום לפי הענין ר"ל בלשון כבוד כלפי מעלה קושט' אינון דיר כו' בתמיה והכא סבור התרגום דא"א לפרש מלשון גנאי כי מה להם תשובה בזה הלא הוא חושב אותו באותו גנאי ודוק מהרש"ל:	Mizrachi, Genesis 44:7:1
Yeriot Shlomo on Torah, Vayigash 1	@11בד"ה ואל יחר כו' אליו קשות @22נ"ב ולי נר' לפרש שאין הפי' שדיבר אליו דברים זרים שלא נאמרו בפרשה שזהו דוקא לפי הדרש ולא מהמובן בפשט הכתוב אלא ה"פ שדיבר עמו בחוזק כאיש שמדבר עם רעהו ומוכיחו על פניו ולא ברכות ובכי וע"ז אמר ואל יחר כו' כלומר מאחר שאתה חשוב כמלך לא היה לו לדבר עמך בחוזק ודוק מהרש"ל:	Mizrachi, Genesis 44:18:2
Yeriot Shlomo on Torah, Vayigash 2	@11בד"ה סופך ללקות כו' @22נ"ב ולפ"ז קשה דהול'ל ותהיה כפרעה שהוא עתיד ולא כמוך שהוא הוה ע"כ פי' ד"א כו' ואף זה לא יתכן דא"כ הל"ל אתה כפרעה מהן כמוך אלא סופך ללקות עליו בצרעת שיאמרו כמוך כפרעה ודוק ומ"מ קשה דהל'ל כפרעה כמוך אלא לרמז נמי שאם תקניטני אהרוג אותך ואף פרעה ומ"מ פשט הפסוק אינו מיושב כלל לפ"ז דא"כ מאי אל יחר דאין דרך לומר אל יחר אדוני כי אהרוג אותך אלא העיקר פירושים הראשונים צרעת ומבטיח ואינו עושה כו' ודוק מהרש"ל:	Mizrachi, Genesis 44:18:4
Yeriot Shlomo on Torah, Vayigash 3	@11בד"ה מבטיח כו' @22נ"ב וי"מ א"כ ריבך ריב וסוד אחר אל תגלה מה לו להזכיר פרעה ולביישו בכדי מאחר שאין מביא ראייה ממנו ובפרט מאחר שמצינו שחלקו הנביאים כבוד למלכות כגון משה לפרעה ואליה לאחאב ונ"ל דרמז לו מאחר שפרעה גוזר ואינו מקיים ק"ו שמבטיח ואינו עושה א"כ אל תשען במשענת קנה רצוץ הבטחות פרעה כלומר ראוי לך לירא מאלהים ולהבטיח עליו ולעשות הישר בעיניו ודוק מהרש"ל:	Mizrachi, Genesis 44:18:6
Yeriot Shlomo on Torah, Vayigash 4	@11בד"ה בתך היינו כו' @22נ"ב רבו בזה המפרשים והכל הבל דבודאי מיסתבר לומר בת מאחות וא"כ גבי בתך היינו מבקשים מוכרח לפרש וכי אחד מאתנו היה מבקש בתך וא"כ טוב לומר בתך מאחותך שזהו רחוק אבל אחותינו אתה מבקש טוב לפרש כן שהוא אחות כל האחין כאחת וכי בעבור זה חקרת ודרשת אחרינו מה אנו ומשפחתנו כדי שתקח אחותינו של כלנו ודוק מהרש"ל:	Mizrachi, Genesis 44:19:2
Yeriot Shlomo on Torah, Vayigash 5	@11בד"ה ואחיו כו' תמוה מאד @22נ"ב ואני אומר דלק"מ כי מפני היראה היה אומר דבר שאינו ברור לו כשמש אבל יראה שלא יתפשוהו אותו ויאמרו לו והלא לא אמרת מת אין בזו תפישה שיאמר בתחילה הייתי סובר שהוא חי ועכשיו אני רואה לפי קושי מזל שלנו שהוא מת מאתנו שהרי כך אירע לנו בודאי עמנו ק"ו בספק נאבד מאתנו ודוק מהרש"ל:	Mizrachi, Genesis 44:19:4
Yeriot Shlomo on Torah, Vayigash 6	@11בד"ה וקרהו אסון כו' בזה הסיפור כו' @22נ"ב ולי נראה דדייק מדכתיב ברעה ולעיל כתי' אבל שאולה אלא כלומ' שאני שרוי בלא אשה החביב' והשרוי בלא אשה שרוי בלא טובה והפך הטובה היא רעה הרי כאלו מתו כולם ביום אחד ודוק מהרש"ל:	Mizrachi, Genesis 44:29:1
Yeriot Shlomo on Torah, Vayigash 7	@11מה שפירש"י לגבורה ולמלחמה ולשימוש ה"פ לגבור' כלומר ידוע שאני גיבור יותר מהוא שהוא תועלת המלחמה והשימוש וק"ל @22ויש מקשין הלא השיב לו יוסף חלילה כו' האיש אשר נמצא הגביע בידו כו' וגם מתחילה אמר יהוד' בעצמו אשר נמצא הגביע בידו יומת כו' ולבסוף כשנמצא אמר בעצמו שכלנו נהיה עבדים וא"כ מה יעשה בהבטחת אביו אלא כך נ"ל ההוצעה אמר יהודה אלו היית ממית אותו כדין גנב ואנחנו עבדים החרשתי כי מה לנו לעשות נגד הדין כי האלהים מצא עון עבדו ואם הפסדתי שני עולמות מה לי לעשות מאחר שערבתי א"כ מוכרח אני לייאש על הספק כדרך הערבים אבל עכשיו שויתרת לו המיתה ואמרתי שנהיה כולנו עבדים והשבת חלילה א"כ מרגיש אני שהכל עלילה שהרי מצד החסד באת עלינו לפי דבריך שאין אתה מימית אותו וגם אתה מוחל לנו עבדות א"כ כ"ש מן הראוי שתקח עבד אחר במקומו שמעולה ממנו לכל דבר בפרט שאין אדם רוצה בעבד גנב אם לא ע"י הדחק וא"כ למה הוא לך אלא שהכל עלילה ודוק מהרש"ל:	NULL
Yeriot Shlomo on Torah, Vayigash 8	@11בד"ה וישמע כו' @22נ"ב ולי נראה שאין שייך להוסיף דא"כ ה"ל לינקוד וישמע בקמ"ץ השי"ן וק"ל מהרש"ל:	Mizrachi, Genesis 45:2:1
Yeriot Shlomo on Torah, Vayigash 9	@11בד"ה גשו כו' דקא דייקי לה כו' @22נ"ב ולי נראה להוסיף דבודאי עיקר ההתקרבות הוא מחמת המילה ולא מחמת פיוס שהרי אם ידבר ברכה ובתחנונים ממילא יתקרבו וגם לשון הגשה הוא לשון קירוב ממש והיה מתיירא שמא יתבהלו ע"כ אמר נא כלומ' שהגשה הזאת תהיה בלשון רכה א"נ מדקאמר גשו כו' משמע שהיה מקרבן כו' ומדקא' אלי משמ' בקרוב ממש ומחמת המילה כלומ' גשו נא לדבר שאלי וק"ל מהרש"ל:	Mizrachi, Genesis 45:4:1
Yeriot Shlomo on Torah, Vayigash 10	@11בד"ה לאב כו' הנקרא פטרון @22נ"ב ולי נראה מתוך שהיה נקרא חבר לפרעה בגדולה וגם מנהיג ביתו מ"ה הוא לאב אבל פטרון לחוד שהו' מנהיג ביתו אין בזה שיהיה לאב פרע' כמו גבי מנהיגי' וגזברים שאין עליהם אלא שימוש שירות שלו ולא אב אלא בע"כ מאחר שהוא חבר שלו במעל' עליהם שהוא מנהיג הרי הוא כמו אב לפרעה ודוק מהרש"ל:	Mizrachi, Genesis 45:8:1
Yeriot Shlomo on Torah, Vayigash 11	@11בד"ה והנה כו' יוסף לא מת כו' @22נ"ב ואני אומר שדעת רש"י כך עיניכם הרואו' בכבודי כבר שקשה לכם להשיג שאני יוסף אותן העיני' כבר ראו שאני מהול וא"כ מה תאמרו עדיין הדבר שקול שהרי המילה אינה ראייה מוחלט' דשמא מבני קטורה הוא כמו שכתב רא"ם ע"כ אמר כי פי המדבר אליכם כו' כלומר זה יכריע כך נראה בעיני עיקר מהרש"ל:	Mizrachi, Genesis 45:12:1
Yeriot Shlomo on Torah, Vayigash 12	@11מה שפרש"י מה בנימין אין לי שנאה עליו כו' @22קשה איך בא זה בענין המקרא שבא להוכיח להם בראייה שהוא אחיהם ויאמינו לו ואיך נופל לומר אין לו שנאה ונ"ל דה"ק להם ההתודעות שאני מתודע לכם אל תאמר שהו' כדי שתאמינו לי ותבואו אלי כדי שאוכל לנקום נקמתי מכם על זה אמ' ועיני אחי בנימין כו' שהרי אני מתודע ג"כ לו ואותו ההתודעו' אינו אלא שהוא יקבלני לאח ולא שיהא הוא תחת ידי ג"כ כך הוא ההתודעות שאני מתודע לכם הוא שתקבלו אותי לאח ולא שיש לי שנאה עליכם ודוק מהרש"ל:	NULL
Yeriot Shlomo on Torah, Vayigash 13	@11בד"ה על צוארי כו' שינויא דקרא כו' @22נ"ב בב"ר לא נאמר כן אלא לשון של רש"י היא לפי הנוסח של הרא"ם ז"ל אבל ברש"י שלנו לא נאמר צוארו כתיב וכן בכל ס"ת שלנו כתיב צואריו ומ"מ נראה דרש"י דייק מדכתיב בכה על צוארו שהוא כפשוטו לשון צואר בלי יתור ולמה בכה על צוארו ולמה כתב אלא להודיע שבכה על המשכן שהוא בגובה כמו צואר ומאחר שאין לנו יתור א"כ אין כאן אלא משכן אחד בע"כ בצוארי שמיותר לשני משכנות ותדע שלשון צואר מורה על המשכן שהרי גבי אחיו כתוב ויבך עליהם ודוק מהרש"ל:	Mizrachi, Genesis 45:14:1
Yeriot Shlomo on Torah, Vayigash 14	@11בד"ה אל תרגזו כו' תרגז עליכם @22נ"ב פירש"י שאם תתעסקו שמא תטעו מהרש"ל:	Mizrachi, Genesis 45:24:1
Yeriot Shlomo on Torah, Vayigash 15	@11בא"ד אל תפסיעו פסיעה גסה כו' @22נ"ב ולי נראה דהכל אחד דהא ודאי לא ציוה שלא יתעסקו בדברי תורה כלל אלא לא תתעסקו בדבר הלכה שהוא דבר עיוני כדמוקים בגמרא וה"ט משום שאמרו רז"ל כל הפוסק ממשנתו ואמר מה נאה אילן זה כו' והיינו דבר עיוני שלא יפסיק ויבלבל כל מה שעיין וא"כ ירגז עליה' הדרך כלו' שיתגבר הליכתם מחמת שבודאי תתעו אבל המדרש קאמר אל תפסיקו מדברי הלכה כלומר מגירסה מבוררת שיכול אדם להפסיק בה לצורכו ולחזור לפרקו ולא תתעו בדרך בודאי אל תפסקו ממנה כדאיתא בגמר' שנים שמהלכי' בדרך ואין בפיהם ד"ת ראוין לישרוף ומוקי לה למיגרם אלמא דבעי למיגרס ואולי הזהיר אותן יוסף על העיון שלא יעיינו בסוד פרשת עגלה ערופה ששלח אל אביו וק"ל ומה שפרש"י ד"א אל תפסיעו כו' תחילת דבריו הוא דברי רבי אליעזר ואחר כך מסיק תלמודא במתני' תנא אל תפסיעו כו' והכנסו בחמ' לעיר ונ"ל שסובר האי תנא שהזהיר אותן יוסף על רוב התגברות ההליכה יותר מדאי כגון להלוך עד הלילה מהרש"ל:	Mizrachi, Genesis 45:24:1
Yeriot Shlomo on Torah, Vayigash 16	@11מה שפרש"י כזאת כחשבון הזה @22משום דמצינו בלשון כ' שפירושו כחשבון הזה וקראוהו חכמי הלשון כ' השיעור כמו כשש מאות איש כבחצי כמחנה כחצות הלילה כאלפי' אמה אף כאן כזאת כחשבון הזה ספר דקדוקי רש"י והא דכתיב כזאת ולא כזה פי' הרמב"ן משום דמנחה לשון נקבה היא:	NULL
Yeriot Shlomo on Torah, Vayigash 17	@11בד"ה וירא כו' @22נ"ב ולשון וירא כלומר הבין ונראה בעיני כמו וירא את האור ואני קבלתי שכתב מקצת סימני' ממה שלמד על העגלות מהרש"ל:	Mizrachi, Genesis 45:27:1
Yeriot Shlomo on Torah, Vayigash 18	@11בד"ה בן הכנעני' כו' דהכא תגרי' כו' @22נ"ב ולי נראה דלא שייך כאן לפרש תגר' דא"כ מה בא הכתוב להשמיענו כאן יותר מבכל שאר השבטים ואיך תלה בתולדות הבנים אם לא שבא להשמיענו חידוש וכו' מהרש"ל ז"ל:	Mizrachi, Genesis 46:10:1
Yeriot Shlomo on Torah, Vayigash 19	@11בד"ה צריכין אנו כו' דכיון דכתיב כו' @22נ"ב ונראה לי דאי לאו שמתו א"כ היה לו למנות' בשמות' כמו שמנה דינה אלא וודאי שמתו ומלבד נשי בני יעקב על נשים אחרים קאמר שלקחו אחרי כן והא דקאמר מלבד כו' אע"פ שאינם מיוצאי יריכו לק"מ כי לא בא להודיע הפרט מי הם ומי אינם הם אלא שבא להודיע שבא בשבעים נפש יוצאי ירך יעקב במצרים זולתי הנשים שעמהן ודוק מהרש"ל:	Mizrachi, Genesis 46:26:1
Yeriot Shlomo on Torah, Vayigash 20	@11בד"ה בעבור כו' תועבות מצרים @22נ"ב ואני אומר שלעולם תועבת מצרים הוא ל' כינוי וגנאי לע"ז וכאלו אמר אלהי מצרים ומ"ה נתן להם פרעה מרעה טוב כי הוא היה אוהב רועי צאן וכן מוכח בפר' בא ע"ש מהרש"ל:	Mizrachi, Genesis 46:34:1
Yeriot Shlomo on Torah, Vayigash 21	@11בד"ה בשנה השנית כו' שפירושו עד כו' @22נ"ב ואני אומר הוכרח לאשר וזולתו לא יהיה נופל מלת כי אם תם למלת אדוני שלא יהיה מחובר מלת כי אם תם הכסף למלת אל אדוני וזה אינו נכון אבל במקום אשר נופל הלשון כך כאשר תם הכסף מה היה אל אדוני כלומר כבר בא אל אדוני ודוק מהרש"ל:	Mizrachi, Genesis 47:18:1
Yeriot Shlomo on Torah, Vayigash 22	@11בד"ה בלתי אם כו' תפרשנו כו' @22נ"ב מה צריך לאריכת דברים אלא מהו אם גויתנו כי אין נופל כאן אם בלשון תנאי ולא בלשון אשר אלא בלשון אם לא מהרש"ל:	Mizrachi, Genesis 47:18:3
Yeriot Shlomo on Torah, Vayechi 1	@11בד"ה מצרת השיעבוד כו' @22נ"ב ומ"ה הוכרח לב' פירושי' דאי משום צרת השיעבוד לחוד היה לו לעשות סתימה בפרשת שמות ואי משום הקץ לחוד היה לו לעשות סתימה גבי ויקרא יעקב לבניו ודוק מהרש"ל:	Mizrachi, Genesis 47:28:3
Yeriot Shlomo on Torah, Vayechi 2	@11בד"ה סופו כו' מהכא משמע כו' @22נ"ב ואני אומר שכל הג' טעמים מוכיחין מן המקרא אל תקברני במצרים משום כינים ונשאתני ממצרים משום ע"ז וקברתני בקברתם משום גילגול מחילות וכן הסדר בב"ר ומה ששינה רש"י ודרש טעם של גילגול קודם טעם עשיית ע"ז שהוא קודם לו משום שרש"י מפרש ענייני הקבורה אל תקברני ממצרים משום כינים וא"כ למה דוקא בקבורת אבותי ולא בשאר מקומות ע"כ הוכרח לפרש מיד משום גילגול ואח"כ מפרש היתור ונשאתני ממצרים ודוק מהרש"ל:	NULL
Yeriot Shlomo on Torah, Vayechi 3	@11מה שפירש"י כמו וישכב דוד עם אבותיו @22פי' דא"א לפרש התם על הקבורה שנקבר עם אבותיו בבית לחם או עם אברהם יצחק יעקב בחברון שהרי כתי' אח"כ ויקבר בעיר דוד שהיה ציון וק"ל 	NULL
Yeriot Shlomo on Torah, Vayechi 4	@11בד"ה הפך כו' וא"ת ומי הכריחם @22נ"ב כנ"ל: ולי נראה דאל"כ הל"ל לעל ראש המטה אלא השתחואה ליוסף ובאיזה מקום על ראש המטה מהרש"ל:	Mizrachi, Genesis 47:31:2
Yeriot Shlomo on Torah, Vayechi 5	@11בד"ה בשרני כו' ולכן לא @22נ"ב ואני אומר לשם פירושו קהל גוים מנשה ואפרים והיינו מאחר שכתב בתחילה גוי שהוא בנימין וממילא קהל גוים הוא שני אומות וגם מאחר שכתב בתחילה גוי דרך ארץ הוא לכתוב על ריבוי גוים קהל גוים אבל הכא שלא הזכיר בתחילה עם אין כאן הוכחה שקהל עמים הוא שנים אם לא שתפרש קהל חד ועמים חד ודוק מהרש"ל:	Mizrachi, Genesis 48:4:1
Yeriot Shlomo on Torah, Vayechi 6	@11בד"ה ואעפ"י כו' זה לכאן @22נ"ב יש מקשין איך בא זה הענין לכאן הי' לו לומר מיד אחר שנשבע לו ונ"ל כך אמר יעקב ליוסף אל יעלה בלבך מה שאני מברך אותך ועושה אותך בב' שבטים אין בידי אלא שהקדוש ברוך הוא ברכני ובשרני שעתיד אחד מבני להתחלק לב' שבטים והיינו איזה שימצא חן בעיני המקום ויתרבה באוכלסין ואני מברך אותך דרך פיוס להפיס דעתך בין יהיה בין לא יהיה רק שתסיר מן הלב מה שיש לך עלי לכן אמ' כבר ידעתי זה אבל באתי להוציא אותן הדברים מלבך באות ובמופת כדי שתדע ותבין שהברכה אינו דרך פיום אלא אמת הוא ובידי לברך ועושה אני מרוב אהבה ודוק מהרש"ל:	NULL
Yeriot Shlomo on Torah, Vayechi 7	@11בד"ה כי יודע כו' ואע"פ כו' @22נ"ב ואני קבלתי כי מנשה הבכור כלומר בעבור שהיה הבכור היה משכל ידיו ולולי כן היה מהפכן להדיא ודוק מהרש"ל:	Mizrachi, Genesis 48:14:1
Yeriot Shlomo on Torah, Vayechi 8	@11בד"ה ראשית אוני כו' @22ואע"פ שאין כו' @22נ"ב ומחמי קבלתי משום שהיו לה עיני' רכות וסומא אין לה טענת בתולים מהרש"ל:	Mizrachi, Genesis 49:3:1
Yeriot Shlomo on Torah, Vayechi 9	@11בד"ה אבל כו' כלומר ולכן @22נ"ב ולפי פירושו קשה שהיה לו לומר שהרי בד"ה מצינו מהו אבל דקא' ועוד לעיל היה לו לפרש גבי שבטו של שמעון וקבלתי מאמ"ז לפי שגבי שמעון נאמר בסודם אל תבא נפשי שהוא לשון נסתר לנפש הנקבה כמו נוכח לזכר וגבי כבוד שהוא לשון זכר צריך אתה לפרש בלשון נוכח ולא נסתר דאל"כ הל"ל אל יחד אלא כמדבר עם הכבוד ומ"ש אלא מ"ה דיבר אל הכבוד להזהיר שלא יחלל כבודו אבל במקום שאינו חילול לכבוד אלא לייחס יחדו לשם ודוק מהרש"ל:	Mizrachi, Genesis 49:6:2
Yeriot Shlomo on Torah, Vayechi 10	@11בד"ה בני עלית כו' @22נ"ב מה שפרש"י בני על יהודה ולא על יוסף הוא נשמע מן הנגינה ובעל הנגינה אפשר כיון לזה כדי שיהיה קאי מטרף על יוסף ותמר ודוק מהרש"ל:	Mizrachi, Genesis 49:9:1
Yeriot Shlomo on Torah, Vayechi 11	@11נ"ב וימררהו ורבו וגו' @22פרש"י האחים וגם פוטיפרע מוכרח רש"י לפרש שניהם דאי פוטיפרע ואשתו לחוד א"כ מהו וישטמהו בעלי חצים דבע"כ אאחי יוסף קאי ואאחי יוסף לחוד נמי לא קאי דא"כ הל'ל מקודם וישטמהו בעלי חצי' ואח"כ וימררהו ורבו כסדר הענין ודוק מהרש"ל:	NULL
Yeriot Shlomo on Torah, Vayechi 12	@11בד"ה תהיינה כו' בסופו @22נ"ב פי' שגברו על ברכת הוריו ולא הראשונים לבד לראש יוסף אלא בשוה עם שאר אחיו ודוק מהרש"ל:	Mizrachi, Genesis 49:26:3
Yeriot Shlomo on Torah, Vayechi 13	@11בד"ה זאב כו' אין מילת כו' @22נ"ב ולי נראה דק"ל דה"ל למכתב זאב טורף כו' והעיקר שבא לפרש דל"ת הוא יטרף הזאב וק"ל מהרש"ל:	Mizrachi, Genesis 49:27:1
Yeriot Shlomo on Torah, Vayechi 14	@11בד"ה אבל ירא כו' @22נ"ב והקשה חמי וכי בעבו' שהוא יעבור על השבוע' הותר לו לעבור ג"כ על שבועתו אלא י"ל דה"ק לו אם אני אגלה שאין אתה יודע שבעים לשון ואני יודע א"כ בהכרח ימליכו אותי וא"כ אקיים שבועת אבא ודוק מהרש"ל:	Mizrachi, Genesis 50:6:1
Yeriot Shlomo on Torah, Vayechi 15	@11בד"ה שם מבנות כנען בסופו @22נ"ב ולי נראה דלא דק דמאחר שמפרש תלמודא מאי כנעני תגרא א"כ מה שהזכיר רבי נחמיה לא עדיף מן המקרא וכאלו אמר שהשבטים נשאו כנעניות כמו שנשא יהוד' ולא אחותם ודוק מהרש"ל:	NULL
Yeriot Shlomo on Torah, Vayechi 16	@11ונ"ב @22עוד יש מקשין מה היה דעת יוסף שריחק אחיו מעל שלחנו ונ"ל דדעת יוסף היה שקירבם בתחילה כדי שלא ידמו אחיו שיש לו לב עליהם ומה שלא עשה להם רעה משום שחם על כבוד אביו אבל לאחר מיתת אביו אם יראו שלא אעש' להם רעה בודאי אין לי לב עליה' שהרי אין כאן מי שיעכב על ידי ודוק מהרש"ל ותירוץ זה מספיק במדרש שלא נאמר שם משום כבוד אביו אבל לפירש"י דפי' שהיה מקרבן בתחילה משום כבוד אביו לא יתכן תירוץ זה דא"כ נ"ל כבוד אביו דהא בתחילה עשה שלא ידמו האחים שיש לו לב עליהן לכן נראה דלפרש"י לק"מ משום דמתחיל' עשה משום כבוד אביו משא"כ לבתר מיתת אביו שאין שייך כבוד אביו ואפשר שדעת הרב דמה שנקע רש"י כבוד אביו פי' כך היו סבורין בני יעקב אחיו אבל באמת לא כך היה אלא שלא יסברו שיש לו לב עליה' כדפי' הרב ז"ל כנ"ל:	NULL
