Meilah 2a:1	<sup>i</sup><b>B</b><small>EIM</small> H<small>OCHHEILIGEN</small>$fn1, <small>DAS MAN AN DER</small> S<small>ÜDSEITE</small>$fn2 <small>GESCHLACHTET HAT</small>, <small>GIBT ES EINE</small> V<small>ERUNTREUUNG</small>$fn3. H<small>AT MAN ES AN DER</small> S<small>ÜDSEITE GESCHLACHTET UND DAS</small> B<small>LUT AN DER</small> N<small>ORDSEITE</small>$fn2<small>AUFGENOMMEN, ODER AN DER</small> N<small>ORDSEITE UND DAS</small> B<small>LUT AN DER</small> S<small>ÜDSEITE AUFGENOMMEN, 
Meilah 2a:2	ODER HAT MAN ES AM</small> T<small>AGE GESCHLACHTET UND DAS</small> B<small>LUT NACHTS</small>$fn4 <small>GESPRENGT, ODER NACHTS UND DAS</small> B<small>LUT AM</small> T<small>AGE GESPRENGT, ODER HAT MAN ES AUSSERHALB DER</small> F<small>RIST ODER AUSSERHALB DES</small> O<small>RTES</small>$fn5 <small>GESCHLACHTET, SO GIBT ES DABEI EINE</small> V<small>ERUNTREUUNG</small>$fn6. 
Meilah 2a:3	R. J<small>EHOŠUA͑ SAGTE EINE</small> R<small>EGEL</small>: W<small>AR ES BEREITS DEN</small> P<small>RIESTERN ERLAUBT, SO GIBT ES DABEI</small>$fn7 <small>KEINE</small> V<small>ERUNTREUUNG, WAR ES DEN</small> P<small>RIESTERN NOCH NICHT ERLAUBT, SO GIBT ES DABEI EINE</small> V<small>ERUNTREUUNG</small>. 
Meilah 2a:4	W<small>ELCHES</small>$fn8 <small>WAR DEN</small> P<small>RIESTERN BEREITS ERLAUBT</small>? D<small>AS</small>$fn9 <small>ÜBER</small> N<small>ACHT LIEGEN GEBLIEBEN, UNREIN GEWORDEN ODER HINAUSGEKOMMEN</small>$fn10<small>IST</small>. 
Meilah 2a:5	W<small>ELCHES WAR DEN</small> P<small>RIESTERN NOCH NICHT ERLAUBT</small>? D<small>AS AUSSERHALB DER</small> F<small>RIST ODER AUSSERHALB DES</small> O<small>RTES GESCHLACHTET WORDEN IST, ODER DESSEN</small> B<small>LUT</small> U<small>NTAUGLICHE</small>$fn11<small>AUFGENOMMEN ODER GESPRENGT HABEN</small>.
Meilah 2a:6	GEMARA. Er lehrt, daß es beim Hochheiligen, das man an der Südseite geschlachtet hat, eine Veruntreuung gebe; selbstverständlich, sollte es denn, weil man es an der Südseite geschlachtet hat, nicht mehr der Veruntreuung unterliegen!? – 
Meilah 2a:7	Dies ist [zu lehren] nötig; da U͑la im Namen R. Joḥanans gesagt hat, verendete Opfertiere unterliegen nach der Tora nicht mehr der Veruntreuung, so könnte man glauben, auch Hochheiliges an der Südseite [geschlachtet] gelte als erdrosselt, 
Meilah 2a:8	so lehrt er uns. Opfertiere, die verendet sind, sind überhaupt nicht verwendbar, die Südseite aber ist allerdings für Hochheiliges unzulässig, für Minderheiliges aber ist sie zulässig. – 
Meilah 2a:9	Wozu braucht er all diese Fälle zu lehren? – 
Meilah 2a:10	Dies ist nötig. Würde er nur den Fall gelehrt haben, wenn an der Südseite geschlachtet und an der Nordseite das Blut aufgenommen, so könnte man glauben, nur in diesem Falle gebe es dabei eine Veruntreuung, weil die Blutaufnahme$fn12an der Nordseite erfolgt ist, wenn aber an der Nordseite geschlachtet und an der Südseite das Blut aufgenommen, unterliege es nicht mehr der Veruntreuung, weil die Blutaufnahme an der Südseite erfolgt ist. 
Meilah 2a:11	Und würde er nur dies gelehrt haben, so könnte man glauben, weil der Tag die Zeit der Darbringung ist, wenn man es aber am Tage geschlachtet und das Blut nachts aufgenommen hat, gelte es, da die Nacht keine Zeit der Darbringung ist, als erdrosselt und es gebe dabei keine Veruntreuung, so lehrt er uns. – Wofür ist es, 
Meilah 2a:12	wenn außerhalb der Frist oder 
Meilah 2a:13	außerhalb des Ortes [geschlachtet], verwendbar? – 
Meilah 2a:14	Es macht hinsichtlich der Verwerflichmachung wohlgefällig$fn13. 
Meilah 2b:1	Sie fragten: Sind sie, wenn sie hinaufgekommen$fn14sind, herabzunehmen? – Rabba sagt, wenn sie hinaufgekommen sind, seien sie herabzunehmen, und R. Joseph sagt, wenn sie hinaufgekommen sind, seien sie nicht herabzunehmen. 
Meilah 2b:2	Nach R. Jehuda (ist dies nicht fraglich) streiten sie nicht, sondern stimmen überein, daß, wenn sie hinaufgekommen sind, sie herabzunehmen sind, sie streiten nur nach R. Šimo͑n$fn15. 
Meilah 2b:3	R.Joseph ist entschieden der Ansicht R. Šimo͑ns, aber auch Rabba kann dir erwidern: R. Šimo͑n sagt dies nur von dem Falle, wenn man das unterhaib$fn16zu sprengende [Blut] oberhalb oder das oberhalb zu sprengende unterhalb gesprengt hat, 
Meilah 2b:4	jedoch an der Nordseite [das Opfer] geschlachtet und das Blut aufgenommen hat; hierbei aber, wo man es an der Südseite geschlachtet hat, gilt es als erdrosselt. – 
Meilah 2b:5	Wir haben gelernt: Beim Hochheiligen, das man an der Südseite geschlachtet hat, gibt es eine Veruntreuung. Erklärlich ist dies allerdings nach R. Joseph, gegen Rabba aber ist dies ja ein Einwand!? – Unter Veruntreuung ist eine rabbanitische zu verstehen. – 
Meilah 2b:6	Welchen Unterschied gibt es zwischen einer der Tora und einer rabbanitischen? – Wegen einer der Tora ist das Fünftel$fn17zu zahlen, wegen einer rabbanitischen nicht – 
Meilah 2b:7	Gibt es denn eine rabbanitische Veruntreuung? – Freilich. U͑la sagte im Namen R. Joḥanans, Opfertiere, die verendet sind, unterliegen nach der Tora nicht mehr der Veruntreuung; bei diesen gibt es also keine nach der Tora, wohl aber rabbanitisch, ebenso auch hierbei rabbanitisch. – 
Meilah 2b:8	Demnach lehrt ja bereits unsere Mišna das, was U͑la im Namen R. Joḥanans gesagt hat? – Obgleich dies gelehrt wird, ist auch die Lehre U͑las nötig; man könnte glauben, nur an diesen, weil man solche$fn18nicht meidet, 
Meilah 2b:9	an Opfertieren aber, die verendet sind, die man$fn19meidet, begehe man auch rabbanitisch keine Veruntreuung, so lehrt er uns. – 
Meilah 2b:10	Auch vom verendeten haben wir dies ja bereits gelernt: wer von einem Sündopfer$fn20nießbraucht, begeht, wenn es ein lebendes ist, eine Veruntreuung, erst wenn er [dessen Wert] gemindert$fn21hat, und wenn es ein totes ist, eine Veruntreuung, sobald er einen Nutzen hat!? – 
Meilah 2b:11	Man könnte glauben, 
Meilah 3a:1	dies gelte nur von einem Sündopfer, weil es zur Sühne gebracht wird und man es nicht meidet, Opfertiere aber, die nicht zur Sühne gebracht werden, meidet man, und es gebe bei ihnen keine Veruntreuung, so lehrt er uns. – 
Meilah 3a:2	Gibt es denn bei einem verendeten Sündopfer eine Veruntreuung, wir haben ja gelernt, daß man von den verenden zu lassenden Sündopfern$fn22und vom in das Salzmeer zu werfenden Gelde$fn22nichts genießen darf und es dabei keine Veruntreuung gebe$fn23!? – 
Meilah 3a:3	Ich will dir sagen, verenden zu lassende Sündopfer$fn24meidet man schon lebend, nicht aber solche, die man lebend nicht meidet$fn25. 
Meilah 3a:4	R. Joseph wandte gegen Rabba ein: Eine durch eine andere und die andere durch eine andere$fn26: 
Meilah 3a:5	Sie alle$fn27machen im Schlunde die Kleider$fn28nicht unrein und es gibt bei ihnen eine Veruntreuung, 
Meilah 3a:6	ausgenommen das Vogel-Sündopfer, das man unten$fn29nach Art eines Vogel-Sündopfers auf den Namen eines Sündopfers hergerichtet$fn30hat. 
Meilah 3a:7	Hierzu wird gelehrt: Ist die Untauglichkeit im Heiligtume erfolgt$fn31, so macht es im Schlunde die Kleider nicht unrein, und ist die Untauglichkeit nicht im Heiligtume$fn32erfolgt, so macht es im Schlunde die Kleider unrein. 
Meilah 3a:8	Ferner wird hierzu gelehrt: Dessen Untauglichkeit im Heiligtume erfolgt ist, ist, wenn es [auf den Altar] gekommen ist, nicht herabzunehmen. Dies ist eine Widerlegung Rabbas. Eine Widerlegung.
Meilah 3a:9	Das, worüber Rabba und R. Joseph streiten, war wohl R. Elea͑zar entschieden, denn R. Elea͑zar sagte: Wenn man das Brandopfer eines Privataltars$fn33nach Innen$fn34gehracht hat, 
Meilah 3b:1	so hat die Wand$fn35es aufgenommen in jeder Hinsicht$fn36. 
Meilah 3b:2	Aber folgendes fragte R. Elea͑zar: Ist es, wenn es [auf den Altar] gekommen ist, herabzunehmen? 
Meilah 3b:3	Wenn er dies fragte, so war ihm wohl jenes$fn37entschieden, entweder wie Rabba oder wie R. Joseph. – 
Meilah 3b:4	Er fragte dies bezugnehmend auf jenes: 
Meilah 3b:5	Rabba ist vielleicht nur da der Ansicht, daß es, wenn es hinaufgekommen ist, herabgenommen werde, 
Meilah 3b:6	weil die richtige Wand$fn35es untauglich$fn38macht, und die nicht richtige es nicht untauglich$fn39macht; 
Meilah 3b:7	oder aber: auch nach R.Joseph, welcher sagt, wenn es hinaufgekommen ist, sei es nicht herabzunehmen, gilt dies nur da, wo die richtige Wand es aufgenommen hat, nicht aber hierbei, wo die richtige Wand es nicht aufgenommen$fn40hat!? – Dies bleibt unentschieden.
Meilah 3b:8	R. Gidel sagte im Namen Rabhs: Das Sprengen des Verwerflichen$fn41 bringt nicht aus der Veruntreuungsfähigkeit$fn42, beim Hochheiligen, und bringt nicht zur Veruntreuungsfähigkeil$fn43, beim Minderheiligen. 
Meilah 3b:9	Abajje saß und trug diese Lehre vor; da wandle R. Papa gegen Abajje ein: Wenn jemand das Dankopfer innerhalb der Mauer schlachtet und das Brot dazu sich außerhalb der Mauer befindet, so ist das Brot nicht heilig; 
Meilah 3b:10	hat er es geschlachtet bevor [die Brote] im Ofen eine Kruste bekommen haben. oder wenn sogar alle eine Kruste bekommen haben, mit Ausnahme von einem, so ist das Brot nicht heilig. Hat man es außerhalb der Frist oder außerhalb des Ortes geschlachtet, so ist das Brot heilig. 
Meilah 3b:11	Demnach unterliegt das Verwerfliche der Veruntreuung!? Da schwieg er. 
Meilah 3b:12	Als er zu R. Abba kam, sprach dieser: Beim Sprengen$fn44. 
Meilah 3b:13	R. Asi sprach zu Raba: U͑la sagte ja, wenn man einen verwerflichen Haut’en$fn45auf den Altar getan hat, sei ihm die Verwerflichkeit genommen$fn46; 
Meilah 3b:14	die Abhebung des Haufens entspricht ja dem Schlachten!? 
Meilah 3b:15	Dieser erwiderte: Es ist ein Verbot, das zur Verwerflichmachung$fn47bringt. – 
Meilah 4a:1	Er lehrt ja aber: wenn die Verwerflichmachung bei anderem$fn48erfolgen kann, um wieviel mehr bei diesem selber!? – 
Meilah 4a:2	Dies ist ebenfalls zu verstehen, das Verbot, das zur Verwerflichkeit bringt. 
Meilah 4a:3	Rabina sprach zu R. Asi: Hpha lehrte ja aber, der Streit$fn49 besiehe nur bei zwei Dienstverrichtungen$fn50, 
Meilah 4a:4	wenn er beispielsweise gesagt hat, er wolle das eine Organ$fn51außerhalb der Frist und das andere Organ außerhalb des Ortes durchschneiden, bei einer Dienstverrichtung aber stimmen alle überein, daß dies eine Vermischung der Absichten$fn52sei!? – 
Meilah 4a:5	Hierbei ergibt es sich ebenfalls erst beim Sprengen, ob es bei einer Dienstverrichtung oder bei zwei Dienstverrichtungen erfolgt ist. – 
Meilah 4a:6	Demnach sollte es$fn53auch beim Dankopfer erst beim Blutsprengen erfolgen!? – 
Meilah 4a:7	Unter ‘heilig’ ist zu verstehen, um untauglich zu werden, daß es verbrannt werden$fn54muß. 
Meilah 4a:8	Ihm wäre eine Stütze zu erbringen. Am Verwerflichen kann man immer eine Veruntreuung begehen. Doch wohl, auch nachdem das Blut gesprengt worden ist; somit ist dies eine Stütze für ihn. – 
Meilah 4a:9	Nein, solange das Blut noch nicht gesprengt worden ist. – Wozu braucht dies, wenn das Blut noch nicht gesprengt worden ist, gelehrt zu werden!? –  
Meilah 4a:10	Vielmehr, tatsächlich, wenn es bereits gesprengt ist, nur spricht diese Lehre von einem Brandopfer$fn55. – Von einem Brandopfer ist es ja selbstverständlich, denn es ist ja vollständig Gottes!? 
Meilah 4b:1	Ferner lehrt er im Schlußsatze: hat das Blut über Nacht gestanden, so gibt es dabei eine Veruntreuung, auch wenn man es wieder gesprengt hat. 
Meilah 4b:2	Erklärlich ist dies, wenn du sagst, er spreche von einem Sündopfer, wozu braucht dies aber gelehrt zu werden, 
Meilah 4b:3	wenn du sagst, er spreche von einem Brandopfer$fn55!? – 
Meilah 4b:4	Der Schlußsatz ist entschieden eine Stütze für ihn; ist es auch der Anfangsatz? – Wenn der Schlußsatz eine Stütze für ihn ist, so ist auch der Anfangsatz eine Stütze für ihn$fn56. – 
Meilah 4b:5	Nur der Schlußsatz ist entschieden eine Stütze für ihn, nicht aber der Anfangsatz. – Womit ist es anders? – Beim Übernachtenlassen übt man eine Handlung mit den Händen aus, somit ist das Sprengen$fn57nicht wirksam, es aus der [Eignung zur] Veruntreuung zu bringen, 
Meilah 4b:6	bei der Absicht$fn58aber, wobei man keine Handlung mit den Händen ausübt, ist das Sprengen wirksam, es aus der [Eignung zur] Veruntreuung zu bringen. – 
Meilah 4b:7	Es wäre anzunehmen, daß folgendes eine Stütze für ihn ist: Beim Verwerflichen vom Hochheiligen$fn55gibt es eine Veruntreuung. Doch wohl, auch nachdem man das Blut gesprengt hat, somit ist dies eine Stütze für ihn. – Nein, solange man es noch nicht gesprengt hat. – 
Meilah 4b:8	Wenn man es aber gesprengt hat, gibt es also dabei keine Veruntreuung; wieso lehrt er demnach im Schlußsatze: beim Minderheiligen aber gebe es dabei keine Veruntreuung, er sollte doch beim ersten. 
Meilah 4b:9	Falle selber einen Unterschied machen und lehren: vor dem Blutsprengen gibt es dabei eine Veruntreuung, nach dem Blutsprengen gibt es dabei keino Veruntreuung!? – Dies ist entschieden eine Stütze für ihn. – 
Meilah 4b:10	Demnach wäre, wenn der Schlußsatz eine Stütze für ihn ist, auch der Anfangsatz eine Stütze für ihn!? – Beim Minderheiligen ist dies ausgemacht, hierbei aber ist es nicht ausgemacht$fn59.
Meilah 4b:11	R. J<small>EHOŠUA͑ SAGTE EINE</small> R<small>EGEL</small>: W<small>AR ES BEREITS DEN</small> P<small>RIESTERN ERLAUBT, SO GIBT ES DABEI KEINE</small> V<small>ERUNTREUUNG, WAR ES DEN</small> P<small>RIESTERN NOCH NICHT ERLAUBT, SO GIBT ES DABEI EINE</small> V<small>ERUNTREUUNG</small>, 
Meilah 4b:12	W<small>ELCHES WAR DEN</small> P<small>RIESTERN BEREITS ERLAUBT</small>? D<small>AS ÜBER</small> N<small>ACHT LIEGEN GEBLIEBEN</small>, <small>UNREIN GEWORDEN ODER HINAUSGEKOMMEN IST</small>. 
Meilah 4b:13	W<small>ELCHES AVAR DEN</small> P<small>RIESTERN NOCH NICHT ERLAUBT</small>? D<small>AS AUSSERHALB DER</small> F<small>RIST ODER AUSSERHALB DES</small> O<small>RTES GESCHLACHTET WORDEN IST, ODER DESSEN</small> B<small>LUT</small> U<small>NTAUGLICHE AUFGENOMMEN ODER GESPRENGT HABEN</small>. 
Meilah 4b:14	Bar Qappara sprach zu Bar Pada: Schwesterssohn, sieh zu, was du mich morgen im Lehrhause fragen sollst: spricht unsere Mišna vom Erlaubtsein zum Schlachten, 
Meilah 5a:1	spricht unsere Mišna vom Erlaubtsein zum Blutsprengen, oder spricht unsere Mišna vom Erlaubtsein zum Essen? Ḥizqija sagte, unsere Mišna spreche vom Erlaubtsein zum Schlachten: R. Johanan sagte, unsere Mišna spreche vom Erlaubtsein zum Essen. 
Meilah 5a:2	R. Zera sprach: Aus unserer Mišna ist weder die Ansicht Ḥizqijas noch die Ansicht R. Joḥanans zu erweisen. – 
Meilah 5a:3	Wir haben gelernt: Das über Nacht liegen geblichen, unrein geworden oder hinausgekommen ist. Doch wohl, wenn das Blut über Nacht liegen geblieben ist, und er lehrt, daß es dabei keine Veruntreuung gebe. 
Meilah 5a:4	Somit ist hieraus zu entnehmen, daß unsere Mišna vom Erlaubtsein zum Sprengen spricht. – 
Meilah 5a:5	Nein, wenn das Fleisch über Nacht liegen geblieben, das Blut aber gesprengt worden ist; deshalb$fn60lehrt er, daß es dabei keine Veruntreuung gebe. – 
Meilah 5a:6	Wir haben gelernt: Welches war den Priestern noch nicht erlaubt? Das außerhalb der Frist oder außerhalb des Ortes geschlachtet worden ist, oder dessen Blut Untaugliche aufgenommen oder gesprengt haben. 
Meilah 5a:7	In welchem Falle: wollte man sagen, wenn Untaugliche es gesprengt haben und$fn61 Untaugliche es aufgenommen hatten, wozu ist beides nötig!? 
Meilah 5a:8	Doch wohl, wenn Untaugliche es aufgenommen oder Untaugliche es gesprengt haben, 
Meilah 5a:9	und er lehrt, daß es dabei eine Veruntreuung gebe; somit ist hieraus$fn62zu entnehmen, daß unsere Mišna vom Erlaubtsein zum Sprengen spricht. 
Meilah 5a:10	R.Joseph wandte ein: Dort haben wir gelernt: 
Meilah 5a:11	Wegen des Blutes eines untauglichen Sündopfers ist das Waschen$fn63nicht erforderlich, einerlei ob es$fn64tauglich war und untauglich geworden ist, oder ob es überhaupt nicht tauglich war und untauglich geworden ist. 
Meilah 5a:12	Welches war tauglich und ist untauglich geworden? Das über Nacht gestanden hat, unrein geworden ist oder hinausgekommen$fn65 war. 
Meilah 5a:13	Welches war überhaupt nicht tauglich? Wenn [das Opfer] außerhalb des Ortes oder außerhalb der Frist geschlachtet worden ist, oder Untaugliche das Blut aufgenommen oder gesprengt haben. 
Meilah 5a:14	In welchem Falle, wenn du sagst, es sei auf diese Weise zu unterscheiden: wollte man sagen, wenn Untaugliche [das Blut] aufgenommen und Untaugliche es gesprengt haben, wonach nur dann wegen des Blutes das Waschen nicht erforderlich ist, wenn aber Taugliche [das Blut] aufgenommen oder gesprengt haben, sei wegen des Blutes das Waschen erforderlich, 
Meilah 5a:15	so heißt es ja diesbezüglich$fn66<i>der von seinem Blute sprengt,</i> nicht aber, wenn es bereits gesprengt worden$fn67ist!? Vielmehr ist es nicht genau$fn68zu nehmen, 
Meilah 5b:1	ebenso ist es auch hierbei$fn69nicht genau zu nehmen. B. Asi sprach: Wozu braucht er es$fn70demnach zweimal zu lehren!? 
Meilah 5b:2	Vielmehr ist es bei der Veruntreuung genau zu nehmen, 
Meilah 5b:3	und dort lehrt er uns folgendes, daß nämlich auch der Untaugliche Zurückbleibendes$fn71macht; 
Meilah 5b:4	auch wenn ein Untauglicher [das Blut] aufgenommen und gesprengt hat, und darauf ein Tauglicher es aufnimmt und sprengt, ist dies nichts, weil es Zurückbleibendes ist. – 
Meilah 5b:5	Aber Reš Laqiš fragte ja R. Joḥanan, ob ein Untauglicher Zurückbleibendes mache, 
Meilah 5b:6	und dieser erwiderte ihm, nichts anderes als [die Absicht$fn72], es außerhalb der Frist oder außerhalb des Ortes [zu essen], mache es$fn73zu Zurückbleibendem, weil diese es auch zur Verwerflichkeit geeignet macht; 
Meilah 5b:7	doch wohl ein Untauglicher nicht$fn74!? – Nein, auch ein Untauglicher. – 
Meilah 5b:8	Er sagte ja aber: nichts anderes!? – 
Meilah 5b:9	Er meint es wie folgt: außer [der Absicht], es außerhalb der Frist oder außerhalb des Ortes [zu essen], gibt es nichts, was das Gemeindeopfer nicht wohlgefällig macht, wobei [das Blut aber] Zurückbleibendes ist. Ein Unreiner$fn75aber, der für das Gemeindeopfer zulässig ist, macht es zu Zurückbleibendem, 
Meilah 5b:10	und andere Untaugliche, die für das Gemeindeopfer nicht zulässig sind, machen es nicht zu Zurückbleibendem. – 
Meilah 5b:11	Komm und höre: Beim Verwerflichen gibt es immer eine Veruntreuung. 
Meilah 5b:12	Doch wohl, wenn man [das Blut] nicht gesprengt hat, somit ist hieraus zu entnehmen, daß unsere Mišna vom Erlaubtsein zum Sprengen spricht. – 
Meilah 5b:13	Nein, wenn man es gesprengt hat, 
Meilah 5b:14	und mit ‘immer’ lehrt er uns das, was R. Gidel gesagt hat. R. Gidel sagte nämlich im Namen Rabhs: Das Sprengen des Verwerflichen bringt es nicht aus der Veruntreuungsfähigkeit und bringt es nicht zur Veruntreuungsfähigkeit$fn76. – 
Meilah 6a:1	Komm und höre: R.Šimo͑n sagte: Es gibt Übriggebliebenes, wobei es eine Veruntreuung gibt, und es gibt Übriggebliebenes, wobei es keine Veruntreuung gibt, 
Meilah 6a:2	und zwar: hat [das Blut] vor dem Sprengen über Nacht gestanden, so gibt es dabei eine Veruntreuung, 
Meilah 6a:3	wenn nach dem Sprengen, so gibt es dabei keine Veruntreuung. Er lehrt also, daß es dabei eine Veruntreuung gebe; doch wohl, wenn Zeit zum Sprengen vorhanden war, sodaß, wenn er wollte, er sprengen könnte. 
Meilah 6a:4	Somit ist hieraus zu entnehmen, daß unsere Mišna vom Erlaubtsein zum Essen spricht. – 
Meilah 6a:5	Nein, wenn man es kurz vor Sonnenuntergang aufgenommen hat, sodaß keine Zeit zum Sprengen war. – 
Meilah 6a:6	Weshalb lehrt er demnach, wenn es dabei keine Veruntreuung gibt, 
Meilah 6a:7	wenn noch Zeit dazu war: vor dem Sprengen, sollte er doch lehren: vor dem Sonnenuntergange, beziehungsweise nach dem Sonnenuntergange$fn77!? – 
Meilah 6a:8	Dies lehrt er auch: bevor es zum Sprengen geeignet war, und nachdem es zum Sprengen geeignet$fn78war. – 
Meilah 6a:9	Komm und höre: R. Šimo͑n sagte: Es gibt Verwerfliches, wobei es eine Veruntreuung gibt, und es gibt Verwerfliches, wobei es keine Veruntreuung gibt, 
Meilah 6a:10	und zwar: vor dem Sprengen gibt es dabei eine Veruntreuung, nach dem Sprengen gibt es dabei keine Veruntreuung. 
Meilah 6a:11	Er lehrt also, daß es vor dem Sprengen dabei eine Veruntreuung gebe; doch wohl, wenn Zeit zum Sprengen war, sodaß, wenn er wollte, er sprengen könnte, und er lehrt, daß es dabei eine Veruntreuung gebe. Hieraus ist somit zu entnehmen, daß unsere Mišna vom Erlaubtsein zum Essen spricht. – 
Meilah 6a:12	Nein, wenn keine Zeit zum Sprengen war. – Weshalb lehrt er demnach, wenn es dabei keine Veruntreuung gibt, 
Meilah 6a:13	wenn noch Zeit zum Sprengen war: nach dem Sprengen, sollte er doch lehren: nach dem Sonnenuntergang!? – 
Meilah 6a:14	Dies meint er auch: bevor es zum Sprengen geeignet war, und nachdem es zum Sprengen geeignet war. – 
Meilah 6a:15	Komm und höre: Beim Verwerflichen vom Hochheiligen gibt es eine Veruntreuung. Doch wohl, wenn man [das Blut] bereits gesprengt hat, somit ist hieraus zu entnehmen, daß unsere Mišna vom Erlaubtsein zum Essen spricht. – Nein, wenn man es noch nicht gesprengt hat. – 
Meilah 6a:16	Weshalb lehrt er demnach, wenn es dabei keine Veruntreuung gibt, falls man es gesprengt hat, daß es beim Minderheiligen keine Veruntreuung gebe, 
Meilah 6a:17	sollte er doch lehren: eines gilt vor dem Sprengen und eines nach dem Sprengen!? – 
Meilah 6a:18	Folgendes will er lehren: soll es Veruntreuungsfähigkeit erlangen, so macht nur das vorschriftsmäßige Sprengen es veruntreuungsfähig, soll es aus der Veruntreuungsfähigkeit kommen, 
Meilah 6a:19	so bringt auch das unvorschriftsmäßige [Sprengen] es aus der Veruntreuungsfähigkeit.
Meilah 6b:1	<sup>ii</sup><b>B</b><small>EIM</small> F<small>LEISCHE VOM</small> H<small>OCHHEILIGEN, DAS VOR DEM</small> B<small>LUTSPRENGEN</small> <small>HINAUSGEKOMMEN WAR, GIBT ES, WIE</small> 
Meilah 6b:2	R. E<small>LIE͑ZER SAGT, EINE VERUNTREUUNG UND MAN IST WEGEN DESSEN NICHT SCHULDIG WEGEN</small> V<small>ERWERFLICHEM</small>, U<small>EBRIGGEBLIEBENEM UND</small> U<small>NREINEM</small>. 
Meilah 6b:3	R. A͑<small>QIBA SAGT, ES GEBE DABEI KEINE</small> V<small>ERUNTREUUNG UND MAN SEI DIESERHALB SCHULDIG WEGEN</small> V<small>ERWERFLICHEM</small>, Ü<small>BRIGGEBLIEBENEM UND</small> U<small>NREINEM</small>. 
Meilah 6b:4	R. A͑<small>QIBA SPRACH</small>: E<small>NTHEBT ETWA NICHT, WENN JEMAND SEIN SÜNDOPFER ABGESONDERT HATTE UND ES ABHANDEN GEKOMMEN WAR, UND NACHDEM ER SEINERSTATT EIN ANDERES ABGESONDERT HAT, DAS ERSTE SICH WIEDER EINFINDET UND NUNMEHR BEIDE DASTEHEN</small>$fn79, 
Meilah 6b:5	<small>DAS BLUT, WIE ES DAS FLEISCH DESSELBEN ENTHEBT</small>$fn80, <small>AUCH DAS</small> F<small>LEISCH DES ANDEREN</small>? 
Meilah 6b:6	W<small>ENN NUN DAS</small> B<small>LUT DAS</small> F<small>LEISCH DES ANDEREN DER</small> V<small>ERUNTREUUNG ENTHEBT, SO ENTHEBT ES DAS</small> F<small>LEISCH DESSELBEN ERST RECHT</small>. 
Meilah 6b:7	W<small>ENN DIE</small> O<small>PFERTEILE VON</small> M<small>INDERHEILIGEM VOR DEM</small> <sup>iii</sup>B<small>LUTSPRENGEN HINAUSGEKOMMEN SIND, SO GIBT ES BEI IHNEN, WIE</small> 
Meilah 6b:8	R. E<small>LIE͑ZER SAGT, KEINE</small> V<small>ERUNTREUUNG UND MAN IST IHRETWEGEN NICHT SCHULDIG WEGEN</small> V<small>ERWERFLICHEM</small>, Ü<small>BRIGGEBLIEBENEM UND</small> U<small>NREINEM</small>. R. A͑<small>QIBA SAGT, ES GEBE DABEI EINE</small> V<small>ERUNTREUUNG UND MAN SEI IHRETWEGEN SCHULDIG WEGEN</small> V<small>ERWERFLICHEM</small>, Ü<small>BRIGGEBLIEBENEM UND</small> U<small>NREINEM</small>.
Meilah 6b:9	GEMARA. Wozu ist beides$fn81nötig? – 
Meilah 6b:10	Dies ist nötig. Würde er es nur vom Hochheiligen gelehrt haben, so könnte man glauben, R. Elie͑zer sage nur hierbei, daß es dabei eine Veruntreuung gebe, weil das vorschriftsmäßige Sprengen es aus der Veruntreuung bringt und das unvorschriftsmäßige es nicht aus der Veruntreuung bringt, 
Meilah 6b:11	hinsichtlich des Gelangens zur Veruntreuung aber pflichte er R. A͑qiba bei, daß es auch durch das unvorschriftsmäßige zur Veruntreuung gelange. 
Meilah 6b:12	Und würde er es nur vom Minderheiligen gelehrt haben, so könnte man glauben, nur vom Minderheiligen sage R. A͑qiba, daß es dabei eine Veruntreuung gebe, weil es auch durch das unvorschriftsmäßige Sprengen zur Veruntreuung gelangt, 
Meilah 6b:13	beim Hochheiligen aber, wobei es sich um die Enthebung handelt, bringe das unvorschriftsmäßige es nicht aus der Veruntreuung, so lehrt er uns. 
Meilah 6b:14	R. Joḥanan sagte: Das, was R. A͑qiba sagt, wenn es hinausgekommen ist, sei das Sprengen wirksam, gilt nur von dem Falle, wenn ein Teil hinausgekommen ist, nicht aber sagt es R. A͑qiba von dem Falle, wenn alles hinausgekommen ist. 
Meilah 6b:15	R. Asi sprach zu R. Joḥanan: Bereits lehrten mich die Kollegen in der Diaspora, 
Meilah 7a:1	die Absicht sei wirksam auch beim Abhandengekommenen$fn82und beim Verbrannten. 
Meilah 7a:2	Das Abhandengekommene und das Verbrannte sind ja nicht auf der Welt, dennoch lehrt er, die Absicht sei wirksam. – 
Meilah 7a:3	Kann R. Asi dies denn gesagt haben, R. Asi fragte ja R. Joḥanan, wie es denn sei, wenn man beim fortzugießenden [Blute] beabsichtigt hat, es am folgenden Tage$fn83zu tun, 
Meilah 7a:4	und R. Zera sprach zu ihm: du hast uns bereits vom Abfall$fn84gelehrt. Abfall ist also für die Unreinheit nicht empfänglich, 
Meilah 7a:5	weil er unwesentlich ist, ebenso ist beim fortzugießenden [Blute], da es der Vernichtung verfällt, die Absicht wirkungslos. – 
Meilah 7a:6	Dem widerspricht ja die Lehre vom Abhandengekommenen und vom Verbrannten$fn85!? Raba erwiderte: Lies: über das später Abhandengekommene und Verbrannte$fn86.
Meilah 7a:7	R. Papa sagte: Das, was R. A͑qiba sagt, wenn es hinausgekommen ist, sei das Sprengen wirksam, gilt nur von dem Falle, wenn das Fleisch hinausgekommen ist, wenn aber das Blut, so ist das Sprengen$fn87, nachdem es hinausgekommen war, nicht wirksam. 
Meilah 7a:8	Desgleichen wird gelehrt: Wenn er schweigend$fn88geschlachtet hat und das Blut hinausgekommen ist, so hat er, auch wenn er es später gesprengt hat, nichts ausgerichtet. Bei Hochheiligem gibt es dabei eine Veruntreuung und bei Minderheiligem gibt es dabei keine Veruntreuung.
Meilah 7a:9	R. A͑<small>QIBA SAGTE</small>: (D<small>IES IST ZU VERGLEICHEN</small>). 
Meilah 7a:10	R. Elea͑zar sagte: R. A͑qiba sagt es nur von dem Falle, wenn mit einem Male$fn89, nicht aber sagt es R. A͑qiba von dem Falle, wenn nacheinander. 
Meilah 7a:11	Es wird gelehrt: R. Šimo͑n sagte: Als ich nach Kephar Phagi ging, begegnete mir ein Greis und er sprach zu mir: Ist R. A͑qiba der Ansicht, daß, wenn es hinausgekommen ist, das Sprengen wirksam ist? Ich erwiderte ihm: Jawohl. Als ich nach Galiläa kam und dies den Kollegen unterbreitete, sprachen sie zu mir: Es ist ja untauglich, wie sollte [das Sprengen] das Untaugliche wohlgefällig machen!? 
Meilah 7a:12	Als ich hierauf fortging und dies R. A͑qiba unterbreitete, sprach er zu mir: Mein Sohn, bist du etwa nicht dieser Ansicht? Wenn jemand sein Sündopfer abgesondert hatte und es abhanden gekommen war, und, nachdem er seinerstatt ein anderes abgesondert hat, das erste sich wieder einfindet und nunmehr beide dastehen, gibt es ja eine Veruntreuung bei beiden; 
Meilah 7b:1	wenn man sie geschlachtet hat und das Blut beider sich in den Bechern befindet, gibt es ja eine Veruntreuung bei beiden. Gibst du etwa nicht zu, daß, wenn das Blut des einen von ihnen gesprengt worden ist, wie das Blut das Fleisch desselben der Veruntreuung enthebt, es auch das Fleisch des anderen der Veruntreuung enthebt? 
Meilah 7b:2	Wenn es nun das Fleisch des anderen vor der Veruntreuung schützt, obgleich es untauglich ist, so schützt es das Fleisch desselben erst recht. 
Meilah 7b:3	Reš Laqiš sagte im Namen R. Oša͑jas: Es ist eine verstohlene Antwort, die R. A͑qiba jenem Schüler gab: nur gleichzeitig$fn90, nicht aber nacheinander; 
Meilah 7b:4	wenn es untauglich ist, ist es ja einerlei, ob gleichzeitig oder nacheinander. 
Meilah 7b:5	Da sprach R. Joḥanan zu Reš Laqiš: Bist du etwa nicht dieser Ansicht? Pflichtest du etwa nicht bei, 
Meilah 7b:6	daß, wenn jemand zur Sicherheit zwei Schuldopfer abgesondert, beide geschlachtet und die Opferteile des einen vor dem Sprengen [auf den Altar] gebracht hat, sie, wenn hinaufgekommen, herabzunehmen sind? 
Meilah 7b:7	Wieso sind sie nun, wenn du sagst, sie gelten als ein Körper, wenn sie hinaufgekommen sind, herabzunehmen, U͑la sagte ja, Opferteile von Minderheiligem, die vor dem Blutsprengen auf den Altar gekommen sind, seien nicht mehr herabzunehmen, weil sie bereits Zehrung des Altars geworden sind!? 
Meilah 7b:8	Da schwieg er. Hierauf sprach R. Joḥanan: Ich habe dem Knaben die Beine abgehauen.
Meilah 7b:9	<sup>iv</sup><b>D</b><small>AS</small> B<small>LUTZEREMONIELL ERFOLGT BEIM</small> H<small>OCHHEILIGEN ERLEICHTERND UND ERSCHWEREND, BEIM</small> M<small>INDERHEILIGEN ABER IMMER ERSCHWEREND</small>. 
Meilah 7b:10	U<small>ND ZWAR: BEIM</small> H<small>OCHHEILIGEN GIBT ES VOR DEM</small> B<small>LUTSPRENGEN EINE</small> V<small>ERUNTREUUNG AN DEN</small> O<small>PFERTEILEN UND AM</small> F<small>LEISCHE, NACH DEM</small> B<small>LUTSPRENGEN ABER NUR EINE</small> V<small>ERUNTREUUNG AN DEN</small> O<small>PFERTEILEN UND NICHT AM</small> F<small>LEISCHE, 
Meilah 7b:11	UND WEGEN BEIDER IST MAN SCHULDIG WEGEN</small> V<small>ERWERFLICHEM</small> Üb<small>RIGGEBLIEBENEM UND</small> U<small>NREINEM</small>. E<small>S ERGIBT SICH ALSO, DASS DAS</small> B<small>LUTZEREMONIELL BEIM</small> H<small>OCHHEILIGEN ERLEICHTERND UND ERSCHWEREND ERFOLGT</small>. B<small>EIM</small> M<small>INDERHEILIGEN IMMER ERSCHWEREND, 
Meilah 7b:12	UND ZWAR: BEIM</small> M<small>INDERHEILIGEN GIBT ES VOR DEM</small> B<small>LUTSPRENGEN KEINE</small> V<small>ERUNTREUUNG, NICHT AN DEN</small> O<small>PFERTEILEN UND NICHT AM</small> F<small>LEISCHE, NACH DEM</small> B<small>LUTSPRENGEN ABER GIBT ES EINE</small> V<small>ERUNTREUUNG AN DEN</small> O<small>PFERTEILEN, NICHT ABER AM</small> F<small>LEISCHE, 
Meilah 7b:13	UND WEGEN BEIDER IST MAN SCHULDIG WEGEN</small> V<small>ERWERFLICHEM</small>, Ü<small>BRIGGEBLIEBENEM UND</small> U<small>NREINEM</small>. E<small>S ERGIBT SICH ALSO, DASS DAS</small> B<small>LUTZEREMONIELL BEIM</small> M<small>INDERHEILIGEN IMMER ERSCHWEREND ERFOLGT</small>.
Meilah 7b:14	GEMARA. Er lehrt$fn91, daß es beim Fleische keine Veruntreuung gebe,. wonach es dabei nur keine Veruntreuung gibt, wohl aber ein Verbot$fn92; weshalb denn, es ist ja Eigentum des Priesters!? – 
Meilah 7b:15	Das ist kein Einwand; da er im Anfangsatze lehrt, es gebe dabei eine Veruntreuung, lehrt er im Schlußsatze, es gebe dabei keine Veruntreuung$fn93. – 
Meilah 7b:16	Wie ist demnach der Schlußsatz zu erklären: beim Minderheiligen ist es immer erschwerend, und zwar: beim Minderheiligen gibt es vor dem Blutsprengen keine Veruntreuung, nicht daran und nicht an den Opfer teilen, und man ist wegen dieser nicht schuldig wegen Verwerflichem, Übriggebliebenem und Unreinem; nach dem Blutsprengen aber gibt es eine Verunreinigung an den Opferteilen, nicht aber am Fleische. 
Meilah 7b:17	Nur eine Veruntreuung gibt es nicht, wohl aber ein Verbot; weshalb denn, es ist ja Besitz des Eigentümers$fn94!? 
Meilah 7b:18	R. Ḥanina erwiderte: Wenn [das Fleisch] hinausgekommen$fn65 war, und zwar nach R. A͑qiba$fn95. 
Meilah 7b:19	R. A͑qiba sagt, wenn es hinausgekommen war, sei das Sprengen wirksam, aber nur hinsichtlich der Verbrennung$fn96, 
Meilah 8a:1	hinsichtlich des Essens aber macht es$fn97nicht wohlgefällig.
Meilah 8a:2	
Meilah 8a:3	<sup>i</sup><b>B</b><small>EIM</small> V<small>OGEL</small>-S<small>ÜNDOPFER GIBT ES EINE</small> V<small>ERUNTREUUNG, SOBALD ES GEHEILIGT WORDEN IST; IST IHM</small> [<small>DER</small> K<small>OPF</small>] <small>ABGEKNIFFEN WORDEN, SO IST ES UNTAUGLICH ZU WERDEN GEEIGNET</small> [<small>DURCH</small> B<small>ERÜHRUNG</small>] <small>MIT EINEM, DER AM SELBEN</small> T<small>AGE UNTERGETAUCHT IST ODER DEM DIE</small> S<small>ÜHNE</small>$fn1 <small>NOCH FEHLT, UND DURCH DAS</small> Ü<small>BERNACHTEN</small>$fn2; 
Meilah 8a:4	<small>IST DAS</small> B<small>LUT GESPRENGT WORDEN, SO IST MAN WEGEN DESSEN SCHULDIG WEGEN</small> V<small>ERWERFLICHEM</small>, Ü<small>BRIGGEBLIEBENEM UND</small> U<small>NREINEM, UND ES GIBT DABEI KEINE</small> V<small>ERUNTREUUNG</small>$fn3.
Meilah 8a:5	GEMARA. Er lehrt, es sei untauglich zu werden geeignet durch einen, der am selben Tage untergetaucht ist, oder dem die Sühne noch fehlt, und durch Übernachten; nur untauglich, nicht aber unrein zu werden$fn4. 
Meilah 8a:6	Unsere Mišna vertritt somit die Ansicht der Rabbanan, denn es wird gelehrt: Abba Šaúl sagte: Der am selben Tage Untergetauchte ist für 
Meilah 8b:1	das Heilige erstgradig [unrein]$fn5. 
Meilah 8b:2	R. Meir sagt, er mache Heiliges unrein und die Hebe untauglich. Die Weisen sagen, wie er Getränke von Hebe und Speisen von Hebe untauglich macht, ebenso mache er heilige Getränke und heilige Speisen untauglich$fn6. 
Meilah 8b:3	Raba sagte: Nach Abba Saul haben die Rabbanan beim Heiligen eine Steigerung getroffen und den am selben Tage Untergetauchten dem erstgradig [Unreinen] gleichgestellt; 
Meilah 8b:4	nach R. Meír gleicht er dem, der zweitgradig [Unreines] gegessen hat; nach den Weisen aber ist, sobald er untergetaucht ist, die Unreinheit geschwächt, sodaß er nur untauglich macht, unrein aber macht er nicht.
Meilah 8b:5	I<small>ST DAS</small> B<small>LUT GESPRENGT WORDEN, SO IST MAN WEGEN DESSEN SCHULDIG &amp;C</small>. Nur eine Veruntreuung gibt es dabei nicht, wohl aber liegt ein Verbot$fn7 vor. Weshalb denn, es ist ja Eigentum des Priesters!? 
Meilah 8b:6	R. Ḥanina erwiderte: Wenn es hinausgekommen war, und zwar nach R. A͑qiba, welcher sagt, wenn es hinausgekommen war, sei das Sprengen wirksam$fn8, es ist aber zum Essen nicht verwendbar.
Meilah 8b:7	R. Hona sagte im Namen Rabhs, das Auspressen$fn9 sei beim Vogel-Sündopfer nicht unerläßlich, denn Rabh lehrte: ‘ist das Blut gesprengt worden’. 
Meilah 8b:8	R. Ada b. Ahaba sagte im Namen Rabhs, das Auspressen sei beim Vogel-Sündopfer unerläßlich, denn Rabh lehrte: ‘hat er das Blut ausgepreßt’. – 
Meilah 8b:9	Komm und höre:$fn10<i>Was vom Blute zurückbleibt, werde auf den Grund des Altars ausgepreßt, es ist ein Sündopfer.</i> Erklärlich ist es nach R. Ada b. Ahaba, daß es heißt: <i>was vom Blute zurückbleibt, werde ausgepreßt, es ist ein Sündopfer,</i> was aber heißt nach R. Hona: <i>was zurückbleibt</i>$fn11!? – 
Meilah 8b:10	Wie in der Schule R. Jišma͑éls gelehrt worden ist: wenn zurückbleibt$fn12. – Was heißt:$fn10<i>es ist ein Sündopfer</i>$fn13?<i> –</i> Dies bezieht sich auf das Vorangehende$fn14. 
Meilah 8b:11	R. Aḥa, der Sohn Rabas, sprach zu R. Aši: Demnach ist auch beim Speisopfer, wobei es heißt:$fn15<i>was zurückbleibt,</i> ebenfalls zu verstehen: wenn es zurückbleibt!? Wolltest du sagen, dem sei auch so, 
Meilah 9a:1	so wird ja gelehrt:$fn16<i>Von seinem Mehl und seinem Öl samt seinem ganzen Weihrauch,</i> ausgenommen der Fall, wenn etwas vom Mehl fehlt, wenn etwas vom Öl fehlt, oder etwas vom Weihrauch fehlt. – 
Meilah 9a:2	Ich will dir sagen, da heißt es überflüssigerweise: <i>was zurückbleibt.</i> 
Meilah 9a:3	Der Vater des Šemuél [b. Abin] wandte gegen R. Hona ein: Einerlei ob ein Geflügel-Sündopfer oder ein Geflügel-Brandopfer, wenn man den Kopf abgekniffen hat oder das Blut ausgedrückt hat außerhalb des Ortes$fn17, so ist es untauglich und es ist nicht mit der Ausrottung belegt; wenn außerhalb der Frist, so ist es Verwerfliches und man ist dieserhalb der Ausrottung schuldig. Hier lehrt er also: oder das Blut ausgedrückt hat!? 
Meilah 9a:4	Er richtete diesen Einwand und er selber erklärte es: er lehrt es je nachdem$fn18.
Meilah 9a:5	Der Text. In der Schule R. Jišma͑éls wurde gelehrt: Wenn Blut zurückbleibt$fn19. – 
Meilah 9a:6	Dort$fn20lehrt ja aber die Schule R. Jišma͑éls, das zurückbleibende [Blut] sei unerläßlich, und hierzu sagte R. Papa, ein Unterschied bestehe zwischen ihnen$fn21hinsichtlich des Ausdrückens beim Geflügel-Sündopfer!? – Zwei Tannaím streiten über die Ansicht der Schule R. Jišma͑éls.
Meilah 9a:7	<sup>ii</sup><b>B</b><small>EIM</small> V<small>OGEL</small>-B<small>RANDOPFER GIBT ES EINE</small> V<small>ERUNTREUUNG, SOBALD ES GEHEILIGT WORDEN IST</small>. I<small>ST IHM</small> [<small>DER</small> K<small>OPF</small>] <small>ABGEKNIFFEN WORDEN, SO IST ES UNTAUGLICH ZU WERDEN GEEIGNET</small> [<small>DURCH</small> B<small>ERÜHRUNG</small>] <small>MIT EINEM, DER AM SELBEN</small> T<small>AGE UNTERGETAUCHT IST, ODER DEM DIE</small> S<small>ÜHNE NOCH FEHLT, UND DURCH DAS</small> Ü<small>BERNACHTEN; IST DAS</small> B<small>LUT AUSGEPRESST WORDEN, SO IST MAN WEGEN DESSEN SCHULDIG WEGEN</small> V<small>ERWERFLICHEM</small>, Ü<small>BRIGGEBLIEBENEM UND</small> U<small>NREINEM, UND ES GIBT DABEI EINE</small> V<small>ERUNTREUUNG, BIS</small> [<small>DIE</small> A<small>SCHE</small>] <small>IN DEN</small> A<small>SCHENRAUM KOMMT</small>. 
Meilah 9a:8	<sup>iii</sup>B<small>EI DEN ZU VERBRENNENDEN</small> F<small>ARREN</small>$fn22<small>UND DEN ZU VERBRENNENDEN</small> Z<small>IEGENBÖCKEN</small>$fn23<small>GIBT ES EINE</small> V<small>ERUNTREUUNG, SOBALD SIE GEHEILIGT WORDEN SIND; SIND SIE GESCHLACHTET WORDEN, SO SIND SIE UNTAUGLICH ZU WERDEN GEEIGNET</small> [<small>DURCH</small> B<small>ERÜHRUNG</small>] <small>MIT EINEM, DER AM SELBEN</small> T<small>AGE UNTERGETAUCHT IST, ODER DEM DIE</small> S<small>ÜHNE NOCH FEHLT, UND DURCH DAS</small> Ü<small>BERNACHTEN; IST IHR</small> B<small>LUT GESPRENGT WORDEN, SO IST MAN IHRETWEGEN SCHULDIG WEGEN</small> V<small>ERWERFLICHEM</small>, Ü<small>BRIGGEBLIEBENEM UND UNREINEM, UND ES GIBT BEI IHNEN EINE</small> V<small>ERUNTREUUNG, BIS DAS</small> F<small>LEISCH DURCHGEBRANNT IST</small>. 
Meilah 9a:9	<sup>iv</sup>B<small>EIM</small> B<small>RANDOPFER GIBT ES EINE</small> V<small>ERUNTREUUNG, SOBALD ES GEHEILIGT WORDEN IST; IST ES GESCHLACHTET WORDEN, SO IST ES UNTAUGLICH ZU WERDEN GEEIGNET</small> [<small>DURCH</small> B<small>ERÜHRUNG</small>] <small>MIT EINEM, DER AM SELBEN</small> T<small>AGE UNTERGETAUCHT IST, ODER DEM DIE</small> S<small>ÜHNE NOCH FEHLT, UND DURCH DAS</small> Ü<small>BERNACHTEN; IST SEIN</small> B<small>LUT GESPRENGT WORDEN, SO IST MAN WEGEN DESSEN SCHULDIG WEGEN</small> V<small>ERWERFLICHEM</small>, Ü<small>BRIGGEBLIEBENEM UND</small> U<small>NREINEM; ES GIBT KEINE</small> V<small>ERUNTREUUNG AN DER</small> H<small>AUT, WOHL ABER GIBT ES EINE</small> V<small>ERUNTREUUNG AM</small> F<small>LEISCHE, BIS ES IN DEN</small> A<small>SCHENRAUM KOMMT</small>. 
Meilah 9a:10	<sup>v</sup>B<small>EIM</small> S<small>ÜNDOPFER, BEIM</small> S<small>CHULDOPFER UND BEI DEN</small> H<small>EILSOPFERN DER</small> G<small>EMEINDE GIBT ES EINE</small> V<small>ERUNTREUUNG, SOBALD SIE GEHEILIGT WORDEN SIND; SIND SIE GESCHLACHTET WORDEN, SO SIND SIE UNTAUGLICH ZU WERDEN GEEIGNET</small> [<small>DURCH</small> B<small>ERÜHRUNG</small>] <small>MIT EINEM, DER AM SELBEN</small> T<small>AGE UNTERGETAUCHT IST, ODER DEM DIE</small> S<small>ÜHNE NOCH FEHLT, UND DURCH DAS</small> Ü<small>BERNACHTEN; IST IHR BLUT GESPRENGT WORDEN, SO IST MAN IHRETWEGEN SCHULDIG WEGEN</small> V<small>ERWERFLICHEM</small>, Ü<small>BRIGGEBLIEBENEM UND</small> U<small>NREINEM; ES GIBT KEINE</small> V<small>ERUNTREUUNG AM</small> F<small>LEISCHE, WOHL ABER GIBT ES EINE</small> V<small>ERUNTREUUNG AN DEN</small> O<small>PFERTEILEN, BIS SIE IN DEN</small> A<small>SCHENRAUM KOMMEN</small>. 
Meilah 9a:11	<sup>vi</sup>B<small>EI DEN ZWEI</small> B<small>ROTEN</small>$fn24<small>GIBT ES EINE</small> V<small>ERUNTREUUNG, SOBALD SIE GEHEILIGT WORDEN SIND; HABEN SIE IM</small> O<small>FEN EINE</small> K<small>RUSTE BEKOMMEN, SO SIND SIE</small> [<small>DURCH</small> B<small>ERÜHRUNG</small>] <small>MIT EINEM, DER AM SELBEN</small> T<small>AGE UNTERGETAUCHT IST, ODER DEM DIE</small> S<small>ÜHNE NOCH FEHLT, UND DURCH DAS</small> Ü<small>BERNACHTEN UNTAUGLICH ZU WERDEN, UND MIT IHNEN DAS</small> O<small>PFER</small>$fn25<small>ZU SCHLACHTEN GEEIGNET; IST DAS</small> B<small>LUT DER</small> L<small>ÄMMER GESPRENGT WORDEN, SO IST MAN IHRETWEGEN SCHULDIG WEGEN</small> V<small>ERWERFLICHEM</small>, Ü<small>BRIGGEBLIEBENEM UND</small> U<small>NREINEM, UND ES GIBT BEI IHNEN KEINE</small> V<small>ERUNTREUUNG</small>. 
Meilah 9a:12	<sup>vii</sup>B<small>EIM</small> S<small>CHAUBROTE</small>$fn26 <small>GIBT ES EINE</small> V<small>ERUNTREUUNG, SOBALD ES GEHEILIGT WORDEN IST; HAT ES IM</small> O<small>FEN EINE</small> K<small>RUSTE BEKOMMEN, SO IST ES</small> [<small>DURCH</small> B<small>ERÜHRUNG</small>] <small>MIT EINEM, DER AM SELBEN</small> T<small>AGE UNTERGETAUCHT IST, ODER DEM DIE</small> S<small>ÜHNE NOCH FEHLT, UND DURCH DAS</small> Ü<small>BERNACHTEN UNTAUGLICH ZU WERDEN, UND AUF DEN</small> T<small>ISCH AUFGESCHICHTET ZU WERDEN GEEIGNET; 
Meilah 9a:13	SIND DIE</small> S<small>CHALEN</small> [W<small>EIHRAUCH</small>] <small>DARGEBRACHT WORDEN, SO IST MAN WEGEN DESSEN SCHULDIG WEGEN</small> V<small>ERWERFLICHEM</small>, Ü<small>BRIGGEBLIEBENEM UND</small> U<small>NREINEM, UND ES GIBT DABEI KEINE VERUNTREUUNG</small>. 
Meilah 9a:14	<sup>viii</sup>B<small>EI DEN</small> S<small>PEISOPFERN GIBT ES EINE</small> V<small>ERUNTREUUNG, SOBALD SIE GEHEILIGT WORDEN SIND; SIND SIE IM</small> [D<small>IENST</small>]<small>GEFÄSSE GEHEILIGT WORDEN, SO SIND SIE UNTAUGLICH ZU AVERDEN GEEIGNET</small> [<small>DURCH</small> B<small>ERÜHRUNG</small>] <small>MIT EINEM, DER AM SELBEN</small> T<small>AGE UNTERGETAUCHT IST, ODER DEM DIE</small> S<small>ÜHNE NOCH FEHLT, UND DURCH DAS</small> Ü<small>BERNACHTEN; 
Meilah 9a:15	IST DER</small> H<small>AUFE</small>$fn27<small>DARGEBRACHT WORDEN, SO IST MAN IHRETWEGEN SCHULDIG WEGEN</small> V<small>ERWERFLICHEM</small>, Ü<small>BRIGGEBLIEBENEM UND</small> U<small>NREINEM; ES GIBT KEINE</small> V<small>ERUNTREUUNG BEIM</small> Z<small>URÜCKBLEIBENDEN, WOHL ABER GIBT ES EINE</small> V<small>ERUNTREUUNG BEIM</small> H<small>AUFEN, BIS ER IN DEN</small> A<small>SCIIEINRAUM KOMMT</small>.
Meilah 9a:16	GEMARA. Es wurde gelehrt: Wer von der auf dem Altar$fn28gehäuften Asche nutznießt, begeht, wie Rabh sagt, keine Veruntreuung, und wie R. Joḥanan sagt, eine Veruntreuung. 
Meilah 9a:17	Wenn vor dem Abheben der Asche, stimmen alle überein, daß man daran eine Veruntreuung begehe, sie streiten nur über den Fall, wenn nach dem Abheben der Asche. 
Meilah 9a:18	Rabh sagt, man begehe daran keine Veruntreuung, weil das Gebot$fn29bereits ausgeübt worden$fn30ist; R. Joḥanan aber sagt, da es heißt:$fn31<i>und der Priester ziehe sein linnenes Gewand an &amp;c.</i>, dies$fn32somit der Priestergewänder benötigt, so behält [die Asche] ihre Heiligkeit. – 
Meilah 9a:19	Wir haben gelernt: Es gibt dabei eine Veruntreuung, bis es in den Aschenraum kommt. Dies$fn33ist ja ein Einwand gegen Rabh!? – Rabh kann dir erwidern: bis es für den Aschenraum geeignet$fn34ist. 
Meilah 9b:1	Man wandte ein: Diese alle$fn35sind, wenn sie vom Altar herabgefallen sind, nicht wieder hinaufzulegen. Ebenso lege man eine Kohle, die vom Altar herabgefallen ist, nicht wieder hinauf. Demnach ist sie, solange sie sich auf dem Altar befindet$fn36, wieder hinaufzulegen. 
Meilah 9b:2	Einleuchtend ist dies nach R. Joḥanan, gegen Rabh aber ist dies ja ein Einwand!? Rabh kann dir erwidern: anders ist es bei einer Kohle, die etwas Wesentliches$fn37hat. 
Meilah 9b:3	Manche lehren dies entgegengesetzt: Dies gilt nur von einer Kohle, die etwas Wesentliches hat, bei der Asche aber, die nichts Wesentliches hat, gibt es keine Veruntreuung, auch wenn sie sich auf dem. Altar befindet. Erklärlich ist dies nach Rabh, gegen R. Joḥanan aber ist dies ja ein Einwand!? – 
Meilah 9b:4	R. Joḥanan kann dir erwidern: dasselbe gilt auch von der Asche, und er lehrt dies deshalb von einer Kohle, um zu lehren, daß man sogar eine Kohle, die etwas Wesentliches hat, wenn sie vom Altar herabgefallen ist, nicht wieder hinauflege.
Meilah 9b:5	Es wurde gelehrt: Wenn jemand Fleisch von Hochheiligem vor dem Blutsprengen oder Opferteile von Minderheiligem nach dem Blutsprengen nutznießt, so fällt, wie Rabh sagt, das, was er genossen$fn38hat, der freiwilligen Spendenkasse zu; Levi aber sagt, er bringe dafür etwas, was ganz dem Altar zufällt. 
Meilah 9b:6	Es gibt eine Lehre übereinstimmend mit Levi: Wo kommt [dieser Ersatz für] die Veruntreuung hin? – Die vor den Weisen rezitierten$fn39, sagten, er bringe dafür etwas, das ganz dem Altar zufällt. – Was ist dies? – Räucherwerk. 
Meilah 9b:7	Es gibt eine Lehre übereinstimmend mit Rabh: Wer vom Gelde des Sündopfers oder vom Gelde des Schuldopfers$fn40 nutznießt, muß, wenn bevor sein Sündopfer dargebracht worden ist, [den Betrag] ergänzen und sein Sündopfer darbringen, bevor sein Schuldopfer dargebracht worden ist, [den Betrag] ergänzen und sein Schuldopfer darbringen. Ist sein Sündopfer bereits dargebracht worden, so ist es$fn41in das Salzmeer zu werfen; ist sein Schuldopfer bereits dargebracht worden, so fällt es der freiwilligen Spendenkasse zu. 
Meilah 9b:8	Wenn jemand Hochheiliges vor dem Blutsprengen oder Opferteile von Minderheiligem nach dem Blutsprengen nutznießt, so fällt das, was er genossen$fn38hat, der freiwilligen Spendenkasse zu. Alle Opfer für den Altar$fn42fallen dem Altar zu, Opfer für den Tempelreparaturfonds fallen dem Tempelreparaturfonds zu, und Gemeindeopfer fallen der Gemeinde zu. 
Meilah 9b:9	Dies widerspricht sich ja selbst; [es heißt:] wenn bevor sein Sündopfer dargebracht worden ist, [den Betrag] ergänzen und sein Sündopfer darbringen; ist sein Sündopfer bereits dargebracht worden, so ist es in das Salzmeer zu werfen; darauf aber lehrt er: alle Opfer für den Altar fallen dem Altar zu, einerlei ob der Eigentümer bereits Sühne erlangt hat oder er noch keine Sühne erlangt hat!? – 
Meilah 9b:10	Der Anfangsatz ist nach R. Šimo͑n, welcher sagt, das Sündopfer, dessen Eigentümer Sühne erlangt$fn43hat, sei verenden zu lassen. – 
Meilah 10a:1	Der Anfangsatz nach R. Šimo͑n und der Schlußsatz nach den Rahbanan!? R. Gebiha aus Be-Kethil sprach zu R. Aši: [Freilich,] so sagte Abajje: der Anfangsatz nach R. Šimo͑n und der Schlußsatz nach den Rabbanan.
Meilah 10a:2	Raba sagte: Alle stimmen überein, daß, wenn jemand Fleisch von unrein gewordenem Hochheiligen vor dem Sprengen, oder Opferteile von [unrein gewordenem] Minderheiligen nach dem Sprengen nießbraucht hat, er frei sei. – 
Meilah 10a:3	Selbstverständlich, er hat ja keinen Schaden angerichtet$fn44!? – 
Meilah 10a:4	Man könnte glauben, beim unrein gewordenen Fleisch vom Hochheiligen besteht ja ein Gebot für die Priester, es zu verbrennen, bei den Opferteilen vom Minderheiligen besteht ja ein Gebot, sie mit der Gabel umzuwenden$fn45, so lehrt er uns, daß dem nicht so ist.
Meilah 10a:5	Raba sagte: Das, was du sagst, wenn das Sündopfer bereits geschlachtet worden ist, sei [das Geld] in das Salzmeer zu werfen, gilt nur von dem Falle, wenn er sich$fn46vor der Sühne bewußt wird, wenn aber nach der Sühne, fällt es der freiwilligen Spendenkasse zu, denn man sondert es nicht von vornherein zur Vernichtung ab$fn47.
Meilah 10a:6	<sup>ix</sup><b>B</b><small>EIM</small> H<small>ALFEN</small>$fn27, <small>DEM</small> W<small>EIHRAUCH, DEM</small> R<small>ÄUCHERWERK, DEM</small> S<small>PEISOPFER DER</small> P<small>RIESTER, DEM</small> S<small>PEISOPFER DES GESALBTEN</small> P<small>RIESTERS UND DEM</small> S<small>PEISOPFER ZUM</small> G<small>USSOPFER GIBT ES EINE</small> V<small>ERUNTREUUNG, SOBALD SIE GEHEILIGT WORDEN SIND; 
Meilah 10a:7	SIND SIE IM</small> [D<small>IENST]GEFÄSSE GEHEILIGT WORDEN, SO SIND SIE UNTAUGLICH ZU WERDEN GEEIGNET [DURCH</small> B<small>ERÜHRUNG</small>] <small>MIT EINEM, DER AM SELBEN</small> T<small>AGE UNTERGETAUCHT IST ODER DEM DIE</small> S<small>ÜHNE NOCH FEHLT, UND DURCH DAS</small> Ü<small>BERNACHTEN; MAN IST IHRETWEGEN SCHULDIG WEGEN</small> Ü<small>BRIGGEBLIEBENEM UND</small> U<small>NREINEM</small>, V<small>ERWERFLICHES ABER GIBT ES BEI IHNEN NICHT</small>. 
Meilah 10a:8	D<small>IE</small> R<small>EGEL HIERBEI IST: BEI ALLEM, WOBEI ES EIN</small> E<small>RLAUBTMACHENDES</small>$fn48<small>GIBT, IST MAN WEGEN</small> V<small>ERWERFLICHEM</small>, Ü<small>BRIGGEBLIEBENEM UND</small> U<small>NREINEM NICHT EHER SCHULDIG, 
Meilah 10a:9	ALS BIS DAS</small> E<small>RLAUBTMACHENDE DARGEBRACHT WORDEN IST, UND BEI ALLEM, WOBEI ES KEIN</small> E<small>RLAUBTMACHENDES</small>$fn49<small>GIBT, IST MAN SCHULDIG WEGEN</small> Ü<small>BRIGGEBLIEBENEM UND</small> U<small>NREINEM, SOBALD ES IM</small> [D<small>IENST</small>]<small>GEFÄSSE GEHEILIGT WORDEN IST</small>, V<small>ERWERFLICHES ABER GIBT ES DABEI NICHT</small>.
Meilah 10b:1	GEMARA. Woher dies? – Die Rabbanan lehrten: Man könnte glauben, man sei wegen des Unreinen schuldig nur bei einer Sache, bei der es ein Erlaubtmachendes gibt, 
Meilah 10b:2	und dies wäre auch durch einen Schluß zu folgern: wenn man wegen des Verwerflichen, wobei nur ein einmaliges Bewußtwerden$fn50erforderlich$fn51, das Opfer festgesetzt$fn52, und das nicht aus der Allgemeinheit heraus erlaubt worden ist, nur dann schuldig ist, wenn es durch anderes erlaubt wird, 
Meilah 10b:3	um wieviel mehr ist man wegen des Unreinen, wobei ein zweimaliges Bewußtwerden$fn53erforderlich, das Opfer ein auf- und absteigendes$fn54, und das aus der Allgemeinheit heraus erlaubt worden$fn55ist, nur dann schuldig, wenn es durch anderes erlaubt wird. 
Meilah 10b:4	Daher heißt es:$fn56<i>sprich zu ihnen: Für eure Geschlechter: jeder, der von all eurem Samen nahet &amp;c.</i>; die Schrift spricht von allen Opfern. Man könnte glauben, man sei wegen dieser sofort schuldig, so heißt es: <i>der nahet</i>$fn57. 
Meilah 10b:5	R. Elea͑zar erklärte: Ist man denn nur wegen des Berührens$fn58schuldig? Vielmehr, wie folgt: wird es durch anderes erlaubt, so ist man schuldig, erst wenn das Erlaubtmachende dargebracht worden ist, und wird es nicht durch anderes erlaubt, so ist man schuldig, erst wenn es durch das [Dienst]gefäß geheiligt worden ist$fn59.
Meilah 10b:6	
Meilah 10b:7	<sup>i</sup><b>D</b><small>AS</small> J<small>UNGE EINES</small> S<small>ÜNDOPFERS, DAS</small> E<small>INGETAUSCHTE EINES</small> S<small>ÜNDOPFERS UND DAS</small> S<small>ÜNDOPFER, DESSEN</small> E<small>IGENTÜMER GESTORBEN IST, SIND VERENDEN ZU LASSEN</small>. 
Meilah 10b:8	D<small>AS DAS</small> J<small>AHR</small>$fn1 <small>ÜBERSCHRITTEN HAT, DAS ABHANDEN GEKOMMEN WAR UND GEBRECHENBEHAFTET SICH EINFINDET, IST, WENN DER</small> E<small>IGENTÜMER BEREITS</small> S<small>ÜHNE ERLANGT HAT, VERENDEN ZU LASSEN, AUCH KANN ES NICHT UMGETAUSCHT WERDEN, UND MAN DARF ES NICHT NUTZNIESSEN, JEDOCH GIBT ES DABEI KEINE</small> V<small>ERUNTREUUNG; 
Meilah 11a:1	HAT DER</small> E<small>IGENTÜMER</small> <small>NOCH KEINE</small> S<small>ÜHNE ERLANGT, SO IST ES WEIDEN ZU LASSEN, BIS ES EIN</small> G<small>EBRECHEN BEKOMMT, SODANN ZU VERKAUFEN UND FÜR DEN</small> E<small>RLÖS EIN ANDERES ZU KAUFEN, AUCH KANN ES UMGETAUSCHT WERDEN, UND ES GIBT DABEI EINE</small> V<small>ERUNTREUUNG</small>.
Meilah 11a:2	GEMARA. Welchen Unterschied gibt es zwischen dem Anfangsatze, wobei er keinen Unterschied$fn2 macht, und dem Schlußsatze, wobei er einen Unterschied macht? – 
Meilah 11a:3	Im Anfangsatze ist dies$fn3 ausgemacht, im Schlußsatze ist dies nicht ausgemacht. – 
Meilah 11a:4	Dies lehrte er ja bereits [im Traktate vom] Umtausch$fn4!? – Da lehrt er es wegen des Falles vom Umtausch, hier lehrt er es wegen des Falles von der Veruntreuung.
Meilah 11a:5	<sup>ii</sup><b>W</b><small>ENN JEMAND</small> G<small>ELD FÜR SEIN</small> N<small>AZIROPFER ABGESONDERT HAT, SO DARF MAN ES NICHT NUTZNIESSEN, JEDOCH GIBT ES DABEI KEINE</small> V<small>ERUNTREUUNG, WEIL JEDE</small> [<small>EINZELNE</small> M<small>ÜNZE</small>] <small>FÜR</small> H<small>EILSOPFER</small>$fn5 <small>VERWENDET WERDEN KANN</small>. 
Meilah 11a:6	W<small>ENN ER GESTORBEN IST UND</small> G<small>ELD OHNE</small> B<small>ESTIMMUNG HINTERLASSEN HAT, SO FÄLLT ES DER FREIWILLIGEN</small> S<small>PENDENKASSE ZU; WENN</small> G<small>ELD MIT</small> B<small>ESTIMMUNG, SO IST DAS</small> G<small>ELD FÜR DAS</small> S<small>ÜNDOPFER IN DAS</small> S<small>ALZMEER ZU WERFEN UND MAN DARF ES NICHT NUTZNIESSEN, JEDOCH GIBT ES DABEI KEINE</small> V<small>ERUNTREUUNG, 
Meilah 11a:7	FÜR DAS</small> G<small>ELD FÜR DAS</small> B<small>RANDOPFER IST EIN</small> B<small>RAISDOPFER ZU BRINGEN, UND ES GIBT DABEI EINE</small> V<small>ERUNTREUUNG, UND FÜR DAS</small> G<small>ELD FÜR DAS</small> H<small>EILSOPFER IST EIN</small> H<small>EILSOPFER ZU BRINGEN, DAS EINEN</small> T<small>AG ZU ESSEN IST UND DES</small> B<small>ROTES</small>$fn6 <small>NICHT BENÖTIGT</small>.
Meilah 11a:8	GEMARA. Reš Laqiš wandte ein: Sollte er auch den Fall lehren, wenn jemand Geld für ein Taubenpaar abgesondert hat, 
Meilah 11a:9	das man nicht nutznießen darf, wobei es jedoch keine Veruntreuung gibt, weil man dafür Turteltauben, die das Alter noch nicht erlangt haben, oder junge Tauben, die das Alter überschritten haben, bringen kann$fn7!? 
Meilah 11a:10	Raba erwiderte: Die Tora sagt, daß man für Geld ohne Bestimmung Heilsopfer bringe, aber sagt etwa die Tora, daß man dafür Turteltauben, die das Alter noch nicht erlangt haben, bringe, die für den Altar ungeeignet sind!?
Meilah 11a:11	<sup>iii</sup><b>R.</b> Š<small>IMO͑N SAGTE</small>: B<small>EIM</small> B<small>LUTE IST ES ANFANGS LEICHTER UND SPÄTER STRENGER, BEIM</small> G<small>USSOPFER ABER IST ES ANFANGS STRENGER UND SPÄTER LEICHTER</small>. 
Meilah 11a:12	B<small>EIM</small> B<small>LUTE GIBT ES ANFANGS KEINE</small> V<small>ERUNTREUUNG, KOMMT ES IN DEN</small> B<small>ACH</small> Q<small>IDRON, SO GIBT ES DABEI EINE</small> V<small>ERUNTREUUNG; BEIM</small> G<small>USSOPFER GIBT ES ANFANGS EINE</small> V<small>ERUNTREUUNG, KOMMT ES IN DEN</small> A<small>BFLUSSKANAL, SO GIBT ES DABEI KEINE</small> V<small>ERUNTREUUNG</small>.
Meilah 11a:13	GEMARA. Die Rabbanan lehrten: Beim Blute gibt es eine Veruntreuung – so R. Meír und R. Šimo͑n; die Weisen sagen, es gebe dabei keine Veruntreuung. 
Meilah 11a:14	Was ist der Grund desjenigen, welcher sagt, es gebe dabei keine Veruntreuung? U͑la erwiderte: Die Schrift sagt:$fn8<i>ich habe es euch gegeben,</i> es ist eures. In der Schule R. Jišma͑éls wurde gelehrt: $fn8<i>Zu sühnen,</i> ich habe es zur Sühne gegeben, nicht aber zur Veruntreuung. 
Meilah 11a:15	R. Joḥanan erklärte: Die Schrift sagt: $fn8<i>denn das Blut mit der Seele entsühnt es,</i> vor der Sühne wie nach der Sühne; wie es dabei nach der Sühne keine Veruntreuung gibt, ebenso gibt es dabei vor der Sühne keine Veruntreuung. – 
Meilah 11a:16	Vielleicht aber: wie es dabei vor der Sühne eine Veruntreuung$fn9 gibt, ebenso gibt es dabei eine Veruntreuung nach der Sühne!? – 
Meilah 11a:17	Gibt es denn etwas, wobei es eine Veruntreuung gibt, nachdem damit das Gebot ausgeübt worden ist!? – Wieso denn nicht, 
Meilah 11b:1	dies ist ja bei der Abhebung der Asche$fn10der Fall: damit ist das Gebot ausgeübt worden, dennoch gibt es dabei eine Veruntreuung!? – 
Meilah 11b:2	Von der Abhebung der Asche und den Gliedern des fortzuschickenden Bockes$fn11lehren zwei Schriftverse dasselbe$fn12, und wenn zwei Schriftverse dasselbe lehren, so ist von diesen nicht [auf anderes] zu folgern. – 
Meilah 11b:3	Allerdings nach demjenigen, welcher sagt, man dürfe von den Gliedern des fortzuschickenden Bockes nicht nutznießen, wie ist es aber nach demjenigen zu erklären, welcher sagt, man dürfe von diesen nutznießen!? – 
Meilah 11b:4	Von der Abhebung der Asche und von den Priestergewändern$fn13 lehren zwei Schriftverse dasselbe, und wenn zwei Schriftverse dasselbe lehren, so ist von diesen nicht [auf anderes] zu folgern. – 
Meilah 11b:5	Allerdings nach den Rabbanan, welche erklären:$fn14<i>er lege sie da nieder,</i> dies lehre, daß sie verwahrt werden müssen, 
Meilah 11b:6	wie ist es aber nach R. Dosa zu erklären, welcher sagt, ein gemeiner Priester dürfe sie benutzen!? – 
Meilah 11b:7	Von der Abhebung der Asche und dem genickbrochenen Kalbe$fn15lehren zwei Schriftverse dasselbe. – 
Meilah 11b:8	Allerdings nach demjenigen, welcher sagt, es sei nicht zu folgern, wie ist es aber nach demjenigen zu erklären, welcher sagt, es sei wohl zu folgern!? – 
Meilah 11b:9	Es sind zwei Ausschließungen vorhanden; da$fn16heißt es: <i>dem das Genick gebrochen wurde,</i> 
Meilah 11b:10	und dort$fn17heißt es: <i>er tue sie neben den Altar;</i> nur diese$fn18, andere aber nicht.
Meilah 11b:11	B<small>EIM</small> G<small>USSOPFER GIBT ES ANFANGS EINE</small> V<small>ERUNTREUUNG &amp;C</small>. Es wäre anzunehmen, daß unsere Mišna nicht die Ansicht des R. Elea͑zar b. R. Çadoq vertritt, 
Meilah 11b:12	denn es wird gelehrt: R. Elea͑zar b. R. Çadoq sagte: Zwischen der Rampe und dem Altar, an der Westseite der Rampe, war ein kleiner Schacht, und einmal in siebzig Jahren pflegten die Priesterjünglinge da hinabzusteigen, den gleich getrockneten Feigen geronnenen Wein heraufzuholen und ihn in Heiligkeit zu verbrennen, denn es heißt:$fn19<i>in Heiligkeit ist das Rauschtrank-Gaßopfer dem Herrn zu gießen</i>; wie das Gießen in Heiligkeit, ebenso das Verbrennen in Heiligkeit. – 
Meilah 11b:13	Wieso geht dies hieraus hervor? Rabina erwiderte: Dies ist durch [das Wort] <i>Heiligkeit</i> zu folgern; hier heißt es <i>in Heiligkeit</i> und dort$fn20heißt es: <i>du sollst das übrige im Feuer verbrennen, es darf nicht gegessen werden, denn es ist heilig;</i> 
Meilah 11b:14	wie das Verbrennen des Übriggebliebenen in Heiligkeit zu erfolgen hat, ebenso auch dies in Heiligkeit. – 
Meilah 11b:15	Du kannst auch sagen, die des R. Elea͑zar b. R. Çadoq, wenn man ihn nämlich aufgefangen$fn21hat. 
Meilah 11b:16	Manche lesen: Es wäre anzunehmen, daß unsere Mišna die Ansicht des R. Elea͑zar b. R. Çadoq vertritt$fn22. – Auch wenn man ihn aufgefangen$fn23hat, 
Meilah 11b:17	sagen sie,. es gebe keine [Veruntreuung], wohl aber rabbanitisch. – Er beruft sich ja aber auf einen Schriftvers!? – Dies ist nur eine Anlehnung.
Meilah 11b:18	<sup>iv,1</sup><b>B</b><small>EI DER</small> E<small>NTASCHUNG DES INNEREN</small> A<small>LTARS UND DES</small> L<small>EUCHTERS DARF MAN DAVON NICHT NUTZNIESSEN, AUCH GIBT ES DABEI KEINE</small> V<small>ERUNTREUUNG</small>. W<small>ENN JEMAND DIE</small> E<small>NTASCHUNG</small>$fn24<small>GEWEIHT HAT, SO GIBT ES DABEI VORHER</small>$fn25 <small>EINE</small> V<small>ERUNTREUUNG</small>. V<small>ON DEN</small> T<small>URTELTAUBEN, DIE DAS</small> A<small>LTER NOCH NICHT ERREICHT HABEN, UND DEN JUNGEN</small> T<small>AUBEN, DIE DAS</small> A<small>LTER ÜBERSCHRITTEN HABEN, DARF MAN NICHT NUTZNIESSEN, JEDOCH GIBT ES BEI IHNEN KEINE</small> V<small>ERUNTREUUNG</small>.
Meilah 11b:19	GEMARA. Erklärlich 
Meilah 12a:1	ist dies vom äußeren Altar, denn bei diesem heißt es: <i>er tue sie neben den Altar,</i> woher dies aber vom inneren Altar? 
Meilah 12a:2	R. Elea͑zar erwiderte: Die Schrift sagt:$fn26<i>er entferne den Kropf samt dem Unrat,</i> und da dies$fn27nicht auf den äußeren Altar zu beziehen$fn28ist, so beziehe man es auf den inneren Altar. – 
Meilah 12a:3	Vielleicht ist beides auf den äußeren Altar zu beziehen, und dies gibt nur die Stelle$fn29an!? – 
Meilah 12a:4	Demnach sollte die Schrift nur gesagt haben: <i>neben den Altar,</i> wenn es aber noch$fn17<i>die Asche</i> heißt, so besagt dies, daß dies auch vom inneren Altar gilt. – 
Meilah 12a:5	Woher dies von der Leuchte? – Aus <i>Asche, die</i>$fn30<i>Asche.</i>
Meilah 12a:6	<sup>iv,2</sup> <b>R.</b> Š<small>IMO͑N SAGTE</small>: B<small>EI DEN</small> T<small>URTELTAUBEN, DIE DAS</small> A<small>LTER NOCH NICHT ERREICHT HABEN, GIBT ES EINE</small> V<small>ERUNTREUUNG; VON DEN JUNGEN</small> T<small>AUBEN, DIE DAS</small> A<small>LTER ÜBERSCHRITTEN HABEN, DARF MAN NICHT NUTZMESSEN, JEDOCH GIBT ES BEI IHNEN KEINE</small> V<small>ERUNTREUUNG</small>.
Meilah 12a:7	GEMARA. Erklärlich ist die Ansicht R. Šimo͑ns, dessen Grund gelehrt wird, denn R. Šimo͑n sagte, wenn es nach einer Zeit geeignet ist und man es innerhalb der Zeit geheiligt hat, so übertrete man das Verbot, jedoch sei es nicht mit der Ausrottung belegt, 
Meilah 12a:8	womit ist es aber nach den Rabbanan bei diesen anders als bei dem, dem das Alter noch fehlt$fn31!? – 
Meilah 12a:9	Ich will dir sagen, bei dem, dem das Alter noch fehlt, verhält es sich ebenso, wie bei einem Gebrechenbehafteten, das ausgelöst werden kann, beim Geflügel aber, das durch ein Gebrechen nicht untauglich wird, gibt es auch keine Auslösung.
Meilah 12a:10	U͑la sagte im Namen R. Joḥanans: Sind Opfertiere verendet, so unterliegen sie nach der Tora nicht mehr der Veruntreuung. 
Meilah 12a:11	Als U͑la saß und diese Lehre vortrug, sprach R. Ḥisda zu ihm: Wer wird auf dich und auf deinen Lehrer R. Joḥanan hören: wo sollte denn die ihnen anhaftende Heiligkeit hingekommen sein!? 
Meilah 12a:12	Jener erwiderte: Dieser Einwand ist ja auch gegen unsere Mišna zu richten: von den Turteltauben, die das Alter noch nicht erreicht haben, und von den jungen Tauben, die das Alter überschritten haben, darf man nicht nutznießen, jedoch gibt es bei ihnen keine Veruntreuung; wo sollte denn auch hierbei die ihnen anhaftende Heiligkeit hingekommen sein!? 
Meilah 12a:13	Dieser entgegnete: Ich pflichte dir bei, daß es rabbanitisch dabei eine Veruntreuung gebe, und habe einzuwenden: gibt es denn etwas, wobei es anfangs$fn32keine Veruntreuung gibt, später aber eine Veruntreuung gibt!? – 
Meilah 12a:14	Etwa nicht, dies ist ja beim Blute$fn33der Fall: anfangs gibt es dabei keine Veruntreuung, später aber gibt es dabei eine» Veruntreuung!? Wir haben nämlich gelernt: Beim Blute gibt es anfangs keine Veruntreuung, kommt es in den Bach Qidron, so gibt es dabei eine Veruntreuung. – 
Meilah 12a:15	Ich will dir sagen, dabei gibt es auch anfangs eine Veruntreuung, 
Meilah 12b:1	denn Rabh sagte, wenn man einem Opfertiere zur Ader läßt, sei [das Blut] zur Nutznießung verboten und es gebe dabei eine Veruntreuung.
Meilah 12b:2	Der Text. R. Hona sagte im Namen Rabhs: Wenn man einem Opfertiere zur Ader läßt, so ist [das Blut] zur Nutznießung verboten und es gibt dabei eine Veruntreuung. R. Hamnuna wandte ein: Von der Milch der Opfertiere und den Eiern [geheiligter] Turteltauben darf man nicht nutznießen, jedoch gibt es bei ihnen keine Veruntreuung!? 
Meilah 12b:3	Dieser erwiderte: Wir sagen es nur vom Blute, denn ohne Blut kann [das Vieh] nicht bestehen, nicht aber von der Milch, denn es kann auch ohne Milch bestehen. 
Meilah 12b:4	R. Mešaršeja wandte ein: Vom Dünger und vom Kote$fn34, die im Hofe, darf man nicht nutznießen, jedoch gibt es dabei keine Veruntreuung. 
Meilah 12b:5	Weshalb denn, es kann ja auch ohne Kot nicht bestehen$fn35!? – Ich will dir sagen, der Kot kommt von auswärts$fn36, und wenn dieser abgeht, kommt anderer, das Blut aber kommt von seinem Körper. – 
Meilah 12b:6	Er lehrt, man dürfe davon nicht nutznießen, jedoch gebe es dabei keine Veruntreuung. Dies ist eine Stütze für R. Elea͑zar, denn R. Elea͑zar sagte: Überall, wo die Weisen gesagt haben, es sei heilig und nicht [ganz] heilig, fällt der Erlös der Tempelkasse zu$fn37.
Meilah 12b:7	<sup>v</sup> <b>V</b><small>ON DER</small> M<small>ILCH DER</small> O<small>PFERTIERE UND DEN</small> E<small>IERN</small> [<small>GEHEILIGTER</small>] T<small>URTELTAUBEN DARF MAN NICHT NUTZNIESSEN, JEDOCH GIBT ES BEI IHNEN KEINE</small> V<small>ERUNTREUUNG</small>. 
Meilah 12b:8	D<small>IES GILT NUR VON</small> H<small>EILIGTÜMERN FÜR DEN</small> A<small>LTAR, BEI</small> H<small>EILIGTÜMERN FÜR DEN</small> T<small>EMPELREPARATURFONDS ABER GIBT ES, WENN MAN EINE</small> H<small>ENNE GEWEIHT HAT, EINE</small> V<small>ERUNTREUUNG BEI DIESER UND BEI IHREM</small> E<small>I, WENN EINE</small> E<small>SELIN, EINE</small> V<small>ERUNTREUUNG BEI DIESER UND IHRER</small> M<small>ILCH</small>.
Meilah 12b:9	GEMARA. Demnach$fn38gibt es beim Geheiligten für den Altar, wenn man seinen Geldwert geweiht hat, keine Veruntreuung!? 
Meilah 12b:10	R. Papa erwiderte: Die Mišna ist lückenhaft und muß wie folgt lauten: dies gilt nur von dem Falle, wenn man es körperlich für den Altar geweiht hat, wenn man aber seinen Geldwert für den Altar geweiht hat, so ist es ebenso, als hätte man es für den Tempelreparaturfonds geweiht; hat man eine Henne geweiht, so gibt es eine Veruntreuung bei dieser und bei ihrem Ei, wenn eine Eselin, so gibt es eine Veruntreuung bei dieser und bei ihrer Milch.
Meilah 12b:11	<sup>vi</sup><b>B</b><small>EI ALLEM, WAS FÜR DEN</small> A<small>LTAR GEEIGNET IST 
Meilah 13a:1	UND NICHT FÜR DEN</small> T<small>EMPELREPARATURFONDS, FÜR DEN</small> T<small>EMPELREPARATURFONDS UND NICHT FÜR DEN</small> A<small>LTAR, WEDER FÜR DEN</small> A<small>LTAR NOCH FÜR DEN</small> T<small>EMPELREPARATURFONDS, GIBT ES EINE</small> V<small>ERUNTREUUNG</small>. Z<small>UM</small> B<small>EISPIEL: 
Meilah 13a:2	HAT JEMAND EINE</small> Z<small>ISTERNE VOLL</small> W<small>ASSER, EINEN</small> M<small>ISTHAUFEN VOLL</small> D<small>ÜNGER, EINEN</small> T<small>AUBENSCHLAG VOLL</small> T<small>AUBEN, 
Meilah 13a:3	EINEN</small> B<small>AUM VOLL</small> F<small>RÜCHTE, ODER EIN</small> F<small>ELD VOLL</small> G<small>EWÄCHSE GEWEIHT, 
Meilah 13a:4	SO GIBT ES EINE</small> V<small>ERUNTREUUNG BEI DIESEN UND BEI DEM, WAS</small> D<small>ARINNEN; 
Meilah 13a:5	WENN MAN ABER EINE</small> Z<small>ISTERNE GEWEIHT HAT, UND SIE NACHHER MIT</small> W<small>ASSER GEFÜLLT WURDE, EINEN</small> M<small>ISTHAUFEN, UND ER NACHHER MIT</small> D<small>ÜNGER GEFÜLLT WURDE, EINEN</small> T<small>AUBENSCHLAG, UND ER NACHHER MIT</small> T<small>AUBEN GEFÜLLT WURDE, EINEN</small> B<small>AUM, UND ER NACHHER VOLL</small> F<small>RÜCHTE WURDE, ODER EIN</small> F<small>ELD, UND ES NACHHER VOLL</small> G<small>EWÄCHSE WURDE, SO GIBT ES EINE</small> V<small>ERUNTREUUNG BEI IHNEN SELBST, NICHT ABER BEI DEM, WAS IN IHNEN</small>$fn39. 
Meilah 13a:6	R. J<small>OSE SAGTE</small>: W<small>ENN JEMAND EIN</small> F<small>ELD ODER EINEN</small> B<small>AUM GEWEIHT HAT, SO GIBT ES EINE</small> V<small>ERUNTREUUNG BEI DIESEN SELBST UND BEI IHREN</small> E<small>RZEUGNISSEN, WEIL SIE</small> E<small>RZEUGNISSE DES</small> G<small>EHEILIGTEN</small>$fn40 <small>SIND</small>. 
Meilah 13a:7	D<small>AS</small> J<small>UNGE VOM</small> [V<small>IEH</small>]<small>ZEHNTEN</small>$fn41<small>DARF NICHT VOM</small> [V<small>IEH</small>]<small>ZEHNTEN SAUGEN</small>; <small>MANCHE ABER SPENDEN SO</small>$fn42. D<small>AS</small> J<small>UNGE VON</small> O<small>PFERTIEREN DARF NICHT VON</small> O<small>PFERTIEREN SAUGEN; MANCHE ABER SPENDEN SO</small>. 
Meilah 13a:8	D<small>IE</small> L<small>OHNARBEITER DÜRFEN VON DEN</small> D<small>ÖRRFEIGEN DES</small> H<small>EILIGTUMS NICHT ESSEN, EBENSO</small> [<small>NICHT</small>] <small>DIE</small> [<small>DRESCHENDE</small>] K<small>UH VON DEN</small> W<small>ICKEN DES</small> H<small>EILIGTUMS</small>.
Meilah 13a:9	GEMARA. Er lehrt, das Junge vom [Vieh]zehnten dürfe nicht vom [Vieh]zehnten saugen. Woher dies? 
Meilah 13a:10	R. Aḥadboj b. Ami erwiderte: Dies ist durch [den Ausdruck] <i>vorübergehen</i> vom Erstgeborenen$fn43zu folgern: wie es beim Erstgeborenen eine Veruntreuung gibt, ebenso gibt es eine Veruntreuung bei der Milch des [Vieh]zehnten. 
Meilah 13a:11	Desgleichen ist es hinsichtlich der Milch von den Opfertieren durch [das Wort] <i>Mutter</i>$fn44vom Erstgeborenen zu folgern.
Meilah 13a:12	D<small>IE</small> L<small>OHNARBEITER DÜRFEN &amp;C. NICHT ESSEN</small>. Aus welchem Grunde? R. Aḥadboj b. Ami erwiderte: Die Schrift sagt:$fn45<i>du sollst einem Ochsen beim Dreschen das Maul nicht schließen,</i> beim Dreschen für dich$fn46, nicht aber beim Dreschen für das Heiligtum. 
Meilah 13a:13	Wer Hülsenfrüchte auf einem Felde des Heiligtums drischt, begeht eine Veruntreuung. – Dies gilt ja nur von Gepflücktem$fn47!? Rabina erwiderte: Hieraus ist somit zu entnehmen, daß dabei der Staub$fn48zuträglich ist.
Meilah 13b:1	<sup>vii</sup><b>W</b><small>ENN DIE</small> W<small>URZELN EINES</small> B<small>AUMES EINES</small> G<small>EMEINEN IN DAS</small> [G<small>EBIET</small>] <small>DES</small> H<small>EILIGTUMS ODER EINES DES</small> H<small>EILIGTUMS IN DAS</small> [G<small>EBIET</small>] <small>EINES</small> G<small>EMEINEN HINEINRAGEN, SO DARF MAN SIE NICHT NUTZNIESSEN, JEDOCH GIBT ES BEI IHNEN KEINE</small> V<small>ERUNTREUUNG</small>. V<small>ON EINER QUELLE, DIE AUS EINEM</small> F<small>ELDE DES</small> H<small>EILIGTUMS AUSGEHT, DARF MAN NICHT NUTZNIESSEN, JEDOCH GIBT ES DABEI KEINE</small> V<small>ERUNTREUUNG; GELANGT SIE AUSSERHALB DES</small> F<small>ELDES, SO DARF MAN DAVON NUTZNIESSEN</small>. 
Meilah 13b:2	V<small>OM WASSER IM GOLDENEN</small> K<small>RUGE</small>$fn49 <small>DARF MAN NICHT NUTZNIESSEN, JEDOCH GIBT ES DABEI KEINE</small> V<small>ERUNTREUUNG</small>; <small>HAT MAN ES IN DIE</small> F<small>LASCHE</small>$fn50<small>GETAN, SO GIBT ES DABEI EINE</small> V<small>ERUNTREUUNG</small>. 
Meilah 13b:3	V<small>ON DER</small> B<small>ACHWEIDE</small>$fn51<small>DARF MAN NICHT NUTZNIESSEN, JEDOCH GIBT ES DABEI KEINE</small> V<small>ERUNTREUUNG</small>. R. E<small>LEA͑ZAR B.</small> R. Ç<small>ADOQ SAGTE</small>: B<small>EI DEN</small> A<small>LTEN WAR ES</small> B<small>RAUCH, DAVON IN IHRE</small> F<small>ESTSTRÄUSSE ZU TUN</small>.
Meilah 13b:4	GEMARA. Reš Laqiš sagte: Es gibt keine Veruntreuung beim ganzen, wohl aber gibt es dabei eine Veruntreuung, wenn es drei Log$fn52sind. – 
Meilah 13b:5	Er lehrt ja aber im Schlußsatze, daß, wenn man es in die Flasche getan hat, es dabei eine Veruntreuung gebe, wonach es im Anfangsatze auch bei drei Log keine gibt!? – 
Meilah 13b:6	Vielmehr, ist dies gelehrt worden, so bezieht es sich auf den Schlußsatz: so gibt es dabei eine Veruntreuung; hierzu sagte Reš Laqiš: Es gibt dabei eine Veruntreuung, nur bei drei Log. 
Meilah 13b:7	R. Joḥanan sagt, es gebe eine Veruntreuung beim ganzen. – Demnach$fn53ist Reš Laqiš der Ansicht, für das Wasser sei ein Quantum festgesetzt, und [dem wider-sprechend] haben wir gelernt: 
Meilah 13b:8	R. Elea͑zar$fn54sagt, wer am Hüttenfeste das für das Hüttenfest bestimmte Wasser außerhalb$fn55gießt, sei schuldig$fn56. Hierzu sagte R. Joḥanan im Namen des Menaḥem aus Jotapata, R. Elea͑zar habe es nach der Ansicht R. A͑qibas gesagt, der [das Wort] <i>ihre Gußopfer</i>$fn57auslegt: das Wassergießen und das Weingießen. 
Meilah 13b:9	Und hierzu sagte Reš Laqiš: Demnach sollte doch, wie beim Weine$fn58drei Log erforderlich sind, auch beim Wasser drei Log erforderlich sein!? Reš Laqiš ist somit der Ansicht, für das Wasser sei kein Quantum festgesetzt!? – Er sagte es nach der Ansicht des Menaḥem aus Jotapata.
Meilah 13b:10	<sup>viii,1</sup> <b>V</b><small>ON EINEM</small> N<small>ESTE AM</small> W<small>IPFEL EINES</small> B<small>AUMES DES</small> H<small>EILIGTUMS DARF MAN NICHT NUTZNIESSEN, JEDOCH GIBT ES DABEI KEINE</small> V<small>ERUNTREUUNG</small>. D<small>AS AUF EINER</small> A<small>ŠERA DARF MAN MIT EINER</small> S<small>TANGE HERUNTERSCHLAGEN</small>$fn59. H<small>AT JEMAND EINEN</small> W<small>ALD GEWEIHT, SO GIBT ES EINE</small> V<small>ERUNTREUUNG BEI ALLEM</small>$fn60.
Meilah 14a:1	GEMARA. Es wurde gelehrt: Wenn ein Götze von selber zerbrochen ist, so ist er$fn61, wie R. Joḥanan sagt, verboten, und wie Reš Laqiš sagt, erlaubt. 
Meilah 14a:2	R. Joḥanan sagt, er sei verboten, weil der Nichtjude ihn nicht entheiligt$fn62hat, und Reš Laqiš sagt, er sei erlaubt, denn dieser denkt: er kann sich selbst nicht schützen, wie sollte er mich schützen. 
Meilah 14a:3	Reš Laqiš wandle gegen R. Joḥanan ein: Von einem Neste am Wipfel eines Baumes des Heiligtums darf man nicht nutznießen, jedoch gibt es dabei keine Veruntreuung. Das auf einer Ašera darf man mit einer Stange herunterschlagen. 
Meilah 14a:4	Doch wohl, wenn er von diesem selber abgebrochen$fn63hat, und er lehrt, daß man es mit einer Stange herunterschlagen darf!? – Nein, wenn er Holz von anderwärts geholt hat. – 
Meilah 14a:5	Wieso darf man demnach, wenn von dem des Heiligtums, davon nicht nutznießen (und gibt es dabei keine Veruntreuung)!? – 
Meilah 14a:6	Vielmehr, dies gilt vom Zuwachs nach [der Heiligung], und er ist der Ansicht, beim Zuwachs gebe es keine Veruntreuung. – 
Meilah 14a:7	Dies ist auch einleuchtend, denn wozu braucht man, wenn du sagen wolltest, wenn er es von anderwärts geholt hat, es mit der Stange herunter zu schlagen, man kann es ja$fn64herunternehmen!? 
Meilah 14a:8	R. Abahu erwiderte im Namen R. Joḥanans: Talsächlich, wenn er es von anderwärts geholt hat, und unter herunterschlagen ist zu verstehen, die Jungen herunterschlagen. 
Meilah 14a:9	R. Ja͑qob sprach zu R. Jirmeja: Die Jungen sind von diesem und von jenem$fn65erlaubt, die Eier sind von diesem und Von jenem verboten. R. Aši sprach: Benötigen die Jungen noch der Mutter, so gleichen sie Eiern.
Meilah 14a:10	<sup>viii,2</sup><b>W</b><small>ENN DIE</small> S<small>CHATZMEISTER</small>$fn66H<small>OLZ GEKAUFT HABEN, SO GIBT ES EINE</small> V<small>ERUNTREUUNG BEIM</small> H<small>OLZE, NICHT ABER BEI DEN</small> H<small>OBELSPÄNEN UND NICHT BEIM</small> L<small>AUBE</small>.
Meilah 14a:11	GEMARA. Šemuél sagte: Man baute$fn67profan$fn68und heiligte es nachher. – 
Meilah 14a:12	Aus welchem Grunde? – Wer Geld spendet, heiligt$fn69es. Daher spreche er$fn70: die Heiligkeit des Geldes werde auf das Bauwerk übertragen, 
Meilah 14a:13	und er gebe es den Werkmeistern als Lohn. 
Meilah 14b:1	Man wandte ein: Wofür verwandte man den Überschuß$fn71des Räucherwerkes? Man reservierte ihn als Lohn für die Werkmeister. 
Meilah 14b:2	Man weihte ihn aus durch das Geld für die Werkmeister und gab ihn den Werkmeistern, sodann kaufte man ihn von diesen zurück [für Geld] von der neuen Hebe$fn72. 
Meilah 14b:3	Weshalb denn, man sollte ihn ja durch Bauarbeiten ausweihen!? – 
Meilah 14b:4	Wenn keine Bauarbeiten da sind. – Er spricht ja vom Gelde für die Werkmeister!? – Wenn keine Bauarbeiten entsprechend dem Gelde da sind. – 
Meilah 14b:5	Šemuél sagte ja aber, wenn man Heiliges im Werte einer Mine durch den Wert einer Peruta ausgeweiht hat, sei die Ausweihung gültig!? – Dies nur, wenn bereits geschehen, von vornherein aber nicht. 
Meilah 14b:6	R. Papa erklärte: Folgendes ist der Grund, weshalb man profan baute: die Tora ist nicht für die Dienstengel$fn73gegeben worden. Es kann nämlich vorkommen, daß jemand sich anlehnen will und sich daran$fn74lehnt, und wenn man heilig baut, ergibt es sich, daß man dadurch eine Veruntreuung am Geheiligten begeht. – 
Meilah 14b:7	Wir haben gelernt: Wenn die Schatzmeister Holz gekauft haben, so gibt es eine Veruntreuung [beim Holze], nicht aber bei den Hobelspänen und nicht beim Laube. 
Meilah 14b:8	Weshalb gibt es dabei eine Veruntreuung, man sollte doch profan [bauen]!? – Ich will dir sagen, wenn jemand sich daran$fn74lehnt, ergibt es sich, daß er eine Veruntreuung am Geheiligten begeht. 
Meilah 14b:9	R. Papa erwiderte: Beim Holze für später ist dem auch so, unsere Mišna aber spricht vom Holze für denselben Tag$fn75.
Meilah 14b:10	
Meilah 15a:1	<sup>i</sup><b>H</b><small>EILIGTÜMER FÜR DEIN</small> A<small>LTAR WERDEN MITEINANDER VEREINIGT</small>$fn1 <small>HINSICHTLICH DER</small> V<small>ERUNTREUUNG UND UM SCHULDIG ZU SEIN WEGEN</small> V<small>ERWERFLICHEM</small>, Ü<small>BRIGGEBLIEBENEM UND</small> U<small>NREINEM</small>; H<small>EILIGTÜMER FÜR DEN</small> T<small>EMPELREPARATURFONDS WERDEN MIT EINANDER VEREINIGT</small>; H<small>EILIGTÜMER FÜR DEN</small> A<small>LTAR UND</small> H<small>EILIGTÜMER FÜR DEN</small> T<small>EMPELREPARATURFONDS WERDEN MIT EINANDER VEREINIGT HINSICHTLICH DER</small> V<small>ERUNTREUUNG</small>.
Meilah 15a:2	GEMARA. Wenn sogar, wie er lehrt, Heiligtümer für den Altar und Heiligtümer für den Tempelreparaturfonds miteinander vereinigt werden, von denen doch das eine körperlich und das andere nur in seinem Geldwerte heilig ist, um wieviel mehr Heiligtümer für den Altar mit Heiligtümern für den Altar!? – 
Meilah 15a:3	Weil er hierzu lehren will, um schuldig zu sein wegen Verwerflichem, Übriggebliebenem und Unreinem, die bei Heiligtümern für den Tempelreparaturfonds nicht vorkommen; daher teilt er es.
Meilah 15a:4	R. Jannaj sagte: Es ist klar, daß man wegen Veruntreuung schuldig ist nur wegen des Heiligen für den Tempelreparaturfonds und des Brandopfers, denn die Schrift sagt: $fn2<i>wenn jemand eine Veruntreuung begeht an den Heiligtümern des Herrn,</i> 
Meilah 15a:5	nur bei Heiligtümern, die für den Herrn allein bestimmt sind, gibt es eine Veruntreuung, an den Heiligtümern für den Altar aber sind auch die Priester und auch die Eigentümer beteiligt. – 
Meilah 15a:6	Wir haben gelernt: Heiligtümer für den Altar werden mit einander vereinigt hinsichtlich der Veruntreuung!? – Rabbani tisch. – 
Meilah 15a:7	Bei Hochheiligem, das man an der Südseite geschlachtet hat, gibt es ja eine Veruntreuung!? – Rabbanitisch. – 
Meilah 15a:8	Wir haben gelernt: Wer von einem Sündopfer nießbraucht, begeht, wenn es lebend ist, eine Veruntreuung, erst wenn er [den Wert] mindert, und wenn es tot ist, eine Veruntreuung, sobald er einen Nutzen hat!? – Rabbanitisch. – 
Meilah 15a:9	Etwa nicht nach der Tora, es wird ja gelehrt: Rabbi sagte:$fn3<i>Alles Fett für den Herrn,</i> dies schließt die Opferteile der minderheiligen Opfer ein hinsichtlich der Veruntreuung!? – 
Meilah 15a:10	Rabbanitisch. – Er bezieht sich ja auf einen Schriftvers!? – Dies ist nur eine Anlehnung. – 
Meilah 15a:11	U͑la sagte ja aber im Namen R. Joḥanans, daß, wenn Opfertiere verendet sind, sie nach der Tora nicht mehr der Veruntreuung unterliegen. Wovon gilt dies: wollte man sagen, von Heiligem für den Tempelreparaturfonds, so bleiben sie es$fn4 ja, auch wenn sie verenden, denn, auch wenn man dem Heiligtume einen Misthaufen weiht, gibt es dabei eine Veruntreuung; 
Meilah 15a:12	doch wohl Heiliges für den Altar, und bei diesem gibt es ja nach der Tora keine Veruntreuung$fn5!? – 
Meilah 15a:13	Vielmehr, in der Schule R. Jannajs erklärten sie wie folgt: Aus diesem Schriftverse$fn6 ist dies nur hinsichtlich des Heiligen für den Tempelreparaturfonds zu entnehmen, hinsichtlich des Heiligen für den Altar aber ist es nicht zu entnehmen.
Meilah 15b:1	<sup>ii,1</sup><b>F</b><small>ÜNF</small> D<small>INGE WERDEN BEIM</small> B<small>RANDOPFER MITEINANDER VEREINIGT</small>$fn7: <small>DAS</small> F<small>LEISCH, DAS</small> F<small>ETT, DAS</small> M<small>EHL</small>$fn8, <small>DER</small> W<small>EIN UND DAS ÖL</small>. S<small>ECHS BEIM</small> D<small>ANKOPFER: DAS</small> F<small>LEISCH, DAS</small> F<small>ETT, DAS</small> M<small>EHL, DER</small> W<small>EIN, DAS</small> Ö<small>L UND DAS</small> B<small>ROT</small>.
Meilah 15b:2	GEMARA. R. Hona lehrte Raba$fn9: Fünf Dinge in der Welt$fn10werden miteinander vereinigt. Da sprach dieser: Du sagst: in der Welt, er lehrt es aber vom Dankopfer, beim Dankopfer seien es sechs Dinge, das Fleisch, das Fett, das Mehl, der Wein, das Öl und die Brote des Dankopfers!? (Jener erwiderte:) Lies vielmehr beim Brandopfer.
Meilah 15b:3	Wir lernen also das, was die Rabbanan gelehrt haben: Das Brandopfer und seine Opferteile werden miteinander zur Olivengröße vereinigt hinsichtlich der Darbringung außerhalb, und um schuldig zu sein wegen Verwerflichem, Übriggebliebenem und Unreinem. 
Meilah 15b:4	Er lehrt dies also nur vom Brandopfer und nicht vom Heilsopfer. Einleuchtend ist dies von der Darbringung außerhalb, denn beim Brandopfer, das ein Ganzopfer$fn11ist, werden sie vereinigt, beim Heilsopfer aber werden sie nicht vereinigt, weshalb aber nicht beim Heilsopfer, um wegen Verwerflichem, Übriggebliebenem und Unreinem schuldig zu sein,
Meilah 15b:5	wir haben ja gelernt: alles Verwerfliche wird miteinander vereinigt, alles Übriggebliebene wird miteinander vereinigt!? – 
Meilah 15b:6	Lies vielmehr: das Brandopfer und seine Opferteile werden miteinander zur Olivengröße vereinigt, um daraufhin das Blut zu sprengen, 
Meilah 15b:7	und da man daraufhin das Blut sprenge, ist man schuldig &amp;c. – 
Meilah 15b:8	Wer lehrte dies? – Es ist R. Jehošua͑, denn es wird gelehrt. R. Jehošua͑ sagte: Wenn von einem aller in der Tora genannten Schlachtopfer ein olivengroßes Stück Fleisch oder ein olivengroßes Stück Talg zurückbleibt, so sprenge man das Blut, wenn eine halbe Olive Fleisch und eine halbe Olive Fett, so sprenge man das Blut nicht; 
Meilah 15b:9	beim Brandopfer aber sprenge man das Blut, auch wenn eine halbe Olive Fleisch und eine halbe Olive Fett, weil es ein Ganzopfer$fn11ist. Auf das Speisopfer hin sprenge man nicht, auch wenn es vollständig vorhanden ist. – 
Meilah 15b:10	Was hat das Speisopfer damit$fn12zu tun? R. Papa erwiderte: Das Speisopfer zum Gußopfer$fn13.
Meilah 15b:11	<sup>ii,2</sup>D<small>IE</small> H<small>EBE, DIE</small> Z<small>EHNTHEBE, DIE</small> Z<small>EHNTHEBE VOM</small> D<small>EMAJ, DIE</small> T<small>EIGHEBE UND DIE</small> E<small>RSTLINGE WERDEN MITEINANDER VEREINIGT, UM ANDERES</small>$fn14 VERBOTEN$fn15<small>ZU MACHEN, UND ZUR</small> V<small>ERPFLICHTUNG ZUM</small> F<small>ÜNFTEL</small>$fn16. <sup>iii,1</sup>A<small>LLES</small> V<small>ERWERFLICHE WIRD MITEINANDER VEREINIGT, ALLES</small> Ü<small>BRIGGEBLIEBENE WIRD MITEINANDER VEREINIGT</small>.
Meilah 15b:12	GEMARA. Aus welchem Grunde? – Sie alle heißen Hebe. Von der Teighebe heißt es:$fn17<i>als Erstes eurer Backmulden erhebet einen Kuchen als Hebe.</i> 
Meilah 15b:13	Die Erstlinge heißen ebenfalls Hebe, denn es wird gelehrt: $fn18<i>Und die Hebe deiner Hand,</i> das sind die Erstlinge. Und von den anderen ist weiter nichts nötig$fn19.
Meilah 15b:14	<sup>iii,2</sup><b>A</b><small>LLE</small> Ä<small>SER WERDEN MITEINANDER VEREINIGT</small>$fn7, <small>ALLE</small> E<small>KELTIERE WERDEN MITEINANDER VEREINIGT</small>.
Meilah 15b:15	GEMARA. Rabh sagte: 
Meilah 16a:1	Sie lehrten dies$fn20nur hinsichtlich der Unreinheit, hinsichtlich [der Strafbarkeit] wegen des Essens aber reine besonders und unreine besonders. Levi sagte, sie werden auch hinsichtlich des Essens vereinigt. 
Meilah 16a:2	R. Asi sagte, die reinen besonders und die unreinen besonders. Manche sagen, er streite gegen. Rabh, und manche sagen, er streite nicht$fn21 gegen ihn. 
Meilah 16a:3	Man wandte ein: Der Tod einer Kuh und das Leben eines Kamels$fn22werden miteinander nicht vereinigt$fn23. Demnach wird der Tod beider$fn24vereinigt, und dies ist ein Einwand gegen R. Asi!? – 
Meilah 16a:4	Sage: aber das Leben beider$fn25wird vereinigt. Dies nach R. Jehuda, welcher sagt, das Verbot eines Gliedes vom Lebenden habe Geltung auch beim unreinen Vieh$fn26. – 
Meilah 16a:5	Wozu lehrt er dies, wenn demnach der Tod beider nicht vereinigt wird, vom Tode einer Kuh und dem Leben eines Esels, auch der Tod beider wird ja nicht vereinigt!? 
Meilah 16a:6	Ferner wird gelehrt: eine halbe Olive von einer lebenden Kuh und eine halbe Olive von einem toten Kamel werden nicht vereinigt, aber eine halbe Olive von einer Kuh und eine halbe Olive von einem Kamel, beide lebend oder beide tot, werden vereinigt. Da nun ein Widerspruch zwischen dem Anfangsatze$fn27und dem Schlußsatze besteht, so ist hieraus zu entnehmen, daß, wenn beide tot, sie vereinigt werden!? – 
Meilah 16a:7	R. Asi kann dir erwidern: dieser Autor ist der Ansicht, ein Verbot erstrecke sich auf Verbotenes$fn28.
Meilah 16b:1	R. Jehuda sagte im Namen Rabhs: Die Geißelung wegen Essens von Kriechtieren erfolgt bei Olivengröße$fn29, denn bei diesen wird [der Ausdruck] ‘essen’$fn30gebraucht. – 
Meilah 16b:2	R. Jose b. R. Ḥanina lehrte ja aber vor R. Joḥanan:$fn31<i>Ihr sollt zwischen dem reinen Vieh und dem unreinen unterscheiden, zwischen dem unreinen Vogel und dem reinen, daß ihr eure Seelen nicht beekelt durch Vieh und Geflügel und alles, was auf dem Erdboden sich regt, das ich euch als unrein ausgesondert habe;</i> die Schrift beginnt mit dem Essen$fn32und schließt mit der Unreinheit, 
Meilah 16b:3	[um zu lehren:] wie die Unreinheit bei Linsengröße, ebenso das Essen bei Linsengröße. Und R. Joḥanan lobte ihn. Dies ist ja ein Einwand gegen Rabh!? – 
Meilah 16b:4	Das ist kein Einwand; eines gilt von toten$fn33und eines gilt von lebenden. 
Meilah 16b:5	Abajje sprach zu ihm: Er bezieht sich ja auf unsere Mišna, und unsere Mišna spricht ja von allen Kriechtieren, auch von toten, (und$fn34nicht ein wenig von diesen und ein wenig von jenen)!? R. Joseph erwiderte ihm: Das$fn35ist deine Bezugnahme. 
Meilah 16b:6	Rabh trug eine unahhängige Lehre vor, und R. Joḥanan lohte ihn. Man wandte ein: Bei [ganzen] Gliedern$fn36gibt es kein festgesetztes Quantum$fn37; auch weniger als eine Olive vom Aase und weniger als eine Linse vom Kriechtiere sind verunreinigend. Hierzu sagte R. Joḥanan, zu geißeln sei dieserhalb nur bei Olivengröße. 
Meilah 16b:7	Raba erwiderte: Die Schrift spricht von den ausgesonderten$fn38. 
Meilah 16b:8	R. Ada b. Ahaba sprach zu Raba: Demnach sollte auch beim Vieh$fn39zwischen ausgesondert und nicht ausgesondert$fn40unterschieden werden!? 
Meilah 17a:1	Dieser erwiderte: Der Allbarmherzige vergleicht sie$fn41nur miteinander hinsichtlich des Verbotes, sich durch diese zu beekeln$fn42, nicht aber hinsichtlich des Quantums.
Meilah 17a:2	<sup>iii,3</sup> <b>D</b><small>AS</small> B<small>LUT EINES</small> K<small>RIECHTIERES UND SEIN</small> F<small>LEISCH WERDEN MITEINAN DER</small>$fn43<small>VEREINIGT</small>. R. J<small>EHOŠUA͑ SAGTE EINE</small> R<small>EGEL: GLEICHEN SIE EINANDER HINSICHTLICH DER</small> U<small>NREINHEIT</small>$fn44<small>UND DES</small> Q<small>UANTUMS</small>$fn45, <small>SO WERDEN SIE MITEINANDER VEREINIGT, 
Meilah 17a:3	WENN HINSICHTLICH DER</small> U<small>NREINHEIT UND NICHT HINSICHTLICH DES</small> Q<small>UANTUMS, HINSICHTLICH DES</small> Q<small>UANTUMS UND NICHT HINSICHTLICH DER</small> U<small>NREINHEIT, ODER WEDER HINSICHTLICH DER</small> U<small>NREINHEIT NOCH HINSICHTLICH DES</small> Q<small>UANTUMS, SO WERDEN SIE NICHT MITEINANDER VEREINIGT</small>.
Meilah 17a:4	GEMARA. R. Ḥanin sagte im Namen Rabhs: Mit diesen$fn46zusammen. 
Meilah 17a:5	R.Jose b. R. Ḥanina wandte ein:$fn47 <i>Die unrein sind,</i> dies lehrt, daß sie miteinander vereinigt werden, auch ein Kriechtier mit einem Kriechtiere, ein Kriechtier mit Blut, ob eines Namens oder zweier Namen$fn48!? 
Meilah 17a:6	R.Joseph erwiderte: Das ist kein Einwand; eines gilt vom ganzen und eines gilt von Teilen$fn49. – 
Meilah 17a:7	Woher entnimmst du dies? – Es wird gelehrt: Wenn es$fn50auf den Estrich ausgeschüttet worden und die Stelle abschüssig$fn51ist, so ist er, wenn er einen Teil bezeltet, rein, und wenn alles, unrein. 
Meilah 17a:8	Was heißt nun einen Teil: wollte man sagen, einen Teil des Blutes, so sagte ja R. Ḥanina im Namen Rabbis, wer ein Viertellog Blut umgerührt$fn52hat, sei rein. 
Meilah 17a:9	Vielmehr gilt eines von einer ganzen [Leiche] und eines von einem Teile$fn53. Schließe hieraus.
Meilah 17a:10	R. Mathja b. Ḥereš fragte R. Šimo͑n b. Joḥaj in Rom: Woher, daß das Blut der Kriechtiere unrein ist? Dieser erwiderte: Die Schrift sagt: $fn54<i>dies sei euch unrein</i>$fn55. 
Meilah 17a:11	Seine Schüler sprachen zu ihm: Der Sohn Joḥajs kam ihm klug$fn56. Da sprach er zu ihnen: Es ist eine offenkundige Lehre aus dem Munde des R. Elea͑zar b. R. Jose. Einst verhängte nämlich die ruchlose Regierung eine Religionsverfolgung, den Sabbath nicht zu halten, die Söhne nicht zu beschneiden und Menstruierenden beizuwohnen. 
Meilah 17a:12	Da ging (R.) Reuben b. Istrobili und ließ sich das Haar qomi$fn57schneiden$fn58, sodann setzte er sich zu ihnen und sprach: Wünscht, wer einen Feind hat, daß dieser arm werde, oder daß er reich werde? Sie erwiderten ihm: Daß er arm werde. Da sprach er zu ihnen: So mögen sie am Sabbath keine Arbeit verrichten, damit sie verarmen. Da sprachen sie: Du hast recht. Hierauf sprach er: So möge man [die Verordnung] aufheben. Und sie hoben sie auf. 
Meilah 17a:13	Alsdann sprach er zu ihnen: Wünscht, wer einen Feind hat, daß dieser abmagere, oder daß er kräftig werde? Sie erwiderten ihm: Daß er abmagere. Da sprach er zu ihnen: So mögen sie ihre Kinder mit acht Tagen beschneiden, damit sie abmagern. Da sprachen sie: Du hast recht. Hierauf sprach er [dasselbe], und sie hoben es auf. 
Meilah 17a:14	Alsdann sprach er zu ihnen: Wünscht, wer einen Feind hat, daß dieser sich vermehre, oder daß er sich vermindere? Sie erwiderten ihm: Daß er sich vermindere. – Wenn dem so ist, so lasset sie keiner Menstruierenden beiwohnen$fn59. Da sprachen sie: Du hast recht. Hierauf sprach er [dasselbe], und sie hoben es auf. 
Meilah 17a:15	Als sie aber später merkten, daß er Jude sei, widerriefen sie es. Hierauf sprachen sie: Wer soll nun gehen und die Verhängnisse vereiteln? 
Meilah 17b:1	Möge R. Šimo͑n b. Joḥaj gehen, der an Wunder gewöhnt$fn60ist. – Wer soll nach ihm$fn61gehen? – R. Elea͑zar b. R. Jose. 
Meilah 17b:2	Da sprach R. Jose$fn62zu ihnen: Würdet ihr, wenn mein Vater Ḥalaphta gelebt hätte, zu ihm gesagt haben: Gib deinen Sohn zur Hinrichtung hin? Hierauf sprach R. Šimo͑n zu ihnen$fn63: Würdet ihr, wenn mein Vater Joḥaj gelebt hätte, zu ihm gesagt haben: Gib deinen Sohn zur Hinrichtung hin? 
Meilah 17b:3	Da sprach R.Jose zu ihnen: Ich will gehen, denn ich fürchte nur, R. Šimo͑n könnte Strafe über ihn bringen$fn64. Da nahm er es auf sich, keine Strafe über ihn zu bringen. Aber dennoch brachte er über ihn eine Strafe. 
Meilah 17b:4	Als sie unterwegs waren, wurde ihnen folgende Frage vorgetragen: Woher, daß das Blut eines Kriechtieres unrein ist? Da verzog R. Elea͑zar b. R. Jose den Mund$fn65und sprach: <i>Dies sei euch unrein</i>$fn55. Da sprach R. Šimo͑n zu ihm: Aus dem Verziehen deines Mundes ist zu erkennen, daß du ein Gelehrter bist; doch mag der Sohn nicht zu seinem Vater [in Frieden] zurückkehren. 
Meilah 17b:5	Hierauf kam ihnen Ben Tamaljon$fn66entgegen [und sprach zu ihnen:] Wollt ihr, daß ich mit euch$fn67gehe? Da weinte R. Šimo͑n und sprach: Einer Magd im Hause meiner Vorfahren$fn68gesellte sich ein Engel dreimal, mir aber nicht ein einziges Mal! Mag aber das Wunder geschehen, woher es auch kommt. 
Meilah 17b:6	Jener aber ging voraus und fuhr in die Tochter des Kaisers$fn69. Als er da hinkam$fn70, sprach er: Hinaus, Ben Tamaljon. hinaus, Ben Tamaljon! Und als er ihm dies zurief, verließ er sie und ging fort. Hierauf sprach [der Kaiser] zu ihnen: Verlanget von mir, was ihr wollt. Alsdann führte man sie in die Schatzkammer, um nach Belieben zu nehmen, und als sie jene Urkunde$fn71fanden, nahmen sie sie und zerrissen sie. 
Meilah 17b:7	Das ist es, was R. Elea͑zar b. R. Jose sagte: Ich sah ihn$fn72in Rom und es waren an ihm viele Tropfen Blut$fn73.
Meilah 17b:8	<sup>iv,1</sup>V<small>ERWERFLICHES UND</small> Ü<small>BRIGGEBLIEBENES WERDEN MITEINANDER NICHT VEREINIGT, WEIL ES VERSCHIEDENE</small> N<small>AMEN SIND</small>. K<small>RIECHTIER UND</small> A<small>AS, EBENSO</small> A<small>AS UND</small> F<small>LEISCH VON EINER</small> L<small>EICHE WERDEN MITEINANDER NICHT ZUM VERUNREINIGUNGSFÄHIGEN</small> [Q<small>UANTUM</small>] <small>VEREINIGT, NICHT EINMAL WIE DAS LEICHTERE UNTER IHNEN</small>$fn74.
Meilah 17b:9	GEMARA. R. Jehuda sagte im Namen Šemuéls: Dies gilt nur von der Unreinheit der Hände, die rabbanitisch$fn75ist, hinsichtlich des Essens aber werden sie vereinigt. Es wird nämlich gelehrt: R. Elie͑zer sagte:$fn76<i>Es darf nicht gegessen werden, denn sie sind</i>$fn77<i>heilig</i>; alles, was vom Heiligen untauglich ist, und die Schrift belegt das Essen mit einem Verbote.
Meilah 17b:10	<sup>iv,2</sup><b>E</b><small>INE</small> S<small>PEISE, DIE DURCH EINE</small> H<small>AUPTUNREINHEIT</small>$fn78<small>UNREIN GEWORDEN IST</small>, <small>UND EINE, DIE DURCH EINE ABSTAMMENDE</small> U<small>NREINHEIT</small>$fn78<small>UNREIN GEWORDEN IST, WERDEN MITEINANDER VEREINIGT, UM WIE DIE LEICHTERE VON BEIDEN ZU VERUNREINIGEN</small>. <sup>v</sup>A<small>LLE</small> S<small>PEISEN WERDEN MITEINANDER VEREINIGT, UM IM</small> Q<small>UANTUM EINES HALBEN</small> P<small>ERAS DEN</small> K<small>ÖRPER UNTAUGLICH</small>$fn79<small>ZU MACHEN, 
Meilah 17b:11	ZU EINER</small> S<small>PEISE FÜR ZWEI</small> M<small>AHLZEITEN FÜR EINEN</small> E͑<small>RUB, ZUM</small> Q<small>UANTUM EINES</small> E<small>IES HINSICHTLICH DER</small> V<small>ERUNREINIGUNGSFÄHIGKEIT</small>$fn80<small>VON</small> S<small>PEISEN, ZUM</small> Q<small>UANTUM EINER</small> D<small>ÖRRFEIGE HINSICHTLICH DES</small> H<small>INAUSBRINGENS AM</small> S<small>ABBATH</small>$fn81, <small>UND ZUM</small> Q<small>UANTUM EINER</small> D<small>ATTEL HINSICHTLICH DES</small> V<small>ERSÖHNUNGSTAGES</small>$fn82. A<small>LLE</small> G<small>ETRÄNKE WERDEN MITEINANDER VEREINIGT, UM IM</small> Q<small>UANTUM EINES</small> V<small>IERTEL[LOGS] DEN</small> K<small>ÖRPER UNTAUGLICH</small>$fn79<small>ZU MACHEN UND ZU EINEM</small> M<small>UNDVOLL HINSICHTLICH DES</small> V<small>ERSÖHNUNGSTAGES</small>$fn82.
Meilah 17b:12	GEMARA. Es wird gelehrt: R.Šimo͑n sagte: Aus dem Grunde$fn83, weil die zweitgradige [Unreinheit] erstgradig machen kann. – Kann denn die zweitgradige erstgradig machen, dies ist ja nicht möglich$fn84!? 
Meilah 17b:13	Raba erwiderte: Er meint es wie folgt: die erstgradige ist es, die zweitgradig gemacht hat. R. Aši erklärte: Die erstgradige und die zweitgradige gehören der drittgradigen gegenüber zur selben Klasse$fn85.
Meilah 18a:1	<sup>vi,1</sup><b>U</b><small>NGEWEIHTES UND</small> M<small>ISCHSAAT (DES</small> W<small>EINBERGES</small>) <small>WERDEN MITEINANDER</small> <small>VEREINIGT</small>$fn86. R. Š<small>IMO͑N SAGT, SIE WERDEN NICHT MITEINANDER VEREINIGT</small>.
Meilah 18a:2	GEMARA. Ist denn nach R. Šimo͑n eine Vereinigung überhaupt erforderlich, es wird ja gelehrt: R.Šimo͑n sagt, jedes Quantum hinsichtlich der Geißelung$fn87!? – Lies: sie brauchen nicht vereinigt zu werden.
Meilah 18a:3	<sup>vi,2</sup><b>K</b><small>LEIDERSTOFF UND</small> S<small>ACKSTOFF</small>$fn88, S<small>ACKSTOFF UND</small> L<small>EDER</small>, L<small>EDER UND</small> M<small>ATTE WERDEN ALLE MITEINANDER VEREINIGT</small>$fn89. 
Meilah 18a:4	R. Š<small>IMO͑N SAGTE</small>: A<small>US DEM</small> G<small>RUNDE, WEIL SIE ZUR</small> V<small>ERUNREINIGUNG ALS</small> S<small>ITZ</small>$fn90<small>GEEIGNET SIND</small>.
Meilah 18a:5	GEMARA. Es wird gelehrt: Wenn man sie alle zusammengesetzt und daraus ein Gewand gemacht hat; als Lager$fn91drei [Handbreiten], als Sitz$fn92eine Handbreite, zum Anfassen$fn92jede Größe. – 
Meilah 18a:6	Was heißt zum Anfassen? Reš Laqiš erwiderte im Namen Jannajs: Es beim Spinnen zu benutzen$fn93. In einer Barajtha wird gelehrt: Es ist für Feigenschneider zu verwenden$fn94.
Meilah 18a:7	
Meilah 18a:8	sup>i</sup><b>W</b><small>ER VON</small> H<small>EILIGEM IM</small> W<small>ERTE EINER</small> P<small>ERUṬTA NIESSBRAUCHT HAT, HAT EINE</small> V<small>ERUNTREUUNG BEGANGEN, AUCH WENN ER ES</small>$fn1 <small>NICHT GEMINDERT HAT</small> – <small>SO</small> R. A͑<small>QIBA</small>. D<small>IE</small> W<small>EISEN SAGEN, BEI JEDER</small> S<small>ACHE, BEI DER</small>$fn2 <small>EINE</small> M<small>INDERUNG ZU ERFOLGEN PFLEGT, BEGEHT MAN EINE</small> V<small>ERUNTREUUNG, ERST WENN MAN SIE GEMINDERT HAT, UND BEI DER KEINE</small> M<small>INDERUNG ZU ERFOLGEN PFLEGT, BEGEHT MAN EINE</small> V<small>ERUNTREUUNG, SOBALD MAN EINEN</small> N<small>UTZEN HAT</small>. 
Meilah 18a:9	 Z<small>UM</small> B<small>EISPIEL: LEGT</small> [<small>EINE</small> F<small>RAU</small>] <small>EINE</small> H<small>ALSKETTE UM DEN</small> H<small>ALS, EINEN</small> R<small>ING AN DIE</small> H<small>AND, ODER TRINKT SIE AUS EINEM GOLDENEN BECHER, SO BEGEHT SIE EINE VERUNTREUUNG, SOBALD SIE EINEN</small> N<small>UTZEN HAT; ZIEHT JEMAND EIN</small> H<small>EMD AN, HÜLLT ER SICH IN EIN</small> O<small>BERGEWAND, SPALTET ER MIT EINER AXT, SO BEGEHT ER EINE VERUNTREUUNG ERST WENN ER ES GEMINDERT HAT</small>.
Meilah 18a:10	W<small>ER VON EINEM</small> S<small>ÜNDOPFER NIESSBRAUCHT, BEGEHT, WENN ES EIN LEBENDES IST, EINE</small> V<small>ERUNTREUUNG, ERST WENN ER ES MINDERT, UND WENN ES EIN TOTES IST, EINE</small> V<small>ERUNTREUUNG, SOBALD ER EINEN NUTZEN HAT</small>.
Meilah 18a:11	GEMARA. Es wird gelehrt: R. A͑qiba pflichtet den Weisen bei, bei einer Sache, bei der eine Minderung zu erfolgen pflegt. – Worin besteht demnach ihr Streit? 
Meilah 18a:12	Raba erwiderte: Über ein Zwischengewand$fn3 und ein Linnengewand$fn4.
Meilah 18a:13	Die Rabbanan lehrten: $fn5<i>Eine Person,</i> sowohl ein Gemeiner, als auch der Fürst, als auch der gesalbte Priester.
Meilah 18a:14	$fn5<i>Die eine Veruntreuung begeht;</i> unter ‘Veruntreuung’ ist eine Änderung$fn6 zu verstehen, wie es heißt: $fn7<i>wenn irgend jemandes Weib ausschweift und an ihm eine Untreue begeht;</i> und ferner heißt es: $fn8<i>und sie begingen Untreue an dem Gott</i> 
Meilah 18b:1	<i>ihrer Väter und buhlten den Baa͑len nach</i>$fn9. 
Meilah 18b:2	Man könnte glauben, auch wenn man [das Geheiligte] mindert und keinen Nutzen$fn10hat oder einen Nutzen hat und es nicht mindert, 
Meilah 18b:3	oder auch in dem Falle, wenn es am Boden haftet, oder auch wenn ein Vertreter seinen Auftrag$fn11ausgeführt hat, 
Meilah 18b:4	so heißt es:$fn5<i>und sündigt.</i> Bei der Hebe$fn12heißt es ‘sündigen’ und bei der Veruntreuung heißt es ‘sündigen’,
Meilah 18b:5	wie bei der Hebe, bei der es ‘sündigen’ heißt, Minderung und Nutznießung vorliegen, der Mindernde auch der Nutznießer ist, die geminderte Sache nießbraucht wird, Minderung und Nutznießung gleichzeitig erfolgen, [die Sache] vom Boden getrennt ist, und wenn der Vertreter seinen Auftrag$fn13ausführt,
Meilah 18b:6	ebenso bei der Veruntreuung, bei der es ‘sündigen’ heißt, wenn Minderung und Nutznießung vorliegen, der Mindernde auch der Nutznießer ist, die geminderte Sache nießbraucht wird, Minderung und Nutznießung gleichzeitig erfolgen, [die Sache] vom Boden getrennt ist, und wenn der Vertreter seinen Auftrag ausführt. 
Meilah 18b:7	Ich weiß dies$fn14von dem Falle, wenn man eine Speise genießt, woher dies von einer Sache, bei der keine Minderung erfolgt, woher dies von dem Falle, 
Meilah 18b:8	wenn er und sein Nächster$fn15davon essen, er und sein Nächster es nießbrauchen$fn16, er es nießbraucht und sein Nächster davon ißt, oder er davon ißt und sein Nächster es nießbraucht, daß sie miteinander vereinigt werden, und sogar nach längerer Zeit$fn17? 
Meilah 18b:9	Es heißt: <i>eine Veruntreuung begeht,</i> auf jede Weise.
Meilah 18b:10	Aber wie bei der Hebe, bei der es <i>Sünde</i> heißt, zwei Essen$fn18nicht miteinander vereinigt werden, ebenso sollten bei der Veruntreuung, bei der es <i>Sünde</i> heißt, zwei Essen nicht vereinigt werden, woher dies nun von dem Falle, wenn jemand heute gegessen hat und morgen gegessen hat, und sogar nach längerer Zeit? Es heißt: <i>eine Veruntreuung begeht,</i> auf jede Weise. 
Meilah 18b:11	Aber bei der Hebe, bei der es <i>Sünde</i> heißt, erfolgen ja die Minderung und der Genuß gleichzeitig, woher dies von dem Falle, wenn er davon gegessen hat und sein Nächster davon gegessen hat, und sogar nach drei Jahren? Es heißt: <i>eine Veruntreuung begeht,</i> auf jede Weise. 
Meilah 18b:12	Aber bei der Hebe, bei der es <i>Sünde</i> heißt, 
Meilah 19a:1	erfolgt dies ja nur dann, wenn es aus dem Heiligtume in Profanbesitz$fn19kommt,
Meilah 19a:2	woher dies von dem Falle, wenn es aus dem Heiligtume in das Heiligtum kommt, wenn man beispielsweise für [Geld vom] Heiligen die Taubenpaare für männliche oder weibliche Flußbehaftete$fn20oder die Taubenpaare für Wöchnerinnen$fn21gekauft, 
Meilah 19a:3	seinen Šeqel$fn22entrichtet oder sein Sündopfer oder sein Schuldopfer gebracht hat, wobei man eine Veruntreuung begeht, wie R. Šimo͑n sagt, sobald man [das Geld] ausgegeben hat, und wie R. Jehuda sagt, wenn man das Blut gesprengt hat? Es heißt: <i>eine Veruntreuung begeht,</i> auf jede Weise.
Meilah 19a:4	Der Meister sagte: <i>Eine Person,</i> sowohl ein Gemeiner, als auch der Fürst, als auch der gesalbte Priester.Wieso könnte man dies$fn23glauben, es ist ja selbstverständlich, denn hierbei heißt es ja <i>eine Person</i>!? – 
Meilah 19a:5	Man könnte dies glauben, weil der Allbarmherzige sagt:$fn24<i>und wer davon auf einen Gemeinen tut,</i> und dieser ist kein Gemeiner, denn er ist ja damit$fn25 gesalbt worden, so lehrt er uns. 
Meilah 19a:6	Der Allbarmherzige hat nämlich [die Veruntreuung] mit der Ehebruchsverdächtigten, mit dem Götzendienste und mit der Hebe$fn26verglichen. Bei der Ehebruchsverdächtigten gilt [das Gesetz] auch dann, wenn keine Minderung erfolgt$fn27ist. Desgleichen beim Geheiligten, denn [eine Frau] begeht eine Veruntreuung, wenn sie nur einen Ring an ihre Hand gelegt hat. 
Meilah 19a:7	Ferner vergleicht sie der Allbarmherzige mit dem Götzendienste; wie dabei eine Änderung$fn28erfolgt, ebenso beim Geheiligten, wenn man [beispielsweise] mit einer Axt gespalten und sie gemindert hat. 
Meilah 19a:8	Und ferner vergleicht sie der Allbarmherzige mit der Hebe, wie es bei der Hebe heißt:$fn29<i>wenn jemand ißt,</i> nicht aber beschädigt, ebenso ist man beim Geheiligten frei, wenn man Eßbares beschädigt.
Meilah 19a:9	Z<small>UM</small> B<small>EISPIEL</small>: <small>LEGT</small> [<small>EINE</small> F<small>RAU</small>] <small>EINE</small> H<small>ALSKETTE &amp;C</small>. R. Kahana sprach zu R. Zebid: Erfolgt denn beim Golde$fn2 keine Minderung, wo ist denn das Gold der Schwiegertochter Nuns$fn30hingekommen!?
Meilah 19a:10	Dieser erwiderte: Vielleicht ist es das Gold, das deine Schwiegertöchter umherwerfen$fn31. Ferner: zugegeben, daß nicht Nutznießung und Minderung sofort erfolgen, aber erfolgt etwa nicht eine Minderung später$fn32!?
Meilah 19a:11	V<small>ON EINEM</small> S<small>ÜNDOPFER NIESSBRAUCHT &amp;C</small>. Merke, ist es ein fehlerfreies Vieh, so ist es ja der Fall vom goldenen Becher$fn33!? R. Papa erwiderte: Dies gilt von einem fehlerbehafteten$fn34.
Meilah 19b:1	<sup>ii</sup><b>W</b><small>ER</small>$fn35<small>EINE HALBE</small> P<small>ERUṬA MISSBRAUCHT UND UM EINE HALBE</small> P<small>ERUṬA</small> [<small>DEN</small> W<small>ERT</small>] <small>GEMINDERT HAT, ODER EINE</small> S<small>ACHE</small>$fn36<small>IM</small> W<small>ERTE EINER</small> P<small>ERUṬA NIESSBRAUCHT</small>$fn37<small>UND EINE ANDERE UM EINE</small> P<small>ERUṬA GEMINDERT HAT, BEGEHT EINE</small> V<small>ERUNTREUUNG NUR DANN, WENN ER VON DERSELBEN</small> S<small>ACHE EINE</small> P<small>ERUṬA NIESSBRAUCHT UND SIE UM EINE</small> P<small>ERUṬA GEMINDERT HAT</small>.
Meilah 19b:2	<sup>iii</sup>B<small>EIM</small> G<small>EHEILIGTEN GIBT ES KEINE</small> V<small>ERUNTREUUNG NACH EINER</small> V<small>ERUNTREUUNG</small>$fn38, <small>NUR BEI EINEM</small> V<small>IEH UND EINEM</small> D<small>IENSTGERÄTE</small>. Z<small>UM</small> B<small>EISPIEL</small>: W<small>ENN EINER AUF EINEM</small> V<small>IEH GERITTEN IST, DANN EIN ANDERER DARAUF GERITTEN IST, UND WIEDER EIN ANDERER DARAUF GERITTEN IST, SO HABEN ALLE EINE</small> V<small>ERUNTREUUNG BEGANGEN; WENN EINER AUS EINEM GOLDENEN</small> B<small>ECHER GETRUNKEN HAT, DANN EIN ANDERER DARAUS GETRUNKEN HAT, UND WIEDER EIN ANDERER DARAUS GETRUNKEN HAT, SO HABEN ALLE EINE</small> V<small>ERUNTREUUNG BEGANGEN; WENN EINER VON EINEM</small> S<small>ÜNDOPFER</small> [W<small>OLLE</small>] <small>GERUPFT HAT, DANN EIN ANDERER GERUPFT HAT, UND WIEDER EIN ANDERER GERUPFT HAT, SO HABEN ALLE EINE</small> V<small>ERUNTREUUNG BEGANGEN</small>. R<small>ABBI SAGT, BEI ALLEM, WOBEI ES KEINE</small> A<small>USLÆSUNG GIBT, GEBE ES EINE</small> V<small>ERUNTREUUNG NACH EINER</small> V<small>ERUNTREUUNG</small>.
Meilah 19b:3	GEMARA. Wer ist der Autor unserer Mišna? – Es ist R. Neḥemja, denn es wird gelehrt: Eine Veruntreuung nach einer Veruntreuung gibt es nur bei einem Vieh. R. Neḥemja sagt, bei einem Vieh und bei einem Dienstgeräte. – 
Meilah 19b:4	Was ist der Grund des ersten Autors? – Er ist der Ansicht, dies$fn39steht ja beim Vieh geschrieben, denn es heißt:$fn40<i>am Widder des Schuldopfers</i>. – 
Meilah 19b:5	Und R. Neḥemja!? – Er kann dir erwidern: es ist [durch einen Schluß] vom Leichteren auf das Schwerere zu folgern: wenn dadurch anderes Heiligkeit$fn41erlangt, wie sollte es nicht selber [heilig] bleiben.
Meilah 19b:6	R<small>ABBI SAGT, BEI ALLEM, WOBEI ES KEINE</small> A<small>USLÖSUNG GIBT &amp;C</small>. Das sagt ja auch der erste Autor!? Raba erwiderte: Ein Unterschied besteht zwischen ihnen beim Holze.
Meilah 19b:7	Die Rabbanan lehrten nämlich: [Sagte jemand] ‘ich spende Holz’, so gebe er nicht weniger als zwei Scheite. Rabbi sagt, die Holz[spende] gelte als Opfer und benötige des Salzes und des Schwingens$fn42. 
Meilah 19b:8	Raba sagte: Nach der Ansicht Rabbis benötigt das Holz auch des Holzes. R.Papa sagte: Nach der Ansicht Rabbis benötigt das Holz des Abhebens des Haufens$fn43. 
Meilah 19b:9	R. Papa erwiderte: Ein Unterschied besteht zwischen ihnen in dem Falle, wenn fehlerfreie Opfertiere fehlerbehaftet geworden sind, und man [das Verbot] übertreten und sie geschlachtet hat. 
Meilah 19b:10	Es wird nämlich gelehrt: Wenn fehlerfreie Opfertiere fehlerbehaftet geworden sind und man [das Verbot] übertreten und sie geschlachtet hat, so sind sie, wie Rabbi sagt, zu begraben, 
Meilah 19b:11	und wie die Weisen sagen, auszulösen$fn44.
Meilah 19b:12	<sup>iv</sup><b>H</b><small>AT JEMAND EINEN</small> S<small>TEIN ODER EINEN</small> B<small>ALKEN DES</small> H<small>EILIGTUMS GENOMFOL</small>. <small>MEN SO HAT ER KEINE</small> V<small>ERUNTREUUNG BEGANGEN; 
Meilah 20a:1	GIBT ER IHN EINEM ANDEREN, SO BEGEHT ER EINE</small> V<small>ERUNTREUUNG, DER ANDERE ABER BEGEHT KEINE</small> V<small>ERUNTREUUNG; BAUT ER IHN IN SEIN</small> H<small>AUS EIN, SO BEGEHT ER EINE</small> V<small>ERUNTREUUNG, ERST WENN ER DARUNTER IM</small> W<small>ERTE EINER</small> P<small>ERUṬA GEWOHNT HAT</small>. 
Meilah 20a:2	H<small>AT JEMAND EINE</small> P<small>ERUṬA DES</small> H<small>EILIGTUMS GENOMMEN, SO HAT ER KEINE</small> V<small>ERUNTREUUNG BEGANGEN; GIBT ER SIE EINEM ANDEREN, SO BEGEHT ER EINE</small> V<small>ERUNTREUUNG, DER ANDERE ABER BEGEHT KEINE</small> V<small>ERUNTREUUNG; GIBT ER SIE EINEM</small> B<small>ADEMEISTER, SO BEGEHT ER EINE</small> V<small>ERUNTREUUNG, AUCH WENN ER NICHT BADET, DENN DIESER SAGTE ZU IHM; DAS</small> B<small>ADEHAUS STEHT DIR OFFEN, GEH HINEIN</small>$fn45<small>UND BADE</small>. 
Meilah 20a:3	<sup>v</sup>S<small>EIN</small> E<small>SSEN UND DAS</small> E<small>SSEN SEINES</small> N<small>ÄCHSTEN, SEINE</small> N<small>UTZNIESSUNG UND DIE</small> N<small>UTZNIESSUNG SEINES</small> N<small>ÄCHSTEN, SEIN</small> E<small>SSEN UND DIE</small> N<small>UTZNIESSUNG SEINES</small> N<small>ÄCHSTEN, SEINE</small> N<small>UTZNIESSUNG UND DAS</small> E<small>SSEN SEINES</small> N<small>ÄCHSTEN WERDEN MITEINANDER VEREINIGT, SELBST NACH LANGER</small> Z<small>EIT</small>.
Meilah 20a:4	GEMARA. Welchen Unterschied gibt es zwischen ihm und seinem Nächsten? Šemuél erwiderte: Hier wird von einem Schatzmeister gesprochen, dem sie anvertraut sind$fn46. 
Meilah 20a:5	B<small>AUT ER IHN IN SEIN</small> H<small>AUS EIN, SO IST ER SCHULDIG &amp;C</small>. Warum denn, erst wenn er darin gewohnt hat, sobald er daran eine Veränderung vorgenommen hat, hat er ja eine Veruntreuung begangen!? Rabh erwiderte: Wenn er auf ihn eine Luke gelegt$fn47hat. –
Meilah 20a:6	Er begeht also eine Veruntreuung, wenn er ihn eingebaut$fn48 hat, somit ist dies eine Stütze für Rabh, denn Rabh sagte, wenn jemand ein Haus angebetet hat, habe er es verboten gemacht$fn49. –
Meilah 20a:7	R. Aḥa, Sohn des R. Iqa, erwiderte: Die den Augen sichtbare Nutznießung hat die Tora verboten$fn50. – 
Meilah 20a:8	Ihm wäre eine Stütze zu erbringen: Wer in einem Hause des Heiligtums wohnt, begeht eine Veruntreuung, sobald er davon einen Nutzen hat. Reš Laqiš erwiderte: Dies in dem Falle, wenn man es geheiligt und nachher gebaut hat$fn51. –
Meilah 20a:9	Wozu lehrt er demnach, wenn man keine Veruntreuung begeht, falls man es zuerst gebaut und nachher geheiligt hat, daß er keine Veruntreuung begehe, wenn er in einem Höhlenraume wohnt, er sollte doch lehren: wer aber in einem (Stein)hause wohnt, das man zuerst gebaut und nachher geheiligt hat, habe keine Veruntreuung begangen!? – 
Meilah 20a:10	Ich will dir sagen: jenes ist ausgemacht, dies ist nicht ausgemacht$fn52.
Meilah 20a:11	
Meilah 20a:12	<sup>i,1</sup><b>H</b><small>AT DER</small> B<small>EAUFTRAGTE SEINEM</small> A<small>UFTRAGE</small>$fn1 <small>GEMÄSS GEHANDELT, SO HAT DER</small> H<small>AUSHERR</small>$fn2 <small>DIE</small> V<small>ERUNTREUUNG BEGANGEN; HAT DER</small> B<small>EAUFTRAGTE NICHT SEINEM</small> A<small>UFTRAGE GEMÄSS GEHANDELT, SO HAT DER</small> B<small>EAUFTRAGTE DIE</small> V<small>ERUNTREUUNG BEGANGEN</small>.
Meilah 20a:13	Z<small>UM</small> B<small>EISPIEL</small>: W<small>ENN ER ZU IHM GESAGT HAT, DASS ER DEN</small> G<small>ÄSTEN FLEISCH VORSETZE, UND ER IHNEN</small> L<small>EBER VORGESETZT HAT, DASS ER IHNEN</small> L<small>EBER</small> [<small>VORSETZE</small>], <small>UND ER IHNEN</small> F<small>LEISCH VORGESETZT HAT, SO HAT DER</small> B<small>EAUFTRAGTE DIE</small> V<small>ERUNTREUUNG BEGANGEN</small>. W<small>ENN ER ZU IHM GESAGT HAT, DASS ER IHNEN JE EIN</small> S<small>TÜCK VORSETZE, DIESER ABER ZU IHNEN GESAGT HAT, DASS SIE JE ZWEI NEHMEN SOLLEN, UND SIE JE DREI GENOMMEN HABEN, SO HABEN SIE ALLE DIE</small> V<small>ERUNTREUUNG BEGANGEN</small>.
Meilah 20b:1	GEMARA. Wer ist der Autor, welcher lehrt, daß bei allem, wobei der Vertreter sich überlegen$fn3 muß, es zwei Handlungen$fn4 sind? 
Meilah 20b:2	R. Ḥisda erwiderte: Es ist nicht R. A͑qiba, denn wir haben gelernt: Wer sich Kräuter abgelobt, dem sind Kürbisse erlaubt, nach R. A͑qiba aber verboten$fn5.
Meilah 20b:3	Abajje erwiderte: Du kannst auch sagen, es sei R. A͑qiba, denn er sollte anfragen$fn6. Als die Jünger dies Raba vortrugen, sprach er zu ihnen: Naḥmani$fn7 hat recht. – 
Meilah 20b:4	Wer ist der Autor, der gegen R. A͑qiba streitet? – Es ist R. Šimo͑n b. Gamliél, denn es wird gelehrt: Wer sich Fleisch abgelobt, dem ist jede Fleischart verboten, auch sind ihm Kopf, Füße, Schlund, Leber, Herz und Geflügelfleisch verboten; erlaubt ist ihm nur das Fleisch von Fischen und Heuschrecken. R. Šimo͑n b. Gamliél erlaubt ihm Kopf, Füße, Schlund und Leber, Geflügel; Fische und Heuschrecken.
Meilah 20b:5	Ebenso sagte R. Šimo͑n b. Gamliél, das Eingeweide sei kein Fleisch, und wer dieses ißt, sei kein Mensch. – 
Meilah 20b:6	Nach dem ersten Autor ist ihm Geflügelfleisch deshalb [verboten], weil man$fn8zu sagen pflegt: ich habe kein (Vieh)fleisch gefunden und Geflügelfleisch$fn9 geholt, und ebenso pflegt man ja zu sagen: ich habe kein (Vieh)fleisch gefunden und Fische geholt!? 
Meilah 20b:7	R. Papa erwiderte: Dies gilt von einem Aderlaßtage, an dem man keine Fische ißt. –
Meilah 20b:8	An einem solchen ißt man ja auch kein Geflügel, denn Šemuél sagte, wer sich zur Ader gelassen hat und Fleisch von einem Vogel ißt, dem fliegt das Herz fort, wie ein Vogel!? Ferner wird gelehrt, man lasse sich nicht zur Ader nach [dem Genusse von] Fischen, Geflügel und gesalzenem Fleische!? 
Meilah 20b:9	Vielmehr, erwiderte R.Papa, dies gilt von einem Tage, an dem einem die Augen schmerzen, an dem man keine Fische ißt.
Meilah 20b:10	W<small>ENN ER ZU IHM GESAGT HAT, DASS ER IHNEN JE EIN</small> S<small>TÜCK VORSETZE &amp;C</small>. Hieraus ist zu entnehmen, daß, wer über seinen Auftrag hinaus handelt, noch als Beauftragter gilt?
Meilah 20b:11	R. Šešeth erwiderte: Wenn der Beauftragte gesagt hat: nimm ein Stück auf Wunsch [des Hausherrn] und ein Stück von mir aus. 
Meilah 21a:1	Man könnte glauben, er habe den Auftrag des Haus herrn unterlassen, und dieser habe keine Veruntreuung begangen, so lehrt er uns.
Meilah 21a:2	<sup>i,2</sup><b>W</b><small>ENN ER ZU IHM</small>$fn10<small>GESAGT HAT, DASS ER ES</small>$fn11<small>HIM AUS DER</small> F<small>ENSTERNISCHE ODER AUS DER</small> T<small>ASCHE HOLE, UND ER ES IHM GEHOLT HAT, SO HAT DER</small> H<small>AUSHERR DIE</small> V<small>ERUNTREUUNG BEGANGEN, SELBST WENN ER SAGT, ER HABE DIESEN GEMEINT, UND ER ES IHM AUS JENER GEHOLT HAT; WENN ER ABER ZU IHM GESAGT HAT, DASS ER ES IHM AUS DER</small> F<small>ENSTERNISCHE HOLE, UND DIESER ES IHM AUS DER</small> T<small>ASCHE GEHOLT HAT, ODER AUS DER</small> T<small>ASCHE, UND DIESER ES AUS DER</small> F<small>ENSTERNISCHE GEHOLT HAT, SO HAT DER</small> B<small>EAUFTRAGTE DIE</small> V<small>ERUNTREUUNG BEGANGEN</small>.
Meilah 21a:3	<sup>ii</sup>H<small>AT ER ES</small>$fn12<small>DURCH EINEN</small> T<small>AUBEN</small>, B<small>LÖDEN ODER</small> M<small>INDERJÄHRIGEN GESCHICKT, SO HAT, WENN SIE SEINEN</small> A<small>UFTRAG AUSGEFÜHRT HABEN, DER</small> H<small>AUSHERR DIE</small> V<small>ERUNTREUUNG BEGANGEN, WENN SIE ABER DEN</small> A<small>UFTRAG NICHT AUSGEFÜHRT HABEN, DER</small> K<small>RÄMER DIE</small> V<small>ERUNTREUUNG BEGANGEN</small>. 
Meilah 21a:4	W<small>ENN ER DURCH EINEN</small> V<small>OLLSINNIGEN GESCHICKT, UND BEVOR DIESER ZUM KRÄMER KAM, SICH ERINNERT</small>$fn13<small>HAT, SO BEGEHT DER</small> K<small>RÄMER DIE</small> V<small>ERUNTREUUNG, SOBALD ER ES AUSGIBT</small>.
Meilah 21a:5	W<small>AS MACHE ER</small>$fn14<small>NUN</small>? E<small>R NEHME EINE</small> P<small>ERUṬA ODER EIN</small> G<small>ERÄT UND SPRECHE: WO AUCH DIE</small> P<small>ERUṬA DES</small> H<small>EILIGTUMS SICH BEFINDET, SEI SIE DURCH DIESES AUSGEWEIHT</small>. H<small>EILIGES KANN NÄMLICH DURCH</small> G<small>ELD UND</small> G<small>ELDESWERT AUSGELÖST WERDEN</small>.
Meilah 21a:6	GEMARA. Was lehrt er uns damit? – Im Herzen Gedachtes gilt nicht.
Meilah 21a:7	H<small>AT ER ES DURCH EINEN</small> T<small>AUBEN</small>, B<small>LÖDEN ODER</small> M<small>INDERJÄHRIGEN GESCHICKT, SO HAT, WENN SIE AUSGEFÜHRT HABEN &amp;C</small>. Sie sind ja nicht auftragsfähig!? 
Meilah 21a:8	R. Elea͑zar erwiderte: Bei diesen ist es ebenso, wie beim Olivenbottich. 
Meilah 21a:9	Wir haben nämlich gelernt: Von wann an sind Oliven für die Unreinheit empfänglich$fn15? Sobald sie im Olivenbottich schwitzen, nicht aber, wenn sie im Korbe$fn16schwitzen.
Meilah 21a:10	R. Joḥanan erwiderte: Wie wir gelernt haben: Wenn man den E͑rub einem Affen auf den Rücken gelegt und er ihn hingebracht hat, oder einem Elefanten auf den Rücken gelegt und er ihn hingebracht hat, und jemand beauftragt hat, ihn in Empfang zu nehmen, so ist er gültig. Weil nämlich sein Auftrag ausgeführt worden ist, ebenso ist auch hierbei sein Auftrag ausgeführt worden.
Meilah 21a:11	W<small>ENN ER DURCH EINEN</small> V<small>OLLSINNIGEN GESCHICKT &amp;C</small>. Obgleich der Beauftragte sich nicht erinnert hat; ich will auf einen Widerspruch hinweisen: Hat der Hausherr sich erinnert und nicht der Beauftragte, so hat der Beauftragte die Veruntreuung begangen; haben beide sich erinnert, so hat der Krämer die Veruntreuung begangen!? 
Meilah 21a:12	R. Šešeth erwiderte: Auch unsere Mišna spricht von dem Falle, wenn beide sich erinnert haben.
Meilah 21a:13	<sup>iii</sup><b>W</b><small>ENN ER IHM</small>$fn17<small>EINE PERUṬA</small>$fn11<small>GEGEBEN UND ZU IHM GESAGT HAT, DASS ER FÜR DIE</small> H<small>ÄLFTE</small> L<small>AMPEN UND FÜR DIE</small> H<small>ÄLFTE</small> D<small>OCHTE HOLE, UND DIESER HINGEGANGEN IST UND FÜR DIE GANZE</small> D<small>OCHTE ODER FÜR DIE GANZE</small> L<small>AMPEN GEHOLT HAT, ODER ER ZU IHM GESAGT HAT, DASS ER FÜR DIE GANZE</small> L<small>AMPEN ODER FÜR DIE GANZE</small> D<small>OCHTE HOLE, UND ER HINGEGANGEN IST UND FÜR DIE</small> H<small>ÄLFTE</small> L<small>AMPEN UND FÜR DIE</small> H<small>ÄLFTE</small> D<small>OCHTE GEHOLT HAT, SO HABEN BEIDE KEINE</small> V<small>ERUNTREUUNG</small>$fn18<small>BEGANGEN</small>. 
Meilah 21a:14	H<small>AT ER ABER ZU IHM GESAGT, DASS ER IHM FÜR DIE</small> H<small>ÄLFTE</small> L<small>AMPEN AUS DIESER</small> S<small>TELLE UND FÜR DIE</small> H<small>ÄLFTE</small> D<small>OCHTE AUS JENER</small> S<small>TELLE HOLE, UND DIESER HINGEGANGEN IST UND IHM</small> L<small>AMPEN AUS DER FÜR</small> D<small>OCHTE</small> [<small>GENANNTEN</small>] S<small>TELLE UND</small> D<small>OCHTE AUS DER FÜR</small> L<small>AMPEN</small> [<small>GENANNTEN</small>] S<small>TELLE GEHOLT HAT, SO HAT DER</small> B<small>EAUFTRAGTE DIE</small> V<small>ERUNTREUUNG</small>$fn19<small>BEGANGEN</small>. 
Meilah 21a:15	<sup>iv</sup>W<small>ENN ER IHM ZWEI</small> P<small>ERUṬAS GEGEBEN UND ZU IHM GESAGT HAT, DASS ER GEHE UND IHM EINEN</small> E<small>TROG HOLE, UND DIESER HINGEGANGEN IST UND IHM FÜR EINE EINEN</small> E<small>TROG UND FÜR EINE EINEN</small> G<small>RANATAPFEL GEHOLT HAT, SO HABEN BEIDE DIE</small> V<small>ERUNTREUUNG BEGANGEN</small>. R. J<small>EHUDA SAGT, DER</small> H<small>AUSHERR HABE KEINE</small> V<small>ERUNTREUUNG BEGANGEN, DENN ER KANN ZU IHM SAGEN: ICH WOLLTE EINEN GROSSEN</small> E<small>TROG HABEN, DU ABER HAST MIR EINEN KLEINEN ODER SCHLECHTEN GEHOLT</small>. 
Meilah 21a:16	W<small>ENN ER IHM EINEN</small> G<small>OLDDENAR GEGEBEN UND ZU IHM GESAGT HAT, DASS ER GEHE</small> <small>UND IHM EIN</small> H<small>EMD HOLE,
Meilah 21b:1	UND DIESER HINGEGANGEN IST UND IHM FÜR DREI</small>$fn20 <small>EIN</small> H<small>EMD UND FÜR DREI EIN</small> O<small>BERKLEID GEHOLT HAT, SO HABEN BEIDE DIE</small> V<small>ERUNTREUUNG BEGANGEN</small>; R. J<small>EHUDA SAGT, DER</small> H<small>AUSHERR HABE KEINE</small> V<small>ERUNTREUUNG BEGANGEN, DENN ER KANN ZU IHM SAGEN: ICH WOLLTE EIN GROSSES</small> H<small>EMD HABEN, DU ABER HAST MIR EIN KLEINES ODER SCHLECHTES GEHOLT</small>.
Meilah 21b:2	GEMARA. Hieraus wäre also zu entnehmen, daß, wenn jemand zu seinem Vertreter gesagt hat, daß er gehe und für ihn eine Korfläche$fn21 Boden kaufe, und er für ihn ein Lethekh$fn21gekauft hat, der Käufer es eigne? –
Meilah 21b:3	Ich will dir sagen, hier wird von dem Falle gesprochen, wenn er ihm eines im Werte von sechs für drei geholt$fn22hat. –
Meilah 21b:4	Wie ist demnach der Schlußsatz zu erklären: R. Jehuda sagt, der Hausherr habe keine Veruntreuung begangen, denn er kann zu ihm sagen: ich wollte ein großes Hemd haben, du aber hast mir ein kleines oder schlechtes geholt!? – 
Meilah 21b:5	Er kann ihm erwidern: hättest du den ganzen Denar gezahlt, so würdest du mir eines für zwei Denar geholt haben.
Meilah 21b:6	Dies ist auch einleuchtend, denn er lehrt: R. Jehuda pflichtet bei, daß bei Hülsenfrüchten$fn23beide die Veruntreuung begangen haben, denn [man kauft] Hülsenfrüchte für eine Peruta und Hülsenfrüchte für einen Denar$fn24. – 
Meilah 21b:7	In welchem Falle: ist es ein Ort, wo man nach Augenmaß verkauft, so kauft man ja auch Hülsenfrüchte, wenn man einen ganzen Sela͑ zahlt, vorteilhafter!? R. Papa erwiderte: In einem Orte, wo man nach Mesten verkauft, eine Meste um eine Peruṭa, wobei der Preis der gleiche bleibt.
Meilah 21b:8	<sup>v</sup><b>W</b><small>ENN JEMAND EINEM</small> G<small>ELDWECHSLER</small> G<small>ELD</small>$fn11<small>IN</small> V<small>ERWAHRUNG GEGEBEN HAT, SO DARF DIESER ES, WENN EINGEBUNDEN, NICHT BENUTZEN, DAHER HAT ER, WENN ER ES AUSGEGEBEN HAT, EINE</small> V<small>ERUNTREUUNG BEGANGEN, UND IST ES LOSE, SO DARF ER ES BENUTZEN, DAHER HAT ER, WENN ER ES AUSGEGEBEN HAT, KEINE</small> V<small>ERUNTREUUNG BEGANGEN; WENN ABER EINEM</small> P<small>RIVATMANN, SO DARF ER ES, OB SO ODER SO, NICHT BENUTZEN, DAHER HAT ER, WENN ER ES AUSGEGEBEN HAT, EINE</small> V<small>ERUNTREUUNG BEGANGEN</small>. E<small>IN KRÄMER GLEICHT EINEM</small> P<small>RIVATMANNE</small> - <small>SO</small> R. M<small>EÍR</small>;. J<small>EHUDA SAGT, EINEM</small> G<small>ELDWECHSLER</small>. 
Meilah 21b:9	<sup>vi</sup>W<small>ENN EINEM EINE</small> P<small>ERUṬA DES</small> H<small>EILIGTUMS IN DEN</small> B<small>EUTEL GEKOMMEN IST, ODER WENN ER GESAGT HAT: EINE</small> P<small>ERUṬA IN DIESEM</small> B<small>EUTEL SEI HEILIG, SO HAT ER, SOBALD ER DIE ERSTE AUSGEGEBEN HAT, EINE</small> V<small>ERUNTREUUNG BEGANGEN – SO</small> R. A͑<small>QIBA; DIE</small> W<small>EISEN SAGEN, ERST WENN ER DEN GANZEN</small> B<small>EUTEL AUSGEGEBEN HAT</small>. 
Meilah 21b:10	J<small>EDOCH PFLICHTET</small> R. A͑<small>QIBA DEN</small> W<small>EISEN BEI, DASS, WENN ER GESAGT HAT: EINE</small> P<small>ERUṬA AUS DIESEM</small> B<small>EUTEL SEI HEILIG, ER [DAS</small> G<small>ELD</small>] <small>NACH UND NACH AUSGEBEN DÜRFE, BIS ER DEN GANZEN</small> B<small>EUTEL AUSGEGEBEN HAT</small>$fn25.
Meilah 21b:11	GEMARA. Als R. Dimi kam, erzählte er: Reš Laqiš wies R. Joḥanan auf folgenden Widerspruch hin: welchen Unterschied gibt es denn zwischen dem Anfangsatze und dem Schlußsatze$fn26?
Meilah 21b:12	Und dieser erwiderte ihm: Der Schlußsatz [ist zu verstehen:] dieser Beutel soll vom Heiligtume nicht entbunden$fn27sein. 
Meilah 21b:13	Als Rabin kam, erzählte er, er habe auf einen Widerspruch zwischen [den Lehren] vom Beutel und von den Rindern hingewiesen. Wir haben nämlich gelernt: Wenn jemand gesagt hat, eines von meinen Riyndern sei heilig, und er zwei hat, so ist das größere von ihnen heilig$fn28. Und dieser erwiderte: Der Schlußsatz [ist zu verstehen:] dieser Beutel soll vom Heiligtume nicht entbunden sein.
Meilah 22a:1	R. Papa sagte: Er habe auf einen Widerspruch zwischen [den Lehren] vom Beutel und den Logen hingewiesen.Es wird nämlich gelehrt: Wenn jemand von Samaritanern$fn29 Wein gekauft hat, 
Meilah 22a:2	so spreche er: zwei Log, die ich später absondern werde, sollen Hebe, zehn erster Zehnt und neun zweiter Zehnt sein; diesen$fn30 lasse er durch Geld ausgeweiht sein, und er darf sofort trinken – so R. Meir; 
Meilah 22a:3	R. Jehuda, R.Jose und R.Šimo͑n verbieten$fn31es. Und dieser erwiderte ihm: Der Schlußsatz unserer Mišna [ist zu verstehen:] dieser Beutel soll vom Heiligtume nicht entbunden sein.
Meilah 22a:4	
